tx_hash,block_number,block_timestamp,input_value,output_value,is_coinbase,fee,lock_time
8b1693878134e3360dedfcb63f92b807d17ed33cae96e719bb056ca54d15869c,990661,2020-09-30 22:07:20 UTC,23855,17855,false,6000,0
96eee470ed7b3e72a46e6332027f827aaeae3a28e8e0bc16cc6961ec8172c967,990661,2020-09-30 22:07:20 UTC,11268425946,11268209931,false,216015,0
c8c0021e1eb3098c32841880a6039c99e088e03bab5695caef966c5f8a642104,990661,2020-09-30 22:07:20 UTC,8184458,8170444,false,14014,0
e6f505cd85bbdd16ea894fda21380ba984bca1d9fba7e416217b8484e902a50c,990661,2020-09-30 22:07:20 UTC,10000,0,false,10000,0
97ad4d020826d974cf2c216f2ce121149f3270bc7ab3a4f803f68834b247081b,990661,2020-09-30 22:07:20 UTC,5120569,5120117,false,452,0
3d736897432591a57e8ff6f2d1515f0c743f9c9cfa56fabaaa8145d5b959770a,990660,2020-09-30 22:06:17 UTC,3500305831,3500295831,false,10000,0
073709a9806a77d722e26b5ebdd96463eb807bc6fc2bcfd1f044161d0f6f1c37,990660,2020-09-30 22:06:17 UTC,2500000000,2499997717,false,2283,990649
ee3cd04305e974d651609f9bdb3065664f447d22d91943db45b4a6a370ae5d0e,990660,2020-09-30 22:06:17 UTC,500012972,500002972,false,10000,0
b74ba98b9276895174ac6758230c901f8765fa1197af2c32298fa5f6a657471b,990660,2020-09-30 22:06:17 UTC,10000,0,false,10000,0
a9ae99734911e0b43ef27be6774b20bc95c01c7871274f6789d90e4dcfa27926,990660,2020-09-30 22:06:17 UTC,72290493,72186453,false,104040,0
d89474dcfb175a99d07d92c73fc27fb767f85c1e29237a88ec95e15c787c90c9,990660,2020-09-30 22:06:17 UTC,6418905,6418453,false,452,0
f15f014b61fd0e1d953b1f35f6277aa176dea4f38c476b750743ddc5659b4557,990660,2020-09-30 22:06:17 UTC,1000049089,1000039089,false,10000,0
ad15bace1039f4724c53319cbefa614ce06220f4a28a3d8f20e5f4efa4ee5449,990659,2020-09-30 22:04:32 UTC,240728943831,240728933831,false,10000,0
072557c3a11fc2d8d6f999bf547527e5e05b4619f03515fb3b67b2509d69e204,990659,2020-09-30 22:04:32 UTC,6700,4780,false,1920,0
ebe49df8c65cefd814ce32125945155d013385f974811be0e9ff5c97152baa29,990659,2020-09-30 22:04:32 UTC,28307686,28298287,false,9399,0
b0d59e633e2ba81b2927dfa1e9546132fd7ef1db65d3e2c264780c1cf16f163f,990658,2020-09-30 22:02:47 UTC,10000,0,false,10000,0
184b1fd245a6db43679d16a6c820665669ea853966afeb78d2c485ac8dc9b7d0,990658,2020-09-30 22:02:47 UTC,28398107,28388708,false,9399,0
7b3210a7fb23d34e461cc81a2a79140f2f1e300c8f9ed81b39bbbbff9fec7b08,990657,2020-09-30 22:02:08 UTC,4202242760,4202232760,false,10000,0
f1d4f4b9df2e0bf994c0c63fa918925af364f35a69130295e7224dd9e981493c,990657,2020-09-30 22:02:08 UTC,10000,0,false,10000,0
02736e9aeccf6dccb2ee4298f9670a6807ee2aef11f518372f83007e4824ea3c,990656,2020-09-30 22:01:27 UTC,24920330,24915255,false,5075,990645
ecda4bf7216d4903d08824bcba672ccefcab0286bf938390bde5f8b69a032aa3,990656,2020-09-30 22:01:27 UTC,10000,0,false,10000,0
7df6eaee7bb143efc919ee08154b7f10d0b567601c35917c35dae0f838fd9e04,990656,2020-09-30 22:01:27 UTC,10290063,10287761,false,2302,990645
076ddaf90c8cad2bbe7ac49d0f10e9c282e86c584d217709febf6965b5db262e,990656,2020-09-30 22:01:27 UTC,28426226,28416827,false,9399,0
55a9e4fe4df7c9074d0cdd8ec5131a5409bc9f20139b2dd0f8a040c93fd01b0f,990656,2020-09-30 22:01:27 UTC,11575488,11571813,false,3675,990645
06087e26064c067f371cad667c267488657e3c883b5d65d6912fbfcbea7204bb,990656,2020-09-30 22:01:27 UTC,168611894,168608934,false,2960,0
9a5ee480edb0cf41a6e448c67fa4bd90155f65f4f67d0069f092b541a7f7a663,990656,2020-09-30 22:01:27 UTC,5368375,5365925,false,2450,0
203fcf1989fbaecc870f1d50e6d851452322d87b0f198a7d85bb62ee071b7ff8,990656,2020-09-30 22:01:27 UTC,15582024,15578340,false,3684,990645
4cc4795a6ca096f33c8eea2f2f5da90279ab2d4d029488b732ae3e306f86c0a7,990656,2020-09-30 22:01:27 UTC,127603943,127600983,false,2960,0
e0941f9744b2c95bb84fd72a015fc02b22cf4228a0863ff0c0108086a01e0172,990656,2020-09-30 22:01:27 UTC,461594491,461574321,false,20170,990645
c0247b5304a00870f323b6da3965a1224fc88bb3ee8afbe7a0a6a9002f87fe7e,990656,2020-09-30 22:01:27 UTC,20591226,20587551,false,3675,990645
aee33a23bb5392915c53e597c5ef62d956fd6257545674d301e728d8ff704da3,990656,2020-09-30 22:01:27 UTC,10000,0,false,10000,0
46b693dced90ed69bd61fbe6a8dadb306fe9d2f502214f6d8e31ccbaf6355b4e,990656,2020-09-30 22:01:27 UTC,10000,0,false,10000,0
3fdfe73cdd52f1a821627a2cee868b5f19df9e1bdc6ef807fe6019ea4ee7a193,990656,2020-09-30 22:01:27 UTC,7254185,7247738,false,6447,990645
18a0445ab01ec24bc137392b42dc107d73a6ddb8c0fd14e18906d4dd777ba0ff,990656,2020-09-30 22:01:27 UTC,989913342,989910081,false,3261,990645
a8bd04880dae99334d5affb1439725a7e81c4a4b5cb4a62e0c5df2720639291c,990656,2020-09-30 22:01:27 UTC,1373926160,1373885284,false,40876,990645
8c1b111e4985c5c02b177a8613115b35a38b21a1adb7cf4e0e5188850052cfed,990656,2020-09-30 22:01:27 UTC,10060477,10058175,false,2302,990645
72b90b6eeb4a0b6d54aa5426eb52b8290f2315dd6984016d4655837380e7e700,990656,2020-09-30 22:01:27 UTC,512651146,512648214,false,2932,990645
bb3bd6e188ab48a453fa19de9879eaaf7f344e08d5ef7304a0b943583371c3d8,990656,2020-09-30 22:01:27 UTC,208618,198618,false,10000,0
9a45bf930aebfad91dfcabd605fe2a19e1ccb616e5dddf416f3b55e2cc03aacf,990656,2020-09-30 22:01:27 UTC,142000000,141924808,false,75192,0
e835df7170b59c4bb3ad459a208846115c6ca63dfb3381d0a117f9f3fdbe254a,990656,2020-09-30 22:01:27 UTC,23340066,23334991,false,5075,990645
8972ba5baca28a6e842d72ca4fd000f8210fc01865a881679a8ff044e7d0cc98,990655,2020-09-30 21:55:47 UTC,162386844,162381624,false,5220,0
4c197d9f9a44f8bd78db2158b10228a816f54df97b4d1a79eeb304210c6e2181,990655,2020-09-30 21:55:47 UTC,10000,0,false,10000,0
285b4b67df64e4158523c0acd708572d9f620a1b632e230f5a527b7c523e19d8,990655,2020-09-30 21:55:47 UTC,19584195623,19584185623,false,10000,0
f6e17139b1547e58adcd8b045d0d0d8edf24353d0d597c7220bdf6ea24239e65,990655,2020-09-30 21:55:47 UTC,10000,0,false,10000,0
c500bfe30f6be39ef3c4e916c2b9f22bdae8f697558cbb70024aa8a481487b53,990655,2020-09-30 21:55:47 UTC,149720157,149620157,false,100000,0
98dbf82a0ce92cf89b8483478d32fd5e29778b83309c4ba5d2447cb0c7b25f3a,990654,2020-09-30 21:53:15 UTC,406791905,406786905,false,5000,0
41a4a98db3bdd99b0f301c866296293dd49cfaf968b072d1306861952ea4e376,990653,2020-09-30 21:52:30 UTC,10000,0,false,10000,0
a8dbca0a826d44b556c36ccb83feef82dd8fe029fca755b8b8df571036e2c0d0,990653,2020-09-30 21:52:30 UTC,91840432,91836247,false,4185,0
8de3012f78e8cf75adc2f9256127f9fc2877f9e0cb8e7e363573b8ba5a238c03,990652,2020-09-30 21:51:55 UTC,499980000,499970000,false,10000,0
6e8c1673df7f1ec930d8cd5f9de212c78737b5a90874a5578a7a1526056adb58,990652,2020-09-30 21:51:55 UTC,9399900000,9399899929,false,71,0
51cb8a70fec5dc79b8b45806cb33e29b3e05aca65e1a95b2439fd4219c868f1f,990651,2020-09-30 21:50:29 UTC,462091666,462068291,false,23375,990640
7fcdfcba92e38fd145e936e90c6e2bad740b8dfeb10873ad1458a1cc1b8ca097,990651,2020-09-30 21:50:29 UTC,10000,0,false,10000,0
6a4f4ec9059fc8ac0c5a2c122457b5dc4b373434cc71ae30bffe028375b3761c,990651,2020-09-30 21:50:29 UTC,1375001949,1374948535,false,53414,990640
e19e5151bd5681562ed1ea9003fa53e65432ec4b3c6d5a8dea944d8738a195f1,990651,2020-09-30 21:50:29 UTC,28612773,28603374,false,9399,0
25485037b10c04ba5e1e750ebd7cd4fe2dc340eb47b9941e2889033d805451d0,990651,2020-09-30 21:50:29 UTC,28473641,28464242,false,9399,0
3c453c72ebaab232fb28f0cdd4bfa7087785975e1edeb528206b56d9a4878e2c,990651,2020-09-30 21:50:29 UTC,10000,0,false,10000,0
075ea23151e45d13bd23a8aa49f8e63a42f3e317e4f4040ab2389063bdafa450,990649,2020-09-30 21:49:02 UTC,230698081,230695779,false,2302,990638
d60044da2fde96d381851872ab634ad1bba59417f52b1db45f4cd17ab23ff48d,990649,2020-09-30 21:49:02 UTC,28650810,28641411,false,9399,0
b5c345e85756e91224007d4263f44c202b2ee7f661efd9175c37a70408298d44,990649,2020-09-30 21:49:02 UTC,24701527104,24701497104,false,30000,0
178fb0c2f281e6eb786535198e34260031bb3e116c007b48e41509cd8fcb6978,990649,2020-09-30 21:49:02 UTC,28706959,28697560,false,9399,0
0ced9bd0c53086f6c6d58fc5d38857df21b1eed6d0d3c63a8719836eb91eab49,990648,2020-09-30 21:47:45 UTC,17362152,17352152,false,10000,0
08465556494294c821e9bb780aed7819cd7d888de5ce4e75178b861c09c30ef1,990647,2020-09-30 21:46:49 UTC,131000000,130997740,false,2260,0
1118b2bbcf9d2a5bf54fef379d2348b9392949909874ee4deccbe6fac264a483,990647,2020-09-30 21:46:49 UTC,10000,0,false,10000,0
b622ecc69a80ca12b5bac36e32757f23d140dd7e30a01f63a7952b9bf774719c,990647,2020-09-30 21:46:49 UTC,28751108,28741709,false,9399,0
2ad47ac4c466664afa7ffb58c512a32721452c98cea0a1f5155b4d6ff47c806b,990647,2020-09-30 21:46:49 UTC,10000,0,false,10000,0
5b2d27a80a7b1f41068481d5d52e4e696b04b4085b85bec32ad1e6297700acea,990647,2020-09-30 21:46:49 UTC,358292910,358290460,false,2450,0
737422ee5ba46f9a45513c49c8ae90613c235eb17a6fae93efe07796b12b89b1,990647,2020-09-30 21:46:49 UTC,189270783,189268481,false,2302,990636
a44a4ce462d71240fcf18c9c14b41c62ea3e8753cdebd061f1fef6b46f837dbe,990646,2020-09-30 21:43:14 UTC,10000,0,false,10000,0
b0755affcd0ac48fa01f5970c830ac7887a994560c74dafd5770ce9ba479057a,990646,2020-09-30 21:43:14 UTC,10000,0,false,10000,0
c112b4bcb026b3cc6bb5199a80a0b67ef83c926b3f907140cf33d6bd73bd56bc,990646,2020-09-30 21:43:14 UTC,1375832533,1375785492,false,47041,990635
1038890adb60dc91021f8c91d95206c222047d0f64d64303ad6694c6d2ef1816,990646,2020-09-30 21:43:14 UTC,127860234,127857274,false,2960,0
84e1e3c0696d7b69c0013b3508ed3e0791dcff33a1936cc60f919d3333fd8703,990646,2020-09-30 21:43:14 UTC,462712373,462687382,false,24991,990635
b88962b631660c85eecf17ab692cebde7565f8bd28bf48b0a864ff7c357293b0,990646,2020-09-30 21:43:14 UTC,1208015788,1207940596,false,75192,0
1611de76583778c2352aaecb81968e2d502b9499586df45a9c33385d9e264a6c,990645,2020-09-30 21:39:10 UTC,10000,0,false,10000,0
a2a0251754d5d6170f2f22314a0baa80e88162c0f5880a5a759ee512ae7038f5,990645,2020-09-30 21:39:10 UTC,4685,293,false,4392,0
843face16fb4de1a5ae550f5ab836f3b7b8631088b51588bb69860c58713ca2e,990645,2020-09-30 21:39:10 UTC,3112709317,3112699317,false,10000,0
ca972d72dcba9c53a7efaa5f9c34f9cd67b5ba439277e9529af7c4dc9d1f9a7e,990645,2020-09-30 21:39:10 UTC,10000,0,false,10000,0
e8103c769862a72e04b586d3aa39bc09079c9448c1f9c3a5eb9d7b0c068e1768,990645,2020-09-30 21:39:10 UTC,989923342,989913342,false,10000,0
e961909d7f17cd79ba4a613f708a0d44bcb1432ca47d52382ae2449ded183b3a,990642,2020-09-30 21:34:43 UTC,10000,0,false,10000,0
fc38d3a263212bccca3602e1def63612d464e2f088cddc5357363f81d434b4ae,990642,2020-09-30 21:34:43 UTC,222583354,222579614,false,3740,0
464466c1d086f40c61b36e0b418a0b01aa60ceeb85ab9f956a4c9a42b88bdc88,990642,2020-09-30 21:34:43 UTC,6240460093,6240457803,false,2290,0
cf89b6adbc86577e86ee0392b902b905ff4a9b5deee3507da1039086914241ac,990642,2020-09-30 21:34:43 UTC,168767687,168764727,false,2960,0
efdac02b70ac73c7e89d624458b9e1c28b974544b0032d14c6a3857c44b10273,990641,2020-09-30 21:33:15 UTC,10000,0,false,10000,0
0be2f9809676b807e0bc543fae0d1fb7ecc7599983b3ff17b89e72718572891a,990641,2020-09-30 21:33:15 UTC,106561157,106545917,false,15240,0
2f74d735127475fdd98556a47f477b54727fd42aae59f0e3aeda66b8fb55967b,990641,2020-09-30 21:33:15 UTC,100000000,99997550,false,2450,0
d85be439da6b2c57cd39b8cc6a605852bf6a7299f308916d85778f61516359ff,990641,2020-09-30 21:33:15 UTC,86343153,86340893,false,2260,0
4cfa5ae0b8a66e8d5d423177b9c36230c731ece9574a7e68e0df7d48a6252343,990641,2020-09-30 21:33:15 UTC,106545917,106543381,false,2536,0
9ac14214c26ab59f6ad32f29a49e440750fabf1e43b330e6e924cb52c18e281e,990641,2020-09-30 21:33:15 UTC,499990000,499980000,false,10000,0
cc00e0dfedd894f45405a5ee28a514471ee79338e6a73fde6c5ae60d1e0206b3,990641,2020-09-30 21:33:15 UTC,236049588567,236049586265,false,2302,990630
4d970476d01ef87c1c25f43ef9941b5d6b565af66753b20ec4032c6e2a119756,990640,2020-09-30 21:30:40 UTC,500000000,499990000,false,10000,0
5a625a1c624f40557ff988304421553c295e8a52f5be64d92f5b65131021e72f,990640,2020-09-30 21:30:40 UTC,1376961197,1376909386,false,51811,990628
b56a07445c8d9a63567f57adcbedcffbbb3a3db599dfb568d89fc6408c015fe2,990640,2020-09-30 21:30:40 UTC,10000,0,false,10000,0
aed0dc97ae8d9bf19aea27c0f5b439a084d4a85014c7db04a44d708e07e493ca,990639,2020-09-30 21:30:11 UTC,26858436311,26858406311,false,30000,0
c8d72aaf4c889c538b09e0fd9f1b67a2d466e5723d6bdf009bde8e14c5378c54,990639,2020-09-30 21:30:11 UTC,152710721,152694182,false,16539,0
c070aa54002e0914063b5a0914fcdc2533177d8ce14eb201ff764221b9ad9736,990639,2020-09-30 21:30:11 UTC,463471523,463444636,false,26887,990628
411bff9ddd203119f1d342bc414af2b6d31d63f4df14b86d306975d1b5647279,990638,2020-09-30 21:28:24 UTC,117447,85927,false,31520,0
4dae24e321d57ba85fe46032ec65d53e53d769058e83adadbc571a597f0cd8ac,990638,2020-09-30 21:28:24 UTC,34445,24445,false,10000,0
a90de6e65bc24cab2ed1059f3e4b8a423dab8ffb432b33ab86ca31f7e4c55836,990638,2020-09-30 21:28:24 UTC,10000,0,false,10000,0
35d10c037adae585f32c33268c346d16c9cc628b315a3bdc4a2b7be0f731c546,990638,2020-09-30 21:28:24 UTC,28836137,28826739,false,9398,0
6af1f2e00ae638d10d2e9d67153cc5852cf7ba1475657b337f87679630341f47,990637,2020-09-30 21:26:51 UTC,436063014589,436063011967,false,2622,990626
c00cc1c90fcd639a8ef9b0b2d5e44392dafa1b5f32d3beb1e7642abe04ff1593,990636,2020-09-30 21:26:25 UTC,91995381,91992421,false,2960,0
acc05cdd726299b172d7013c15321e8c89304cd29d555ea421d9d3ca3eae4acf,990636,2020-09-30 21:26:25 UTC,10000,0,false,10000,0
fb36971a2835a840e48daffc3d0d49011c1730a44549a004bb2b07d8573d401f,990635,2020-09-30 21:24:53 UTC,10000,0,false,10000,0
fcfc89fa6e791a855596c289fd3b2853eac9dbebb31923579a8c330930cc3c96,990634,2020-09-30 21:23:57 UTC,149795341,149720157,false,75184,0
fc5d72f2a7f39926a8b94df8d67bbf19a5b3256db636942af8cec1c44479e73d,990634,2020-09-30 21:23:57 UTC,100000000,99990000,false,10000,0
ae0d2427a7f11d5c4597673e78eb31d5f5ee80e1e20faca28edcfd40e3194d72,990634,2020-09-30 21:23:57 UTC,905774850,905674850,false,100000,0
cfd38e44dd9cf93ca01559a51e5e9feb02416bdb0041a93d563250980c75a940,990634,2020-09-30 21:23:57 UTC,257884034,257881732,false,2302,990623
ba5192507b5c98ac0310e211de62e691af29d000551a1fd8a655c6042cad31f4,990634,2020-09-30 21:23:57 UTC,10000,0,false,10000,0
48b0bb7f51c51c982f16f47ccaa2ba5e635e7835560436df437bd12171490be0,990633,2020-09-30 21:21:55 UTC,28869425,28860027,false,9398,0
f900504100e8eb4adc2d716d2be4a9543f183edd4ddb0b034815f9320db377cb,990633,2020-09-30 21:21:55 UTC,15549469832,15549454252,false,15580,0
ddc6dc99e70cbaa9e7cb3b770a4c8cbd7296b8c12c644368a460e3014e799c18,990632,2020-09-30 21:20:51 UTC,6372396517,6372394224,false,2293,990620
d45433a8d50ba6e0af27bdca8b423a61cb16f5788a4c1b9f986ae2a8bce22dc6,990632,2020-09-30 21:20:51 UTC,10000,0,false,10000,0
9fb4f7099a84667638fe4ad2110748f5d1b9b007eaba47c63be7ef7b09aa2377,990632,2020-09-30 21:20:51 UTC,463963873,463939523,false,24350,990544
5cb0353c08cd9e90496ae9dd8bb8d5bb15b49ca6c321cd4c4c0be6de84a5cecc,990632,2020-09-30 21:20:51 UTC,1377695018,1377647737,false,47281,990620
3fa6ec56a61b9770aa075c2df74b76205546376d16e72d0084f06c54770cce63,990632,2020-09-30 21:20:51 UTC,1131658227,1131642647,false,15580,0
f98351507eeb7762711ee400de2cca3707919f62a27f63a6791783a380eb209c,990632,2020-09-30 21:20:51 UTC,19557900004,19557890004,false,10000,0
9e73fef25f94083714fb4c9f7632182ccc998c7fda2af5f90d96cc1cb55cffd1,990628,2020-09-30 21:19:16 UTC,128469794,128464079,false,5715,0
bef455a57f2ba6d1138c21c6b616510fb8ba55130a6470a2c62327f26876eaee,990628,2020-09-30 21:19:16 UTC,19851182868,19851172868,false,10000,0
2b0347da35554b4871e252a6c6dc355beb5d57ae405840974521251dc0d87359,990628,2020-09-30 21:19:16 UTC,10000,0,false,10000,0
ea21463aaa705430554a4d2caf5c29ed57a466d3b91a07bb5683fbb23eb326ce,990627,2020-09-30 21:17:40 UTC,100000000,99997550,false,2450,0
9dbebd4e8488de768d662b92b97d260356c44a3a775e0b53a68f34d3e446124a,990627,2020-09-30 21:17:40 UTC,10000,0,false,10000,0
c777dff325af78aa2ebf40d69d251f8e2b3fe631820e01cadbc5dc57d1829b08,990626,2020-09-30 21:16:27 UTC,40886,38436,false,2450,0
ba5a84fd46b671bcac5a50ae2f65e9d422607f14dbc04ed09a9fd2a966248300,990626,2020-09-30 21:16:27 UTC,40300000,40297740,false,2260,0
8cb88ab870b725805340133c82c81cb54dc1bd8459992bbcf73b8a5b3845b835,990626,2020-09-30 21:16:27 UTC,10000,0,false,10000,0
c5af92123ec2c15f859315c0205c469cf3bf9775a1c56e1d131b0cf5d48a2f84,990626,2020-09-30 21:16:27 UTC,100000000,99997550,false,2450,0
e0bdbd7815602b9611e6e351b6dd1609347771f43ef49ddf9e0478a2cdcc2041,990626,2020-09-30 21:16:27 UTC,14318500,14316472,false,2028,0
e058915a7f7f5802d4f815526aeb6dfcba3670035977649767f889e838698f57,990625,2020-09-30 21:14:00 UTC,87372823026,87372822955,false,71,0
c974495165b12c131eea197b8ab4737ba57406fd95ae623c2a63ddf17464025a,990625,2020-09-30 21:14:00 UTC,22584,16224,false,6360,0
bdaad55c8854135f86b9e614854b7df3d390c1794503e83f93b967f63aae4fe5,990625,2020-09-30 21:14:00 UTC,168970665,168967705,false,2960,0
1d80f6c6b2c865bb0776596d729e22bc203f3bc1237cb77b831dbdbce707c98a,990625,2020-09-30 21:14:00 UTC,29049905,29040507,false,9398,0
a82e40d8d115bdc12f9513c5e021b3f0ee636afc4ffb04fa3925b24062570da9,990625,2020-09-30 21:14:00 UTC,10000,0,false,10000,0
f88a5bf415ac5141405139fe6f7d691c62e3d4db394dac702b6dce68788d856e,990625,2020-09-30 21:14:00 UTC,15770478,15747838,false,22640,0
90713316d9c9126002e133a54ad48d8cf65f149025fe8745a0c06b2de5b5f9d7,990625,2020-09-30 21:14:00 UTC,437259526617,437259524315,false,2302,990614
45cbbb31f0301d9b613db3179f98656e1ed5f1a6fee2a491493ba60294b864f8,990624,2020-09-30 21:11:19 UTC,15530287,15525203,false,5084,990612
ad98ad6a67b44772702c37590d508fe4446b576f48446ec15aa25dddc06b902a,990624,2020-09-30 21:11:19 UTC,4302990000,4302977915,false,12085,0
cc0b2730074c7bde0572385d7d972141cf0fd30aad0a6e93e7d3af3ebf4cd40a,990624,2020-09-30 21:11:19 UTC,10000,0,false,10000,0
73b221922e5a6a0a3a37d8a52db9c84221f3d1c2e246ad13ca78e1b00ec30308,990623,2020-09-30 21:10:19 UTC,1546546,1544244,false,2302,990612
b2d552d5f66fed7334310c22ce9a5f7af2d6e28ae0161b23d029453481737f80,990623,2020-09-30 21:10:19 UTC,32776056,32772363,false,3693,990612
ccd28f41ff7a591b526fdc6c619acd466bc80667c2885092e318befa56c5d3f8,990623,2020-09-30 21:10:19 UTC,281131696,281056512,false,75184,0
6b3ba128b5f5656692bec01ad112a1b934a96506dd1e190b4a55f8c3c4af7c7d,990623,2020-09-30 21:10:19 UTC,1379094992,1379039648,false,55344,990612
008bf40662827be200b0b8d02a18e752052980f045ba9ad2cb80c49243bd6666,990623,2020-09-30 21:10:19 UTC,10000,0,false,10000,0
4f6deadc7ea62edc3fef2a030c98025de2b43d9cfac6370c4b13461d77f713fb,990623,2020-09-30 21:10:19 UTC,29080342,29070944,false,9398,0
3c90c80ab569441aecebe93bee62840883ce0053bd01e5ad7012254217a405b7,990623,2020-09-30 21:10:19 UTC,10000,0,false,10000,0
05d899fc4e5e4c20e188d8ee697196ac10d8e4fbb377b38d2e2353a885cd1289,990623,2020-09-30 21:10:19 UTC,2500511901,2500501901,false,10000,0
bb95bbada865145a421198ea2370f4bbe9cc1f3a503117aa48d637f72dc06d5d,990623,2020-09-30 21:10:19 UTC,1004540,1002090,false,2450,0
91231625363863d9c0bf69d1666f288a0672d4c9e6a7da27cfe0f100b23f309e,990623,2020-09-30 21:10:19 UTC,19851192868,19851182868,false,10000,0
0a0027b3f4f8577296f463c432a031b7a66d3dbb8d91220140aaafe3dbef40db,990623,2020-09-30 21:10:19 UTC,3703569,3698484,false,5085,990612
925231b3d1eac7397d85d87abab3588246f05083e1b76a1a19c4e0126dbbf5ed,990623,2020-09-30 21:10:19 UTC,612047975,612038315,false,9660,0
07a37525ddaded5a49d3555e24570e6d32a8c0ea19862855deb2ac14b6b3cd38,990623,2020-09-30 21:10:19 UTC,457772519239,457772516617,false,2622,990612
4a89f53c8b1f0354f4fc2b821eab2ccc8e31f87699956382bf208aaed11c7cee,990623,2020-09-30 21:10:19 UTC,10000,0,false,10000,0
4398b25be1420f6741d21c27b1923acd6075f03bfd1d712ad9643156472348cd,990623,2020-09-30 21:10:19 UTC,464477221,464452242,false,24979,990612
5d862ed2f592abf46542f4ff331ceb0d43f8afd4a896ad3965a1b1a10edd0175,990623,2020-09-30 21:10:19 UTC,1000281462,1000271462,false,10000,0
6199fe1174976ada5fecbe90cb0ad9433bcbcc0b407ad75f29116b3c14eec924,990622,2020-09-30 21:05:10 UTC,3500315831,3500305831,false,10000,0
3fd87fcab5c1057f67b878cf30e1f945a787e1b5ea74189512de1c925b8ae1fe,990622,2020-09-30 21:05:10 UTC,128919734,128916161,false,3573,0
42a4deb4598b738e410c0b5e7beaca930269613ec13f6a0dc33f648ea090003b,990622,2020-09-30 21:05:10 UTC,92174483,92171523,false,2960,0
e45a902d400bc393ac200ab558d9dce17a6b294891e17a0380dfe5ce27ff0992,990622,2020-09-30 21:05:10 UTC,238631124192,238631114192,false,10000,0
ecf3671c2485c257368a0f0a7780e14c0a581b815dc271ac3b2e0ec79ca02a42,990622,2020-09-30 21:05:10 UTC,149697455020,149697452670,false,2350,0
0d43402888de947461083eb18c7a6dc1a9cd797c5a131a2e6a5718770e427a74,990622,2020-09-30 21:05:10 UTC,3000681622,3000671622,false,10000,0
eae0286d8f34fbd115d80f5164c4d61575c718292fe2e07c1a6b479ec6c32556,990621,2020-09-30 21:03:55 UTC,10000,0,false,10000,0
9bc85519ec20606e68276544f257ad6cf62df11a9e9e711240be21c7aff9bdc1,990621,2020-09-30 21:03:55 UTC,499980000,499970000,false,10000,0
b60c876a4dfbfe059c45a4310a2e50c6a38c4b2d0c461a6412eb18d36fbf61c1,990621,2020-09-30 21:03:55 UTC,10000,0,false,10000,0
23bf486c7f1a9e7c4b04c6cf2fe2f23e152c63e842852118ef6915c0768480a5,990621,2020-09-30 21:03:55 UTC,7472222626,7472213802,false,8824,990609
c185613bc332e3129f0fd01cc6e5d6733780a73ceb05bdd986ab2ae73f06c9dd,990621,2020-09-30 21:03:55 UTC,596753154,596749254,false,3900,990610
8117887f486227a55cf0e96f7d29486e7ae70cd54f7101eed823a50c67966600,990620,2020-09-30 21:02:11 UTC,499990000,499980000,false,10000,0
4d49edfa7df0931cd2f35da801b6d176efd0db3920165071b79aab8c01f77302,990620,2020-09-30 21:02:11 UTC,10000,0,false,10000,0
cbccebedc6ba79ecdcacdc65df8715a901aa91807c5ff4b40d8c732cb3f0bd32,990620,2020-09-30 21:02:11 UTC,710426181,710416181,false,10000,0
080a6b5718c0b6522536edaba2fdc6538ffe4a162f76a16ea0b73e3ac092bec9,990620,2020-09-30 21:02:11 UTC,125953783,125936001,false,17782,0
50e10bd08cc168c82ea4fb897ef468bb9ccb0ec64bb75e68b05691903325bba1,990620,2020-09-30 21:02:11 UTC,10000,0,false,10000,0
01a5d479dd28fe44e66c7f28d39a263a58f8c3ca72453449acf46d43b252a9c7,990620,2020-09-30 21:02:11 UTC,465045804,465023061,false,22743,990608
ba663e435431e63fee55c3072c7f33b969183239b83095dcd864410d5897c2a3,990620,2020-09-30 21:02:11 UTC,10000,0,false,10000,0
9a76e58552af352e6ecfd854ad12e291ff917f4f6665d2882815109344be07b5,990620,2020-09-30 21:02:11 UTC,1380565452,1380510108,false,55344,990608
4b05d1ccd20182ce5fc56792e4c44943741efd0dcb5838f605fdb6cd3a152f09,990620,2020-09-30 21:02:11 UTC,168400010000,168400000000,false,10000,0
79f714c244589944c979ba949840392c4b4962066ba0dcf99e3caaba9f608b04,990617,2020-09-30 20:59:16 UTC,398363354,398347774,false,15580,0
3b82705de2be0bfd8d3fc4dfd0ea3649bd19da80f334d0e7c7feb7a57fdd5d61,990617,2020-09-30 20:59:16 UTC,10000,0,false,10000,0
93a1d78c163d01f9c0a8186783020c3ce072ba72abe340493af5e8fe9c069fc3,990617,2020-09-30 20:59:16 UTC,500000000,499990000,false,10000,0
25e5561eed184d099d5d2aefe3902596298614737da6ac86e362a2bc42a49917,990617,2020-09-30 20:59:16 UTC,29202715,29193318,false,9397,0
4de54f02910809974668bb281172ccff92e777592324e880583b018968a2dde0,990617,2020-09-30 20:59:16 UTC,300920795,300910795,false,10000,0
d911772e5bc10782da048839545f95d8b8af2ba91ebf57494e96d86c7376979c,990617,2020-09-30 20:59:16 UTC,29173707,29164310,false,9397,0
93ecb568bbbb45531f44af7ed062c51e0e986c9f61c53beaaf839eb3027e54b0,990617,2020-09-30 20:59:16 UTC,169173440,169170173,false,3267,0
0aec4b3cee914b390c0d7580cb7ade00e06f8c065eb278468b8a0562a441c13d,990616,2020-09-30 20:58:22 UTC,1481788492,1481772912,false,15580,0
925b15591a15d6dcc12916c1911bda416982c8c98a06dd5311aed5fa6c6b4cb8,990615,2020-09-30 20:58:17 UTC,1074704777,1074689197,false,15580,0
9701a11bd348eda4171f0401b794a4b6c5dd798c1d532a0f74994e59d0e3ab70,990615,2020-09-30 20:58:17 UTC,29251754,29242357,false,9397,0
8e171cdca3c18cad3fd610cae1952f8bddc9199be8c2faf17c0b62822309295c,990615,2020-09-30 20:58:17 UTC,1516467941,1516452361,false,15580,0
10e6987c44e87089e7c3dc11b0664337ef1df0557e7c8b5a3f4b153ecb1296e7,990614,2020-09-30 20:57:48 UTC,453987369,453971789,false,15580,0
fdb05b54fb80ef03de9792be9cdb6a964d751e5a39b04b3356a8bc5398a9615d,990613,2020-09-30 20:57:33 UTC,10000,0,false,10000,0
c05f9b46776d3e5302574904925ed6bc27c6277c0e439d1ba7ece45947160dc4,990612,2020-09-30 20:57:04 UTC,29280361,29270964,false,9397,0
1310492da9371075117a6f8a1e03bc9b3f5203b3bf669a613dc49d807450dba6,990611,2020-09-30 20:55:38 UTC,500034020,500024020,false,10000,0
6f111bf7eff012a5f96e2182a5c47ae8824ec463f3bdc08456398b646ac2ca5e,990611,2020-09-30 20:55:38 UTC,10000,0,false,10000,0
9a7defa4a2544e1a87f4b33ab541bc73aa0db5369b63c69bbfac2b44ebf9c1aa,990611,2020-09-30 20:55:38 UTC,32517034,32499800,false,17234,990600
5af12b3de306e102142f3a7a57dbb94693992a000180a3299137a1cc2e4a2e9f,990611,2020-09-30 20:55:38 UTC,10000,0,false,10000,0
cd1c87d800ee809864b8e6d21196300288a68af230b5f05b701eeed368a2d28b,990610,2020-09-30 20:53:38 UTC,500044020,500034020,false,10000,0
55dc05ce10e38fa67940a85e10a3785693efc4b85fdf7ab4870b239d5b8fc63d,990610,2020-09-30 20:53:38 UTC,4226824,4221760,false,5064,990599
a0cb3a7306601318d1f4ca16f650e7d0c7d1699e0cb34748d18c9d4e316a0059,990610,2020-09-30 20:53:38 UTC,10000,0,false,10000,0
b6d13d0ffefd1d7305756ff31d07bd39e1f22c96079bd97388e44649d975f8f3,990610,2020-09-30 20:53:38 UTC,29868506,29859109,false,9397,0
e629978a30c874a71611aecbe979652de68d5c880eceae317c6c81ba93446c8a,990608,2020-09-30 20:51:35 UTC,465814705,465793233,false,21472,990597
30521d1443507b8173ad2ed5b1ffe50f295dfac2852550bd641bd808284a86f4,990608,2020-09-30 20:51:35 UTC,140965348,140961556,false,3792,0
980714a8302cb906b2df52da28421b5d67dabe2511a251ed682ad2b8e81a9947,990608,2020-09-30 20:51:35 UTC,10000,0,false,10000,0
60e98d86f1e6231da1a3c9c1985a7d9c2bb8efef5387c7e20d99cb8da58a569c,990608,2020-09-30 20:51:35 UTC,303442167,303434327,false,7840,0
20c1f55101d89ce4b89c3067a2b18dfc42de47ff0c8f6c7f1fbc916bb348715d,990608,2020-09-30 20:51:35 UTC,92377033,92373766,false,3267,0
a3c27964b1d2dca66638eea734d5a77c974581e82b149e4ca8a7d33610a0b4ee,990608,2020-09-30 20:51:35 UTC,1381730343,1381678218,false,52125,990597
04d06f457130edc0346d65ffe1fa5d36004c523c6ba0928eb963fb3752768818,990608,2020-09-30 20:51:35 UTC,10000,0,false,10000,0
00daaaa5927873b3cfc6fc2ff6bca30c9ffe48062104aff0a61e18e5ff9bec31,990607,2020-09-30 20:49:41 UTC,5000000,4998418,false,1582,0
1e23aa3e0ac3b20368aca563c37746eeb24ad9135c2397aa4505bd80dcb8d99e,990606,2020-09-30 20:49:17 UTC,10000,0,false,10000,0
eea624630d9f0dd4965c23e4a444c8ccb43e73077515720a1b0337ee63bc0556,990605,2020-09-30 20:49:10 UTC,905850026,905774850,false,75176,0
b45a39ac613435cc15b5091991edab1a1e85376f33b5e5a4b48da0cf4ac89d72,990603,2020-09-30 20:48:24 UTC,2099000605,2099000534,false,71,0
bb84ce45b861161345f3876e82f481c3245f84b093e583178552dc2cd4a91879,990603,2020-09-30 20:48:24 UTC,492533234,492531314,false,1920,0
c4d95484ff3af9ab7c328a11667600c9d8a9089c81f95f0c9d1c6b27242a11ae,990602,2020-09-30 20:47:41 UTC,2100843,2098231,false,2612,0
a7da54ae4dece58122bdd57c235280668fabb67c418ed392406c09e326dd9f2a,990600,2020-09-30 20:46:31 UTC,129193663,129190396,false,3267,0
7a6335015ac8e50839eee7986c672877cf311ee38d7b751031c1853d920402cb,990599,2020-09-30 20:45:55 UTC,10000,0,false,10000,0
699b2c190a1df403bb65dbbaf6bce338ef1fefb57d610ae629d748cfd3a39c3e,990599,2020-09-30 20:45:55 UTC,300000000,299990000,false,10000,0
a70be7e6a8af8f1c257c38fdd060413bfeaa993a6114e76b1f7feb02fa7a8438,990599,2020-09-30 20:45:55 UTC,608381690,608371690,false,10000,0
aa26dfc212ce370e268b645743bfa6a1511c2c854fffb76bc82deb8ca5d1fb60,990597,2020-09-30 20:43:50 UTC,10000,0,false,10000,0
4de721ea38f1ad4ac56ad2d457a1c8bbe8121ea6aad0c0cae326f7a60ef3d1ee,990595,2020-09-30 20:42:36 UTC,10000,0,false,10000,0
91df0af33bc11d6168be06f9cacdbb403fe09f50bfd3cf81c12767e7c79550ca,990595,2020-09-30 20:42:36 UTC,121207113938,121207111588,false,2350,0
775e1d484493bf0d3f1f0cf8a0f1e2376f84ab413725a4fe3e0cf83b364fd9d4,990595,2020-09-30 20:42:36 UTC,169373565,169370298,false,3267,0
9c9ab71ebcf65e7ee3547c3d219ec73b83ba222d5b25358832786a66d37590d9,990595,2020-09-30 20:42:36 UTC,29958607,29949210,false,9397,0
453c46efde167f3a92fb3015ff1c2cc077aee9c0d25f2c1eb178cf76ab381193,990594,2020-09-30 20:40:39 UTC,54253331,54250881,false,2450,0
086bafbef3ab2bf1f88f5b9134eb2417601ebc1891d1e6ac101587c32ea4913e,990593,2020-09-30 20:40:30 UTC,466525921,466500625,false,25296,990581
fbda2a9438a9c87e0c18f573c6ca7b4f9378b14ed9e02f5e64dcc2112b808aba,990593,2020-09-30 20:40:30 UTC,1383448941,1383398743,false,50198,990581
3d17df8fa9b6ff5ef75977c2c63612756b0d1ebd0229363720f8219049181871,990593,2020-09-30 20:40:30 UTC,10000,0,false,10000,0
fbf58fa2a8d5d40379387ea9bd93af57693045f51059b88f2d45fadff23f6002,990592,2020-09-30 20:39:49 UTC,2000041546,2000031546,false,10000,0
714ebd5055e8c3cf14d57d7979998302d44d2b2903363202ffdc3d6306ea5adb,990592,2020-09-30 20:39:49 UTC,14950,4950,false,10000,0
f9e7ac02c7188a6f2b5688e7e8cf06312188d6a75de2729b948b13738fbfb680,990592,2020-09-30 20:39:49 UTC,233113324,233103324,false,10000,0
b1e01f78539c02983c1673f16045087119b636808f25cbf6b393240545258167,990592,2020-09-30 20:39:49 UTC,1054452,1052002,false,2450,0
83cf9246c2b0ca9000857d516ff9619cd0b8d8a02b4a9611b5b97117cc788cff,990591,2020-09-30 20:38:39 UTC,92631922,92628349,false,3573,0
a03f9ef6255a29452886eac3798cae6f0b86c74fe099acc171faf75bebea6a7f,990591,2020-09-30 20:38:39 UTC,19154283514,19154273514,false,10000,0
8338a383ad40fab05f80b777d43e7906cc035f6f45372c38ce019eba78f1d24a,990591,2020-09-30 20:38:39 UTC,711638171,711631706,false,6465,990580
263c1ee32bbc130edb7af66dcdc07e556a8e565aea50abbcce7df1fa3544fc74,990591,2020-09-30 20:38:39 UTC,10000,0,false,10000,0
ecf5b12f599f6f0e90bd2584402589b1d6cb9e4761228ac90f147e5c29925c13,990589,2020-09-30 20:36:39 UTC,30072996,30063599,false,9397,0
4b04ea9177bf360e022af093b905dca262e944850e3f5123b6a0e48480da2794,990589,2020-09-30 20:36:39 UTC,1617367621,1617357621,false,10000,0
4897f82ca32bf8aa3c69d58ede27526c704e6efad608793fe500b3fdc8888fdf,990589,2020-09-30 20:36:39 UTC,19071278270,19071268270,false,10000,0
70c072db7fc7a142cd7317e6904345de17aa0c9a0c59a62a3694263284527fa0,990589,2020-09-30 20:36:39 UTC,129434680,129431107,false,3573,0
c2209b0eba4099b600cc6c5b8c791634d05e11c40d8c6fff45a75bc36b4ad424,990589,2020-09-30 20:36:39 UTC,10000,0,false,10000,0
dd1a9566f4b0331a4c2bed39882ebec49a92dfb1b8277db8971aa569381d840f,990589,2020-09-30 20:36:39 UTC,499980000,499970000,false,10000,0
84666a665c4897097dba7e5906e03486ca754806b69e86f8dcba3a96dc72b6ac,990589,2020-09-30 20:36:39 UTC,10000,0,false,10000,0
937f37a3358fbfb9e298f8ae8a1f57560cb49ebbd4c270a911d2b95ac233247b,990589,2020-09-30 20:36:39 UTC,30128456,30119059,false,9397,0
0087a3d437f0c9b6dfe0a39f5fa56de7804e863dd1eede1cc65a05ede0bb7d95,990588,2020-09-30 20:33:38 UTC,103568776,103565835,false,2941,990576
aace44ae9fccb91f91dfb4ba62921613c82a5f4e8e040e51d6455a13564edab8,990585,2020-09-30 20:32:59 UTC,461722369417,461722366805,false,2612,990573
2ec807a496b19f2ce4a2d53ebb699ed23cc0fc552af1ce4f1a662d15625bc064,990585,2020-09-30 20:32:59 UTC,9364275526,9364246576,false,28950,0
840fd0b44a9c2fffe60dd151778289239f852aed9f74078994b42b27b3d5b5c3,990584,2020-09-30 20:32:45 UTC,142037878,141962702,false,75176,0
c8e5750eeb9426ad9fc047212611ee430af8fe0ac4bc82429f793ed9a525972e,990584,2020-09-30 20:32:45 UTC,2416786,2407389,false,9397,0
312f9ae08fdc2be4250f8758c873b6e9977f6d07c14ed251368c78cff327b439,990584,2020-09-30 20:32:45 UTC,1076397435,1076395175,false,2260,0
767c2ee57a76aea816637b2a2aa14c39b64adf4a1d91ac1101413c4166fcce8a,990584,2020-09-30 20:32:45 UTC,10000,0,false,10000,0
561fded0c4bf3186cab6c713db55af04b771d099847b3f124afd7426ffdcc46d,990584,2020-09-30 20:32:45 UTC,30272326,30262929,false,9397,0
c0437d3f0cdf7580e4b9834eae6c0b2f4b67381f378b2f01f0a28dbc83b36496,990583,2020-09-30 20:31:42 UTC,10000,0,false,10000,0
040da3ccd89aaf568ee14f2ad92642f3ffcf9af15f341635e2c44f6a75d699a0,990583,2020-09-30 20:31:42 UTC,466988503,466967680,false,20823,990571
5ccda398a6424e3442637e10c9d0d8ee10dc2841b18158f0abf610740811956f,990583,2020-09-30 20:31:42 UTC,2084624611,2084624540,false,71,0
7f9aac4cc2ddbe2ec65457e0a2bc0a156490b295057f6232c9a0ffa546dd761d,990583,2020-09-30 20:31:42 UTC,90393360,90390910,false,2450,0
29cdb877c246072a521beb35e0f334f980991700df841858114d731db9dbb170,990583,2020-09-30 20:31:42 UTC,30314158,30304761,false,9397,0
cf5aa618585b268c7190a8a9585f2c7c512264d4ad3a8aa99883e66a2c1b2048,990582,2020-09-30 20:30:09 UTC,1031556075,1031456075,false,100000,0
6d0ed239e477e7915c2e6808c984f1c51c0f2238fc3ffacd53bc3ad3e270f076,990582,2020-09-30 20:30:09 UTC,1385242511,1385191025,false,51486,990571
2723bc50e9cbfa210672a7f7e25904d7c9d9c0883e013a87fbad7909f54ff5a1,990580,2020-09-30 20:29:08 UTC,10000,0,false,10000,0
de99f967ca43f5ecd193291251c3e8e3a1a95ff7696292706849f8c1ff96164a,990580,2020-09-30 20:29:08 UTC,169589714,169586447,false,3267,0
5d334e5bb2096faf68a8d780a724a437dc11b1e2c95bbe28e97bbb14755978d0,990580,2020-09-30 20:29:08 UTC,100000000,99997550,false,2450,0
cebcfb2fed09a6a16d2c47a065dd16d58b009f6aa53ea90eb61e4afbfa3c8a15,990579,2020-09-30 20:27:49 UTC,1994285833,1994275833,false,10000,0
1ade3fefd6dab3a2186bd8ea06e066c396f51fcdc73cc82ce56fd2726ffe057f,990579,2020-09-30 20:27:49 UTC,4884065,4878845,false,5220,0
d45d6e931a66a3b0bdc8b89dbca19f8a07a0ccf46e89d8fcc03301528450449e,990579,2020-09-30 20:27:49 UTC,30354315,30344919,false,9396,0
3c7b01e0475ee682bd20ea1aaaf276ece68bd4d07469a5de6f629d7c7f85b7ef,990579,2020-09-30 20:27:49 UTC,125000000,124997740,false,2260,0
1b144362d70cee531e94e97ee7a21b187588f2e54a41da6527c1bcc2cb4665ad,990579,2020-09-30 20:27:49 UTC,10000,0,false,10000,0
56af61e0dfedb6621839305135476d46d863fa073267beeeda6535373fb91631,990578,2020-09-30 20:25:45 UTC,499990000,499980000,false,10000,0
91b4d7ab7af1f843dd1639a6dab35aefbdbe4babdea557e7e70ea927d79ec41c,990578,2020-09-30 20:25:45 UTC,10000,0,false,10000,0
8b7c0c863e3215df99672a29f2019f5d1fac77d9d79d43b63742cdd9787db343,990578,2020-09-30 20:25:45 UTC,380590000,380189120,false,400880,0
c1f697c4de31e73596a1a0f77ddedbb67f59530a33de16f78d2324e877a41fd7,990578,2020-09-30 20:25:45 UTC,92805860,92802900,false,2960,0
c3332f84a9c86ddbd25c6804410ba4fe3968649cb25ae174842d106f9fafd129,990578,2020-09-30 20:25:45 UTC,3029102,3029102,false,0,0
060f062b0cad67872a6243e58d55bb261106a6770ff770c052823a316eb38b27,990578,2020-09-30 20:25:45 UTC,21158978800,21158968800,false,10000,0
b43eebe6a14cfbb85e093833d68666096580211960e582e1cedabdeba00722ea,990578,2020-09-30 20:25:45 UTC,129846988,129844028,false,2960,0
e91351800ed9a4af43d4769819ff28f3ac6c69c17e2583f8a5407d3bc723643e,990578,2020-09-30 20:25:45 UTC,10000,0,false,10000,0
92d36fe7bd49576e64c1a808b7f2b6374200dc28b5323500d557cd2a85e4f397,990578,2020-09-30 20:25:45 UTC,10000,0,false,10000,0
cd67016c7e3bc54d920f8301ebdd88c20053e531b2a93b8577a400b6aef5c082,990578,2020-09-30 20:25:45 UTC,58734,56304,false,2430,0
4cc2867dd3d5e314199b8a93e74f6e28127a1d67adc683405f39040b3fbfb7ba,990578,2020-09-30 20:25:45 UTC,30382277,30372881,false,9396,0
541c5e79d1ab8cc510cc06273137eaa68941661e75ac277280590e1929aa4ab3,990577,2020-09-30 20:21:18 UTC,233735111,233725111,false,10000,0
79db733049d34d41971cdcf2348c906b6250731a875e143fec09940c1134fcbd,990576,2020-09-30 20:20:49 UTC,1386735585,1386686388,false,49197,990544
6bd2a84a03a84d96cb4a1851a68b18eb91a70cf1b59fea044f6bd688ff9e1214,990576,2020-09-30 20:20:49 UTC,166586734,166568330,false,18404,0
2ae82c34c9fa32a32a9d0d876491e9f30947bb7bb973ea62f224804abf196313,990576,2020-09-30 20:20:49 UTC,467741611,467713433,false,28178,990565
4ac53967fc0f3e4a91d56ac5e0968ea6b5a8605dc2ae426419cd52b6437f6d17,990576,2020-09-30 20:20:49 UTC,13891001200,13890991200,false,10000,0
e2fa9ce408805d30db5e6b3b81c7f664a5c0ee1c58ff4f6a83852d38a1e21d78,990576,2020-09-30 20:20:49 UTC,500000000,499990000,false,10000,0
30832ccbe0cf3faf5ca047d745999c2b23f792b2e66c337f52e02ae0ae24698c,990576,2020-09-30 20:20:49 UTC,20744,14744,false,6000,0
4e7e5918995d45f17591b1a12dadfe9de7031b71baa93e8e1be353ec717650b3,990575,2020-09-30 20:19:15 UTC,10000,0,false,10000,0
7c14742b59e557cd20f2cdfff43e4879a59d4b1b4c95c67031cc8d5449be50ff,990574,2020-09-30 20:18:43 UTC,10110990,10108560,false,2430,0
0a44fd2d6bbe4092665b2c14d7f7fca36aff0f57f333c7ef991adcc543aec687,990573,2020-09-30 20:18:37 UTC,3040518,3040518,false,0,0
22568db25de0ff906b7f3f66216bda210a2680e862a5426eb9f10416be033fe5,990572,2020-09-30 20:18:22 UTC,499990005,499980005,false,10000,0
27fce3f3688a1efb098a252a83f8d4dd88bcb4da1d2975ca179af84d34503cfe,990572,2020-09-30 20:18:22 UTC,170345610,170342037,false,3573,0
7bb1ac1f80926b95d8070ef5a4a9676d46c4e7436e03f7bbf5968fbb4e26a66c,990572,2020-09-30 20:18:22 UTC,10000,0,false,10000,0
85b721f3ac8ac94656f746735d7dc50c12ef5aaaa3cd76873e6e2e35b23cb322,990572,2020-09-30 20:18:22 UTC,233767500,233757500,false,10000,0
65e66f041675276d8a96a408e45a1f61f397922ce05fc55f5b32ea0404d76a39,990572,2020-09-30 20:18:22 UTC,1005137,999137,false,6000,0
2ef3214047b82ad1fcc9a9600610656c5e8e7b313af9d6e00c3afee87db8f80d,990572,2020-09-30 20:18:22 UTC,10000,0,false,10000,0
84b5a10a72d1695d8980a1a5bc10454beec1571fdd95ccf8182d2e2469b18a66,990572,2020-09-30 20:18:22 UTC,5000010000,5000000000,false,10000,0
9e7a56d4ffc23ec930a691fadea69b41772c408c7b252866a0eda7bd9ce47ec0,990572,2020-09-30 20:18:22 UTC,500101000,500098698,false,2302,990560
c3691f98b7e4163edfc17afc6a6688d7549a284a566b4eaccc28a2e3323222b8,990572,2020-09-30 20:18:22 UTC,1103956675,1103591395,false,365280,990571
28102e14d421bd50a4e827dc3f87f27528a765d8efd95cc3c4138a0ab0b5bd3b,990571,2020-09-30 20:15:19 UTC,1417553362,1417478194,false,75168,0
82a1d0b8791b37bfb28bb7bad057c81133a1a1c7f72f35424d01627cdb90918b,990571,2020-09-30 20:15:19 UTC,10023848,10021418,false,2430,0
f47ad9881c180a1b3703bf6732a2cdaea821110edb6867088a432bacfbd42a7f,990571,2020-09-30 20:15:19 UTC,9900000000,9899997464,false,2536,0
b1bd9f8ecb44280e334c0a516acfc8890aa4a69465d01e3ec55ce0fe3b837371,990570,2020-09-30 20:14:55 UTC,2003852,2003852,false,0,0
265cdd811824c94eb67d1adb7fb72de1716b832d1aee6a1d0580cb2e768ec151,990569,2020-09-30 20:14:17 UTC,2392436060,2392434685,false,1375,0
c53c012e5aff71a0c033dfb2e567074d3e7c5e6df99398bc463f217739de667d,990569,2020-09-30 20:14:17 UTC,130064428,130061468,false,2960,0
f863a83f8d229034815c6c7d72b0f5aa5b4cc0ab997c7811d93041ff89b6de42,990569,2020-09-30 20:14:17 UTC,30411185,30401788,false,9397,0
16bd12e91b9ef0a89e8a6dfbb64383772f5a1a7db0d599761ee00f69a5bc2d66,990569,2020-09-30 20:14:17 UTC,93273346,93271086,false,2260,0
343928cfb3e9ab10a19737d2fdb14d56a8dc5aa8e23be45fca8a5c37f814c4c7,990569,2020-09-30 20:14:17 UTC,10000000000,9999997420,false,2580,0
a672b9ac0331ecced76e4b1991c620dd93c7069ab7f58dfdf7618ccce9f009fc,990569,2020-09-30 20:14:17 UTC,10000,0,false,10000,0
75502c60a496e47e81eceb22db95ec3a09dd4da32f810a61f69edeb7b68c10ef,990567,2020-09-30 20:11:48 UTC,468448580,468426488,false,22092,990556
b051d81bb401cc28a4622f4525dfa29859fa4a2caa1dbfdd79d6f201cb539b3a,990567,2020-09-30 20:11:48 UTC,1388176198,1388114883,false,61315,990489
577407e45ed7c5553d904afc1cff1e6c0eac076a983c2727d3d08388bcf634d9,990567,2020-09-30 20:11:48 UTC,10000,0,false,10000,0
9c72619a659640f87b492ed7de88de58b3c0b9393cc24cfff98d469f93c212b2,990567,2020-09-30 20:11:48 UTC,233767500,233757500,false,10000,0
957005dca31b79635b6dd93b36eb6a4ea8d90c115baf2098ad934478ec57ae6e,990567,2020-09-30 20:11:48 UTC,28104292648,28104277068,false,15580,0
37700fec06b9b392894923e985e3fa248a7de3554baeb7576d32fb59805ef79b,990566,2020-09-30 20:09:52 UTC,10000,0,false,10000,0
f8e0d97fdad05d6f5c4d649e6b4e5e3496ce1b7064529051ce0d752e0b18945b,990565,2020-09-30 20:09:39 UTC,92982299,92979339,false,2960,0
54f58f9015ff0f9d417767f58d041afa594f9be4d2285ec16f07f163785a8b70,990565,2020-09-30 20:09:39 UTC,10000010000,10000000000,false,10000,0
9c09eb1c75634a05a20340335311d104858b2590c6eba9aa10fbb3811f04f36f,990564,2020-09-30 20:08:59 UTC,10000,0,false,10000,0
a1a2279a5fc2c59f4799d6a2dfd65c1f97bbf6b3a9c1b71ea8202198e27f295c,990564,2020-09-30 20:08:59 UTC,233767500,233757500,false,10000,0
b1c340b92647f593de3a7d24f53f0fde82ca233ba2373636a8ea5efcf27fa17c,990564,2020-09-30 20:08:59 UTC,65050808,65000027,false,50781,990553
9804ea29decadffc1a85d81cb527a28c64d5f7457e304f1edde1b98933a19425,990564,2020-09-30 20:08:59 UTC,10000,0,false,10000,0
f8ddb8001c79f43a3536fc1a4a17941465a0c61b3425f0a049cc71692cdb2c57,990564,2020-09-30 20:08:59 UTC,47500,45050,false,2450,0
5a5325f77ff098caaccd37bb1cfbcc9a552382167fd9bc56c2d504d9f3115c20,990564,2020-09-30 20:08:59 UTC,170511520,170508560,false,2960,0
5c844e65f6d8e253618eb5c035ffd04a69703eeb63c0d46d731b7072ad784770,990564,2020-09-30 20:08:59 UTC,30533931,30524534,false,9397,0
a2dd7e25ff3758236dec59e9a34e038c46898dbe60576eb7d744a91313abba96,990564,2020-09-30 20:08:59 UTC,2000051546,2000041546,false,10000,0
cfe12b4a0ad9b61aac4f5cb8322059f3247401690b78f820cfd6d7ac62eb1796,990564,2020-09-30 20:08:59 UTC,1500000000,1499999755,false,245,990553
3a3b219a17de8e1c4b8015d9a1103195ee2b1f728388b2818927d3865bdeb0b4,990564,2020-09-30 20:08:59 UTC,1000046380,1000036380,false,10000,0
cc4360666fb03f66e711aa320091987e974bb8e77269675e9ea75c974fc19d43,990564,2020-09-30 20:08:59 UTC,58880,46880,false,12000,0
3df6ca91c51ec39092a3a9f984897b8c83bace51f98e7330a7298d04ff958610,990562,2020-09-30 20:05:29 UTC,470721871719,470721869417,false,2302,990550
f551f457b326bdb636c45af3f5d356c6277e80b499156d838487464c645c3241,990562,2020-09-30 20:05:29 UTC,1500026177,1500016177,false,10000,0
3331933bf7ae0e8a1bbd5f5b4d0daab494b6bbb15ccbad1e4b59ae97eaa78390,990562,2020-09-30 20:05:29 UTC,10000,0,false,10000,0
6baa42a83b4ab8aeab43fa30d4b628bec814b71171cb6bb247124e5ada81aa2c,990561,2020-09-30 20:04:42 UTC,140223740839,140223738489,false,2350,0
22bc68f09358fdf85aae4ec8a0cb4c8e67692766aba31335abe123550be2c2ef,990561,2020-09-30 20:04:42 UTC,238032962003,238032952003,false,10000,0
aac7af464f98b8afaea6299fb18a75afd2aab4856a2da74ba02e080b3a0f38ba,990561,2020-09-30 20:04:42 UTC,3000691622,3000681622,false,10000,0
49a6eddbea79c93bdac8be43ac2d85919982356af92accfd5cf94963ff26eb41,990561,2020-09-30 20:04:42 UTC,130302042,130298775,false,3267,0
71ca5987da95a4d1433313d3beb862570747f4810ed94e4594edae9ad2b711a7,990561,2020-09-30 20:04:42 UTC,459250,449250,false,10000,0
40feaa5dad2dd876225c5c295e492d69be77265b8715827dbe67c3e42e64c157,990560,2020-09-30 20:03:49 UTC,10000,0,false,10000,0
6a8c314a84cdb49598befed1f84b670ab3371bb58bdb4224ac27694aad53bd0d,990560,2020-09-30 20:03:49 UTC,383710,381260,false,2450,0
2b5bcdb9ed46ab9b51210800ed847bd2aff3e152adba8ecf5876ad6f4b6633fa,990560,2020-09-30 20:03:49 UTC,10000,0,false,10000,0
444f03a18e717144489c675c8d1e308aea391facf3ae027179d81c2f90503eb0,990560,2020-09-30 20:03:49 UTC,796264314,796261864,false,2450,0
a897bdc9d272baa5aa566c8f11d5bd4e06760e1648def0fa71bf3344f5274ee4,990560,2020-09-30 20:03:49 UTC,291947825,291945375,false,2450,0
f3b0e958d1ed48f9211f8d9c6f3e74bd7255ae80e710c1e937a9eb2b87d109d5,990559,2020-09-30 20:02:12 UTC,860614108,860610528,false,3580,990548
2741a111b53c1f77b5da8653d814ca44b16caf8ad89f9855b87618a3af6530ec,990559,2020-09-30 20:02:12 UTC,100000000,99997550,false,2450,0
fbf54a0e8b5d1434398e47331def76a8d362a825d296d9af25f75e8dba93b533,990559,2020-09-30 20:02:12 UTC,200000000,199997464,false,2536,0
b83544c49186c4c3d0b144653e40e8d70956148eaaee65f984e2f2c952cb7059,990559,2020-09-30 20:02:12 UTC,30564707,30555310,false,9397,0
5183b2af20b7dfdcddc361313c412e20cbf20498d783ba4232179f685add0dc3,990559,2020-09-30 20:02:12 UTC,10000,0,false,10000,0
6278ee4c34622f3c98c101e62dcd2954bbad1be0323a84c7fbdd3fde5c7bb704,990559,2020-09-30 20:02:12 UTC,10000,0,false,10000,0
176bd40aa0f1ba21d2cc0eea9f131c3a8f42779d6ee6aea2708370d0fd207f3e,990559,2020-09-30 20:02:12 UTC,12029559,12024485,false,5074,990548
94d3de512c98351afd3ccced91eeca5643a3adfcee96b79ca95770628d726ecd,990559,2020-09-30 20:02:12 UTC,468881344,468861150,false,20194,990548
86d4527256a6b262e5fd8f145617d3d580f53e53fff5494a2bbe0acce2e7998c,990559,2020-09-30 20:02:12 UTC,10000,0,false,10000,0
c494e751c78ada673cf9c8e60432fdec46d03e13d17c55cc6b58807ffb47076a,990559,2020-09-30 20:02:12 UTC,1389612580,1389553426,false,59154,990548
14df9250e9e2b0f94fa82dd011c2c28c0586bd216df1dfa7999afde3f2270aa2,990559,2020-09-30 20:02:12 UTC,500000000,499990000,false,10000,0
513d58d054af871a5e7fc1320c154e4f341bd05810a6f8fa770ab242eae05970,990559,2020-09-30 20:02:12 UTC,10000,0,false,10000,0
10b3018acd54d13cbdc5dcf155ed69abc87bcf8bbdfaa5546655f6df7655ffb1,990559,2020-09-30 20:02:12 UTC,129734458,129732156,false,2302,990548
8877c696a627ef83f0928e2463e414738e368fe703fdda202a6573018e69545d,990559,2020-09-30 20:02:12 UTC,1500146923,1500143663,false,3260,990464
af060f20987b21db4b702d3ce90c85d257a83bfe10ca01778cbe7bfc6f76666e,990558,2020-09-30 19:58:05 UTC,6453479624,6453477364,false,2260,0
ba40e2003b10afc057c05bfa3cf549363365faea3f9b196775dd76f33a823109,990558,2020-09-30 19:58:05 UTC,30957814,30948417,false,9397,0
261c7deef38e3cb6143bcfd3fa7f6ace5316bfa186696e0840f311b0ec080256,990558,2020-09-30 19:58:05 UTC,1281086,1276031,false,5055,990547
0bb029afbeb7a811531e0b451007cdf721655780c899c115e4937a596c4d47f0,990557,2020-09-30 19:57:17 UTC,659530000,659520000,false,10000,0
4c9fe1b37b20f4be8818936d4b7addb0ea58599bea1654ec0e19073a0c12cabf,990557,2020-09-30 19:57:17 UTC,10000,0,false,10000,0
499a61dd053988af89db21dd47e4a468f3163177af9c5c6bf97905b06bf895c6,990557,2020-09-30 19:57:17 UTC,93212985,93209412,false,3573,0
1f45504f2f214fba318c1bc3a7c2d76d98b25c48b8d0dca18808832d2d9c6b9d,990557,2020-09-30 19:57:17 UTC,293278566,293273346,false,5220,0
b8a033d2ef84aa47d2e9ea56da8e3539c14c717beb86096c260fcdf6793b5501,990557,2020-09-30 19:57:17 UTC,427617139,427541963,false,75176,0
365ef8cacbad43d215d3c972717401a37457c9c5fbd3b98c1a3702c2262c29b4,990557,2020-09-30 19:57:17 UTC,19071288270,19071278270,false,10000,0
367d6f344d37c3542bde8d77c0a2d4cb978616c70a969f54b0650d0bc4eca9f1,990556,2020-09-30 19:55:10 UTC,10000,0,false,10000,0
42039360c4f70ef781191f33f78cf079db85d96cb62ceb36ee74ccf947e69654,990556,2020-09-30 19:55:10 UTC,19586443837,19586433837,false,10000,0
a5f89f01bba60671943b1f418709cdc40b5c715f17d5cc4ee051d3e1cf292166,990555,2020-09-30 19:53:29 UTC,67434529,67432227,false,2302,990544
bc3852c048ccd3e42e88dd5a1533e39467b2fa753eba7b918decfd73b87fee69,990555,2020-09-30 19:53:29 UTC,10000,0,false,10000,0
d28ede03a0c8ea64529c575d548a44ecbc2a6f3572d1ae4ce1f13a61b2c3c01d,990555,2020-09-30 19:53:29 UTC,353564614,353554614,false,10000,0
7c1c7dc72dd06ae304939ed8dcd591e20ba4e9937af71a72c51a9f240830c5d6,990555,2020-09-30 19:53:29 UTC,299578080,299575630,false,2450,0
5432926ed9771c2c991c48a4ec9e411412180af2debdb2cf3f70d73aa076ab7d,990553,2020-09-30 19:51:42 UTC,1390679520,1390624219,false,55301,990542
00735e6db8946b2769159576298f68db41cca6733ea0d8f53a9510bb2bbd84d4,990553,2020-09-30 19:51:42 UTC,194660257,194639211,false,21046,0
d0057b168761d07d51edc565457810ae66cc5510a69eb3d90fc0b55ed1369ccd,990553,2020-09-30 19:51:42 UTC,37764506,37762246,false,2260,0
bdd3b7568901e68f6e9c93c5a2a12ed97607c8be1e8692d238c658fbd0e7e0b6,990553,2020-09-30 19:51:42 UTC,162448942,162446650,false,2292,990542
597751ba14142e3745f79d551556b8944c3fa5a613f486954dc0a53cde95ab61,990553,2020-09-30 19:51:42 UTC,499980520,499968435,false,12085,0
3d65ac64d02fb82fd562249fde38bde7608eef0c6c0e0095a717316ad37635a6,990553,2020-09-30 19:51:42 UTC,10000,0,false,10000,0
af86e1b2cc1717da492c6fbac8f44451c6150fb3be8470dacc97bcd46e8d7641,990553,2020-09-30 19:51:42 UTC,469536216,469509332,false,26884,990542
0bb24dbb9e25df64ad7ceac95e58c45cbe4413fa866e03ffaf6724120147d1f7,990553,2020-09-30 19:51:42 UTC,10000,0,false,10000,0
b91d403e92487c058d9f09ad0301daa30e8f0515752af69106d2773426e08a13,990553,2020-09-30 19:51:42 UTC,12054898,12052468,false,2430,0
6e67cd23aee1ba41bc5f50e9e6da40bb7db00d1e7135388d6343ff018655439a,990553,2020-09-30 19:51:42 UTC,10000,0,false,10000,0
1ede0501a45abeae2a05c46e2894856e876482bb31186c84881cf69cbfce07c1,990552,2020-09-30 19:48:40 UTC,1109997726,1109995424,false,2302,990540
97ff3d084dde057e0593c2e73c5e43e438a806d843ac00bac8117032537a411d,990552,2020-09-30 19:48:40 UTC,1206888,1206888,false,0,0
5cb3e3f7a45526f3d539478bfb917b60eae10ccf9cad56eda31e4a55001fdf5e,990551,2020-09-30 19:48:01 UTC,113194083,113191791,false,2292,990540
60b88e6a1e6e438be0f80daf05e00a38a8af88ccc65852c2403fabb5f8f56761,990551,2020-09-30 19:48:01 UTC,176038432,176034692,false,3740,0
0d58fb08764e7f2858e4540f6613c5885b24b7fb89e4aa365a491b2d5358797e,990551,2020-09-30 19:48:01 UTC,370177526,370175224,false,2302,990540
cd657443a661784f83585c418e3162ac4054ce734c5d00137cff7643c4df32a3,990551,2020-09-30 19:48:01 UTC,170683427,170680467,false,2960,0
035c2285cad99a52d05a4232675d853ac139ee54a3d0a37e41832f9c09461f4b,990551,2020-09-30 19:48:01 UTC,470840299776,470840297474,false,2302,990539
1c326cafe99f69577aaafe89cc99ad251f63a378ba160c4e323e456d6a7bc774,990551,2020-09-30 19:48:01 UTC,51550601,51547691,false,2910,0
cb78bc5ae1a46578d84f0f32561fe00326c4bafb991a9ef7733dd7a6a561eb91,990550,2020-09-30 19:46:24 UTC,31029932,31020533,false,9399,0
72595d2a9d24693ba9696db4dffc4a115d4fd791eccafed24b62233526b41f28,990550,2020-09-30 19:46:24 UTC,10000,0,false,10000,0
a368c9d4fa868e7697d6cfd6760a595c0945c1d09b3eda9de29e3afccd7b3e27,990550,2020-09-30 19:46:24 UTC,182232,172232,false,10000,0
11e28ee79c8814868d2d534424ca77c3b25fb3e43cf2dab512d067dcba2cc967,990550,2020-09-30 19:46:24 UTC,4996639,4993729,false,2910,0
bc113ba509866c34099be63795cd0da6a50436a55c43387d7b80f096ef534ace,990550,2020-09-30 19:46:24 UTC,80688975,80678975,false,10000,0
f466cdb03c198d60a44d4431748305c42679e2f9b7358f7ca228c8380cb11ead,990550,2020-09-30 19:46:24 UTC,1000000000,999993220,false,6780,0
c72b78aa82a826aadc80d56ccc0eed0dbe6b8ad6f47238b016edba9127861fe1,990549,2020-09-30 19:43:37 UTC,70793586,70783586,false,10000,0
7ab55738c0f3118e797bdc3071abf4703384307a177e01b5a733aa64c8f95f09,990549,2020-09-30 19:43:37 UTC,10000,0,false,10000,0
d8f96aeeab6bacf6a23494adf0e222fae5706e663fb802c8f4a10c423488231f,990548,2020-09-30 19:42:37 UTC,10000,0,false,10000,0
32ed2342d407007993cca7deef610640523964237ae9eb622f5368120cc02f00,990548,2020-09-30 19:42:37 UTC,497852,487852,false,10000,0
b3115fe6c34f15b70784c610f0a687c5c16c8be6a86da05fda294e936dda9498,990548,2020-09-30 19:42:37 UTC,499500000,499498080,false,1920,0
9d4bee4b16b4e716c276813487b60871b36e4a6703b6c7e29147d261cbd152b2,990548,2020-09-30 19:42:37 UTC,470965302078,470965299776,false,2302,990537
cf27c2e4ad73571ec1c255afc9b76b1b0c119d7f152a982ee90a6afca9b07c7c,990546,2020-09-30 19:41:23 UTC,10000,0,false,10000,0
5f382289118cf093f825f44a1f7eaafa1f05b8eb8a788130b57dcf39b83d83ad,990546,2020-09-30 19:41:23 UTC,1391875745,1391821729,false,54016,990535
035633076e547bc27d1c8659644c0332e4a6ae833095e05c0a3369c3482da8f4,990546,2020-09-30 19:41:23 UTC,10000,0,false,10000,0
e23fd56d47b046f9bbade6f6525f6b9cf7a725e3089609954d89160d4e5fbf61,990546,2020-09-30 19:41:23 UTC,250,0,false,250,0
bc766e75521a41f117b992e70abdcdf39f2f78da41a61d0912f909ce0234cd58,990546,2020-09-30 19:41:23 UTC,31030094,31000065,false,30029,990535
3204383dda8af58a256598bc9683309ad5ebffff863de07d0dd89ddc3b8c4b5c,990546,2020-09-30 19:41:23 UTC,846139726,846064534,false,75192,0
1602621633075f4aa857c843bd268f9c5af9a3850b660ee551fd956032c96ab7,990546,2020-09-30 19:41:23 UTC,13428733,13422733,false,6000,0
7f0efdac82a84fc7d167cc648000b8493aac40d6f76ea4c87f33dfc0573357e4,990546,2020-09-30 19:41:23 UTC,10000,0,false,10000,0
3abe970fc98e51e67f92758ef32fba339d404b6af2b6cd48b218c2199eb7dee9,990546,2020-09-30 19:41:23 UTC,13816254,13813344,false,2910,0
8b2e2df3051a76ce9cbc97a69b3a402fb57d8fa80a3a78b9ed6853797884759e,990546,2020-09-30 19:41:23 UTC,499999398,499989398,false,10000,0
4a0dd1f52080ab4a4af4cddd294243ddbbfb5d3e53cab157e00876b4df987392,990546,2020-09-30 19:41:23 UTC,620392250,620382250,false,10000,0
5cdbb131d068cc30d47ca47fc6dd326af03d89fd69f04c7785e185559d316b92,990546,2020-09-30 19:41:23 UTC,1500156923,1500146923,false,10000,0
de1dd388ab735de82c4ed821ac88ad8bf0aa1b7834a8cf87adf2294050a8b10b,990546,2020-09-30 19:41:23 UTC,470285198,470261165,false,24033,990535
f1fd6d31e633571b4194e87b8e244f6c81a18a25cd2c557772b31b592f17e081,990545,2020-09-30 19:37:41 UTC,31069087,31059688,false,9399,0
d582fa5a703fae4567253f4e4aa91134e1f2bdc45dc38e9a0d274fc15d382663,990545,2020-09-30 19:37:41 UTC,130804442,130800869,false,3573,0
16369b07aed9398e3c8b9dcf7bceb88b836ec6038eaa809ac830a189087bbfce,990544,2020-09-30 19:36:53 UTC,10000,0,false,10000,0
422e44fac88f361b4f884dfa2a5458e4a379ee65dcec4ec15f9db57b4e6088f6,990544,2020-09-30 19:36:53 UTC,10000,0,false,10000,0
cb308c718262fb78a332f0033f6f1e478b32c356cf976f503e23345d983ec2a8,990544,2020-09-30 19:36:53 UTC,10000,0,false,10000,0
783afd5e0095b5c73b79409202fc5507a4562fd8a60b8cc0004c141e086e202c,990544,2020-09-30 19:36:53 UTC,49908892,49843332,false,65560,0
60cf6141d0ac6bc2a661ab0650eebc9367b74d8f8d9f620ffe0c9cf73f8e30ad,990544,2020-09-30 19:36:53 UTC,500986674,500984754,false,1920,0
a8a8660b0c36d57347e6d28b0727536b92e6b74e3d7a13e1bc4ddd247f25e5ba,990544,2020-09-30 19:36:53 UTC,500009398,499999398,false,10000,0
0ac6364ac4c37f045e57645fdb469b873f0fced859fa4ff57abd5128972af90e,990544,2020-09-30 19:36:53 UTC,31098934,31089535,false,9399,0
94fbc66e1036423dfda5c17b3d46f4b5194d2e26d9159658f29ab9d1507030b8,990542,2020-09-30 19:34:06 UTC,93384420,93381460,false,2960,0
41e4e17ee6e069fcf2b04bcef2e43468abd39a13adcb4a23f65e647767c8fc8c,990542,2020-09-30 19:34:06 UTC,12056818,12054898,false,1920,0
69926d94d2f2ca739c81669cba087c69a08981b1a16de5d21127bf647e82e73f,990542,2020-09-30 19:34:06 UTC,10000,0,false,10000,0
56f824d3caedf5391022a38f17879e1a67af43703c454f3395b83c719d0520a1,990542,2020-09-30 19:34:06 UTC,644897207,644887207,false,10000,0
45bf7d2ab987879ea532e906319e6a3cbbb7a6d757bab010d54afb4046ebcd35,990541,2020-09-30 19:32:28 UTC,2999931115,2999927431,false,3684,990489
ec7c7786ce4fd89b27533af39c0f0701ced70f3c8d0a051aabbf0b95b4206052,990541,2020-09-30 19:32:28 UTC,10000,0,false,10000,0
2f2a0e42adad9ea83a57bd9d0e153da055d28c228e5895759ad49b96e8254678,990541,2020-09-30 19:32:28 UTC,27468275,27465365,false,2910,0
1aa8111cbdef086b6526cbcf86e3fca558b6f25b3ff2df0bfb147c0848ab4434,990541,2020-09-30 19:32:28 UTC,170839223,170836263,false,2960,0
b84fec3dd861a5e3f190284451d2a0a1b8cfb45cd349e8647d2a18a83f968463,990541,2020-09-30 19:32:28 UTC,1393163053,1393105193,false,57860,990530
bf5baa4b927f23c4aa15567a5698e7d6a9f9e640afe3208b366773d0f4de372f,990541,2020-09-30 19:32:28 UTC,31289680,31280281,false,9399,0
47c2c6f7ad40642a91fad62766250236d6bdfab5b5a08f06da76378f021c9174,990541,2020-09-30 19:32:28 UTC,31141050,31131651,false,9399,0
3b7b069733a70bf0863ec1d417bec9026805272495adae1382f8406e0aeaf4fd,990541,2020-09-30 19:32:28 UTC,9997740,9995820,false,1920,0
da070c7c712b72ba07eac07b562f1506bd8e7dfa002dcb3a4a71ac881474226d,990541,2020-09-30 19:32:28 UTC,471925408,471901056,false,24352,990530
57acc07fe4da2313cd7b56593b7cd368df663776328ed122d5676c68f419e1d5,990541,2020-09-30 19:32:28 UTC,10000,0,false,10000,0
42a84588f116099b10a0ac1d24be044cb92b20984b9f7e0871b92a28df775d62,990540,2020-09-30 19:28:42 UTC,31440760,31431361,false,9399,0
dbee0b6456b94344bfecc2eb01bb72c2e9d38b94406970fb62e6b6e63da5e966,990540,2020-09-30 19:28:42 UTC,10000,0,false,10000,0
6c7c0ddedd32a50d3df96e43e1bf37f2c2ad68d511bff3396adfebda4f2fe0ce,990540,2020-09-30 19:28:42 UTC,521302525,521292525,false,10000,0
98b09b99af993b2a743cf754cb205243b5ee063984399b47d77d96a56edcc6af,990540,2020-09-30 19:28:42 UTC,260140398,260095638,false,44760,990538
aa7c77b76bc9197198bf01741665b14b3459a587cbce58e79bade7f0a95dd0b5,990540,2020-09-30 19:28:42 UTC,209706877,209702377,false,4500,0
919ee5a32156bdf9a7172d55d851dc23c028fbfff2339a489e85429ecf3bd4fe,990540,2020-09-30 19:28:42 UTC,1999980000,1999970000,false,10000,0
9e68ed0a10afca1c14997e431035e49a96e92dbc9c4f70a91b785e329b6d6f5f,990540,2020-09-30 19:28:42 UTC,186438,176438,false,10000,0
b65a5fa402721b0e7e75f18aa18b8b1859daac27ea9ef34b9dc4acb8b9a3636f,990540,2020-09-30 19:28:42 UTC,747273235,747270699,false,2536,0
a69a7a3039225bae2d308723d576b9eb9ba800b5d67d03055d11a42d789c13c2,990540,2020-09-30 19:28:42 UTC,10000,0,false,10000,0
baa22e904fa7276058da07f41c1bbddd840f5be65e45feb1ca7ce712a6c57c9c,990540,2020-09-30 19:28:42 UTC,130964229,130961269,false,2960,0
229f413ba2807dd8add8d3a8e06046099b562e4caf217ed723515c7e7d85ab5d,990540,2020-09-30 19:28:42 UTC,10000,0,false,10000,0
c473dda26a8915a3d41607ded3da5d4de0d79629be4d8235f64e1eb63c781365,990540,2020-09-30 19:28:42 UTC,415657572,415649732,false,7840,0
9b98c74ec86ca5fd6b35203ab96716c1738c1c5b4095e155556bd7070145082d,990540,2020-09-30 19:28:42 UTC,747275155,747273235,false,1920,0
610c088a2e7e8fec9644aa5ef9793dbc80b1272d80a0b657626ddca3022561e9,990538,2020-09-30 19:22:34 UTC,300000000,299990000,false,10000,0
aee8ea7b1031b4be991930956c8e3ffb5e21a3e14bf1fce16bd67212c6dc8f9f,990538,2020-09-30 19:22:34 UTC,10000,0,false,10000,0
5cdf6ed7ea11cc9c07966a1186b1cc0ad4df59973442e8d3302c3551431fc516,990538,2020-09-30 19:22:34 UTC,32957,26957,false,6000,0
f81002366ff6e4730318dfebe60c26c7bb022f21f41b99378a1c10218bc0edb1,990538,2020-09-30 19:22:34 UTC,93595488,93592221,false,3267,0
3b35b5ae0119f6007ec4f035245be09654e0c0c44720eba9b97df6a2eed7d722,990538,2020-09-30 19:22:34 UTC,31485273,31475874,false,9399,0
34bcf3eea6098dcacd1000c50e3b6433bb8ab7c5ff7737b422e390b0005c6677,990536,2020-09-30 19:20:37 UTC,14862149,14855682,false,6467,990474
711d40526af36af9ceddfda1d944555a7c939aa506c879be2a6240f48490ff13,990536,2020-09-30 19:20:37 UTC,167241339,167076069,false,165270,0
40b9dfd59dfdcdbe734c513188472d0fb9f53c0cc0366b857941721abad1e86b,990535,2020-09-30 19:20:12 UTC,70000000,69998080,false,1920,0
ddcdca0bb0b91f8bf5973a82ce4091cd7442a4fecedbb7b08f338d6bb11dc8f3,990535,2020-09-30 19:20:12 UTC,1394752366,1394685572,false,66794,990523
6e0177263d8c879186fd60551eedb3e1f88edfd5dd7ce5b7c35bc5aa6ddb5f70,990535,2020-09-30 19:20:12 UTC,10000,0,false,10000,0
7fa420473a018374e870cb93d957806012c6a8c4c28a35a2d57ff3c239f5f331,990535,2020-09-30 19:20:12 UTC,9425067937,9425065487,false,2450,0
f355ae540cc4198b446d24aecb85b4a1d06022a41e2b56c93f90d6e13c0c1c5a,990535,2020-09-30 19:20:12 UTC,472542106,472514872,false,27234,990523
7c99766c4f3abdf74e4fb77cb7971dda4a7b721493145398008b8e7296b2c6e7,990534,2020-09-30 19:19:47 UTC,73629862,73574914,false,54948,990453
e45cddd29f4bddcef096acacb5813c0f46f5ed74c886669f77b8bd08f05bbf95,990534,2020-09-30 19:19:47 UTC,473687104371,473687102078,false,2293,990423
71e7008ff78473cfed6de8fea5595aa5dd176ee95c48a0dd29123ff35ba96c39,990533,2020-09-30 19:18:59 UTC,10000,0,false,10000,0
3099d741962225110d0e39709b381efe17c28f957c6c46662be612f860edbddb,990533,2020-09-30 19:18:59 UTC,281313082,281237874,false,75208,0
50faae544142e4165782a49c6c34608b8af473b4371e7392f054c980d2c69944,990532,2020-09-30 19:17:45 UTC,10000,0,false,10000,0
6498a54ac1d0f07fd35013499bb02bbc0b79a36c1af855b18294ed4129e1ea8b,990532,2020-09-30 19:17:45 UTC,19970000,19960000,false,10000,0
1353f63a8814aaf544b03204b6041b29d32c59f565dc3a2ddea3fc30753d7132,990530,2020-09-30 19:15:55 UTC,180385534,180383231,false,2303,990519
87d0eeca521d33368f4c31e1ddd88573e9429b2896236419c324b41de69b1648,990530,2020-09-30 19:15:55 UTC,475187106664,475187104371,false,2293,990519
e39a2a9cec081d09b027d1c1aa76a589eda3e1d63a7f1f088e52f059f94e5483,990530,2020-09-30 19:15:55 UTC,85521309131,85521299131,false,10000,0
ec0113cd3a4bc777354d6defd8d8ddde07563934a3ffc5656ff542bd578c7545,990530,2020-09-30 19:15:55 UTC,304647750,304641750,false,6000,0
d23145c0d3b7fbd38c6451daa850e44695cd14963bf2a3a2a316895ad7747120,990530,2020-09-30 19:15:55 UTC,3400000000,3399997550,false,2450,0
048494e363f05370f9c633e6ca3215ae246312fcfc88b8238bffdb38c3c084b0,990530,2020-09-30 19:15:55 UTC,31533525,31524124,false,9401,0
56027ea290e4a0354fca06b0feeefbcba62a0dadd9d0013a2aa7bad879e3ec3a,990530,2020-09-30 19:15:55 UTC,171031899,171028939,false,2960,0
91e30c8e7b0f7a22a5fc195d0e8c79e6a1142cf489304f423249296eefd0fb13,990530,2020-09-30 19:15:55 UTC,2023129988,2023128988,false,1000,0
feb4e2785b4f718d25da73e38c4dce012b07ce94cd58322f57a340c88b5093be,990530,2020-09-30 19:15:55 UTC,31662604,31653203,false,9401,0
ef18abf2094e5c44a32896e07f9e4c95a00fa80bad253e866ac0db5130e5dce1,990530,2020-09-30 19:15:55 UTC,10000,0,false,10000,0
4d432d74864baba8e2bd799aea48d7fc3b9caad298992e87ba9cb0f6a762ff9e,990530,2020-09-30 19:15:55 UTC,19086464439,19086454439,false,10000,0
5419c0363a307c18baebb289c3c7e8249471d6dd58d4fb3a8079920c800a8469,990530,2020-09-30 19:15:55 UTC,10000,0,false,10000,0
784e08aa168a75aa9fd9691249863f4f28e76f46790528252b1058d2835fefbf,990530,2020-09-30 19:15:55 UTC,1002449,999999,false,2450,0
990ad232c379d7a5faf602f570cfc886f02dd849ab42316956cc25be7e73925a,990528,2020-09-30 19:11:27 UTC,19305752267,19305742267,false,10000,0
9772f126391ba8b598a83994f2c930ddefcc88e477687ed17b33c43dd062c61f,990528,2020-09-30 19:11:27 UTC,10000,0,false,10000,0
726ac0e705843daf04deb70510fbec7cf6b24a3780e9717feb4cfdd5e3849b74,990527,2020-09-30 19:11:10 UTC,31711637,31702236,false,9401,0
04731f61fce7feee85bf2125980ac136ed172a0b0ffb1d90a06502022a05226c,990527,2020-09-30 19:11:10 UTC,475287108967,475287106664,false,2303,990516
694d2319a8ed1249ee96303bfd43d282ec78d3da5bf7f8c03981537055b0339b,990526,2020-09-30 19:10:14 UTC,473218314,473186605,false,31709,990514
0f8a8fc1786f1c24e598fac948c2ab63208f38e5611c3d62f12f2c926f4f8913,990526,2020-09-30 19:10:14 UTC,168307895,168287005,false,20890,0
436dc02ed2c02cbe9e430f6518c2b1fdff7fe0cc086fc95c2d10d380d4e98b3b,990525,2020-09-30 19:10:07 UTC,500003879,499993879,false,10000,0
8da132ce755793b2ab7ff02566aee7891fed68f56d419f2e0d9f28a73f26885e,990525,2020-09-30 19:10:07 UTC,1396065972,1396005496,false,60476,990514
058adb1aae9a7c7e5c0d222919d6a7803a9f99efb43b76347940a91d17a657c1,990525,2020-09-30 19:10:07 UTC,10000,0,false,10000,0
44795978cd61261a0a122b0d2728fa6460b50f71c47dca3225ce310e6156bd14,990525,2020-09-30 19:10:07 UTC,19305762267,19305752267,false,10000,0
78c91c2b764b907498685bdcb7a8fa9871149a156958b84122c7af4b1e4ccf5f,990523,2020-09-30 19:07:03 UTC,10000,0,false,10000,0
242009464d369ceedc5a350ae54b45a31515ae104135ea2684b8451c42db14f4,990522,2020-09-30 19:06:18 UTC,1500036177,1500026177,false,10000,0
c9471dbfb1c111d580fe8bfcf402dd230d6a308f2a91a4f5402ad481b44e6472,990522,2020-09-30 19:06:18 UTC,1023599,1021149,false,2450,0
09ae7945a44361afb45297555452cabb581ac34b2c47a06f49f9bb87ef8ca822,990522,2020-09-30 19:06:18 UTC,2500561712,2500551712,false,10000,0
3f1ccaba6f40ec5997dee7438747c936bc3b39bae0cee81b77c3dae357388e52,990522,2020-09-30 19:06:18 UTC,499980000,499970000,false,10000,0
4574b31577c6a929031b7ce4228a7048d5c0ed331cda0ab9eba75fd035f5cd71,990522,2020-09-30 19:06:18 UTC,10000,0,false,10000,0
7223d6f502b565096e699dee7d173628373f7e422df40df1e4cc6df96ce47f0c,990522,2020-09-30 19:06:18 UTC,475427404867,475427402564,false,2303,990489
6e25cd37298dd0a597bb92ac65e68b66632230added52247e24e0be1c7508d34,990522,2020-09-30 19:06:18 UTC,223025840,223023218,false,2622,990510
97fbe53b115e9d5c3fbd50310591f906a7d9916382405d566732feb27360053c,990522,2020-09-30 19:06:18 UTC,31950562,31941161,false,9401,0
be93fe190c645393ed553df364599de7a2a69e2099bc8c96202585f8b35eb346,990521,2020-09-30 19:04:30 UTC,191152,177658,false,13494,0
780645a8ba292bcdc68e503dd5ade077d344d1c3204beeeaa56b15780f405b1c,990521,2020-09-30 19:04:30 UTC,499990000,499980000,false,10000,0
a73abdcda47c7cbf88954dcef2ce34be43b3f640d5870c254bb443208bbbc1d2,990521,2020-09-30 19:04:30 UTC,236984583013,236984573013,false,10000,0
1333eb0b14a2a7ef525481e63a6f579bbce5ddd317f0000b045f6b4d10ba0925,990520,2020-09-30 19:03:24 UTC,475584612978,475584610675,false,2303,990509
8d1493309d0eea51c9e2b5cbf0a0a24382797c1e37100fa95e119ab9fb5d37d6,990520,2020-09-30 19:03:24 UTC,900846,771646,false,129200,0
61c81c9031d2051e505007884503a15c51fa0340020591c6f1c87c6a80001772,990520,2020-09-30 19:03:24 UTC,151000000,150997740,false,2260,0
a60030d9dbb9d88f2018b65722b74dd4577b9c6dc22386a48d004beb3804959c,990520,2020-09-30 19:03:24 UTC,19008156425,19008146425,false,10000,0
3b1996db9623586cbd813614ddd26c0998f23a77c67e262a23913715f076ff6d,990520,2020-09-30 19:03:24 UTC,10000,0,false,10000,0
e57775f81991118f4dbf11c9d32e0ba65cc0b044c685a9fed5e490651276a7d4,990520,2020-09-30 19:03:24 UTC,94392548556,94392538556,false,10000,0
4052cb9b60c342f835d3882f202e85ff310409dfaf5d8dfe9481873a871bc44c,990517,2020-09-30 19:01:27 UTC,168500000000,168490000000,false,10000000,0
5ef0f1c66bc3df873a7ac3efafcd45d32c6a872d8c619a1c5d5af890ea708f78,990517,2020-09-30 19:01:27 UTC,1397351184,1397289448,false,61736,990504
9b4b8b1302d36d63c5aa53b3b9b91b73334fdef060e2c4f84938099314236121,990517,2020-09-30 19:01:27 UTC,2507300533,2507297920,false,2613,990505
6bddc287d6b119e6982224aec8cae72b47f96aedb5dc636a961dd533dcc22dfd,990517,2020-09-30 19:01:27 UTC,131114214,131111254,false,2960,0
6feae7b57ce749f22de7c06bf73441f002703c3714f63a1547865c37a26d8c39,990516,2020-09-30 19:01:04 UTC,10000,0,false,10000,0
5c1cbe55411b3d82d8a0853936f58715659f2718e2d48c0e709798f288e221c6,990516,2020-09-30 19:01:04 UTC,99865712,99863262,false,2450,0
19dfe554711d5187fcf8c9a77c1713b5c06feb7dccecdc788c691db99f1960db,990516,2020-09-30 19:01:04 UTC,19688315479,19688305479,false,10000,0
4d199eab302b78ce32ce2bc30e46cda07488d00aa712e3dd0a4c19626d11fda7,990516,2020-09-30 19:01:04 UTC,699816042,699740834,false,75208,0
b918276e43c0b57a11adf1b246a8e627fbdcafdaa4cff12f77f8680e87fc3c86,990516,2020-09-30 19:01:04 UTC,500000000,499990000,false,10000,0
ae467d3938ef0462c3612b1a2f0419325ec888ea59bc07816312a6d46c62aa73,990516,2020-09-30 19:01:04 UTC,474056412,474028539,false,27873,990504
56c95c0e0922969d70a098ed632a450ee907d5fa48c1da85e8814c4608b6d4b8,990516,2020-09-30 19:01:04 UTC,636412971,636411389,false,1582,0
aad610605837de75c0ae8ade8986d5a72edb2a7c41a27eb58df5930599c88ce0,990516,2020-09-30 19:01:04 UTC,1007157692,1007154430,false,3262,990504
80f79455728f2d0cc3332f90c280d5dfaa28ab9b4c0aa164b769f803fd19804d,990514,2020-09-30 18:58:58 UTC,81098758500,81098754846,false,3654,0
b0bd80a834cb6458c8df2af3f17734ae3b575aff9c1e24d21eaf4a502d69ffae,990513,2020-09-30 18:58:32 UTC,10000,0,false,10000,0
7266e6f136ce735c78dd3dff016a964179f60c75702a1cf7c8ae615b4d325e7a,990512,2020-09-30 18:57:42 UTC,70649851,70639851,false,10000,0
cd58887167c7f2f3ff9851470b0dad5c84bbac5fbb3be98f0f8f5c26a2bc75cf,990512,2020-09-30 18:57:42 UTC,985010000,985000000,false,10000,0
c0b6d00a0ff3bba3fbe334e6673ed776878e01ca981e9c881cba16b908ca2efa,990511,2020-09-30 18:57:16 UTC,10000,0,false,10000,0
9d7adbe9b1253dd81eb68b8d5abf65aa5174605cc5b331088e114d4fdc955e05,990511,2020-09-30 18:57:16 UTC,2348855,2342855,false,6000,0
4338d5fa547f201258f156189f2f6a56be44faa6863951ab52fbc1531c77de3c,990511,2020-09-30 18:57:16 UTC,1000010000,1000000000,false,10000,0
623b4980e95e2dcf8f402c9b45f01ff3943d2f94afa2668ff69de6b7c43fb14e,990510,2020-09-30 18:55:46 UTC,10000,0,false,10000,0
f8bb745ec889d3bd991a69f332cac9ef4772512b2808c427b1abc3721fe9bfc8,990510,2020-09-30 18:55:46 UTC,5207412,5202656,false,4756,990499
1aee2e9059bb12bc8dc549b8e20e72e1ec0a12f649dcb4365bd2ab323c12b142,990510,2020-09-30 18:55:46 UTC,10000,0,false,10000,0
ba2e5d6fd2d1b7f302447ce7715880387d23e24573819775d1eb07b1cd246fa3,990509,2020-09-30 18:52:10 UTC,32161109,32151708,false,9401,0
4b78c064989c80ff6dd0c7e3ec97c7396f1edf74cec602d3ae121130e30aa2df,990509,2020-09-30 18:52:10 UTC,100162897,100060823,false,102074,0
1f9fc3d13ce043015936137c0722c1cecfce56a61a9fe85e3e870f7b7602c96d,990509,2020-09-30 18:52:10 UTC,1398678872,1398615876,false,62996,990459
97e630e6454279640606e0cfc94987ad5d677f6f8fa04c25597392710bfcf362,990509,2020-09-30 18:52:10 UTC,422923810,422921360,false,2450,0
cfcb1ba6879f5bd488f41ea3aee358355f8492502aea80ae72adc48ef0150c95,990509,2020-09-30 18:52:10 UTC,475117801,475084494,false,33307,990466
cf388fd788c738f198ec98a12ed419a6dcff4b979954d030313822390175c77f,990509,2020-09-30 18:52:10 UTC,853393130,853293130,false,100000,990498
a0f4c27b2d0b142c23675d4220432e2cf43be492d4e97a18c93116f3cd68e685,990509,2020-09-30 18:52:10 UTC,10000,0,false,10000,0
29404c2b1b3b4fb615490d24b2edf66972629661300a046a2d8ce8f9a8a47e79,990509,2020-09-30 18:52:10 UTC,51769361024,51769357344,false,3680,0
3c1667bd414b136fa13eb454f2dd6f3d583c607dae75ff630aa2d520e13fead3,990509,2020-09-30 18:52:10 UTC,93745853,93742893,false,2960,0
38f5d632ceebbb989f8607ff04a8f7059b6ed749a9015b4d945bb4353c39f26e,990509,2020-09-30 18:52:10 UTC,10000,0,false,10000,0
5047c2d6ba5c549005865fd4dd1d52655f62ef0b93d9cb224af847dc514f74c0,990509,2020-09-30 18:52:10 UTC,217658808,217652660,false,6148,990494
46f7e7ed20cf1d8980546b3b24d1aff02da690958233b6f8ee8022a4c9c1d523,990508,2020-09-30 18:48:54 UTC,209430815,209425595,false,5220,0
c214fd9f917a72e876d220997f0c7a6b9431874004d7767dbb04c4f15fd75ca1,990508,2020-09-30 18:48:54 UTC,32291866,32282466,false,9400,0
623122faf8aec78c68b3e6d4e48c026781930d1faca56cc2885158b6897ed23e,990508,2020-09-30 18:48:54 UTC,32243293,32233893,false,9400,0
850b3750a36abe359c52ffc71fc31b04bbc448caf12793d6a7880d6611fab65c,990508,2020-09-30 18:48:54 UTC,10000,0,false,10000,0
646e2d2c86a4ab50468f8a96a6c472fa6f523c0b6ccdac70b405781f762f34fb,990508,2020-09-30 18:48:54 UTC,10000,0,false,10000,0
fbf5abfc873ff61d3448956fdae2e866a65dab8215803a208c9449ec13c75b41,990507,2020-09-30 18:48:48 UTC,242558153,242555850,false,2303,990496
c84b0151f3b968af172ae00a6090e78b5a147e73b664e2ca4c1ee7e8fc0c3cd0,990507,2020-09-30 18:48:48 UTC,171868725,171865765,false,2960,0
a0acade8a089c05bcea68e2e845339fa8336eff8dbc894265ccb8e9c535d4bd6,990507,2020-09-30 18:48:48 UTC,285699755,285699362,false,393,990496
e39fb822353936018ac090d551595d07c2ebd6d2baec8d71b055bd0a71fef17a,990507,2020-09-30 18:48:48 UTC,32320262,32310862,false,9400,0
235c3a904734d67b3700cf4ea4db4a4201b454886b66eb7eb8076ed4b30e54ec,990507,2020-09-30 18:48:48 UTC,500000000,499990000,false,10000,0
cb9254f59e4c890420ede258914ffab483013e868bd9aa466177d77df41c17af,990506,2020-09-30 18:46:37 UTC,6208359274,6208311474,false,47800,0
f63bd1b23baeee6d26bed88741dc9f78b371320460668f643ba3be35c6a2fbee,990506,2020-09-30 18:46:37 UTC,153958426,153874186,false,84240,990505
a3fbe0088795e447d0a70a93849d898e8782802d911b524d5debabf259bd102d,990506,2020-09-30 18:46:37 UTC,10000,0,false,10000,0
094ffebdb8e747242781c62d340f91508603f30db5a579a1e992fb5c7a11e9f8,990506,2020-09-30 18:46:37 UTC,10000,0,false,10000,0
6c8eeb9f8a1d7fa943c6232893dd7c95af96eac3408b7fa40b82b22be91fc8df,990506,2020-09-30 18:46:37 UTC,32364338,32354938,false,9400,0
1db8f9e829c94994eacaedbd5a131408d6321d177a08efead190d8b32951ec53,990506,2020-09-30 18:46:37 UTC,19688325479,19688315479,false,10000,0
8acdd9eaaecdb0d0127ee7a79133b4c1d51901cacffbd77d1a80d57f00e6600e,990506,2020-09-30 18:46:37 UTC,51338500000,51338490000,false,10000,0
c5946c7fabb2c81ed7a6105c60ca86c6b7941f6c6e4c5145a61aa319cdcc4fda,990506,2020-09-30 18:46:37 UTC,10000,0,false,10000,0
a5f403705dbc42fa81ec7574c2ec6c4e71e7b7f2a27628feb0eec348861c0c88,990505,2020-09-30 18:43:27 UTC,142131284,142056084,false,75200,0
7162588bdcee65f5eb302d97c60ec42390e4941464de7fdb442381969d33189e,990505,2020-09-30 18:43:27 UTC,100000000,99997550,false,2450,0
d9b67a1a10e46b32ab21094c3b8003b5170c95f495a95fede025775b7290a7df,990505,2020-09-30 18:43:27 UTC,55200000,55197740,false,2260,0
1353e12d88b054bd8ee1a2f0dd7a54fff3255112d3117b934d11f8fc34ef6653,990505,2020-09-30 18:43:27 UTC,575548115281,575548112978,false,2303,990417
8880ec9980a004c1324b9639e2cc2ffa0844e1cec4262bc94a6e7a0561840b62,990505,2020-09-30 18:43:27 UTC,1146385655,1146285655,false,100000,990494
922094182778fc7dc925c0704b8f9fee8c8593187b55fabf972d693d6e97c895,990505,2020-09-30 18:43:27 UTC,10000,0,false,10000,0
11a7807b832aa33ae335d88fa2ae86b89da7edb7aae6945cd0f6e4610a6e72d5,990505,2020-09-30 18:43:27 UTC,106038044,106021194,false,16850,0
1649543c8f2d03cc5f4d4debeae9b3f4294b3647f013b59398a66d63f8bd73e5,990505,2020-09-30 18:43:27 UTC,250,0,false,250,0
029137adc09655c9bcb4588ba8af8ee72dbb16433dd41b4beb1f42d1bb0f1d50,990505,2020-09-30 18:43:27 UTC,475933217,475907330,false,25887,990462
5917a6551587cbd37b8a5219ae38f2d066426980932c9fe9cca5f6d5d53e1bd2,990505,2020-09-30 18:43:27 UTC,10000,0,false,10000,0
8952227bec6cccf206997aceb9e10b05aadd99196942600d6cc2219e5a081ecf,990505,2020-09-30 18:43:27 UTC,499980000,499970000,false,10000,0
1c85ac2b83c6920202379ba06f432493aa4c9aab36eeabd044173d5481437294,990505,2020-09-30 18:43:27 UTC,1400051437,1399991644,false,59793,990494
489f8042b6e546ddb98e60a0bc1b07023301c82be9937de9299879883827139e,990504,2020-09-30 18:39:14 UTC,84935,74935,false,10000,0
22fb9f56c238f4bb88d40826ffa0d5a7cc0ca7a3af661c934ab5b41b972af069,990504,2020-09-30 18:39:14 UTC,250,0,false,250,0
069e4a9a24c04784091d2e733726635dfc39662000087133ec8e8f35e1f23548,990504,2020-09-30 18:39:14 UTC,1001879833,1001877296,false,2537,0
a23ca1ca519f1d698d8e8aa216cf7be875cf3a0e55753854a235d5f5042d1fe9,990504,2020-09-30 18:39:14 UTC,575646775107,575646772814,false,2293,990493
7b878a97b030a4e3db7252740e69264243060fee50567da61a6177a8dfadbaa9,990504,2020-09-30 18:39:14 UTC,500100000,500090000,false,10000,0
482e1cb3321d32fae12a5df109f63791f6d3d97ebee3450f2f7c09bc6c93ad3f,990504,2020-09-30 18:39:14 UTC,150010000,150000000,false,10000,0
0ef84cc055663add54a585be0b0e245f7440bbe3465214a79b69fd91544c787b,990504,2020-09-30 18:39:14 UTC,250,0,false,250,0
81b2b42406e743e78e37b54bc6ab25f7834dadd2da701f8cab24e5de4950c4ac,990504,2020-09-30 18:39:14 UTC,51338510000,51338500000,false,10000,0
54abbea17f2ea6a8f914d87bd9f46dc0402aafc816a08c0307d6517ca3eecea0,990504,2020-09-30 18:39:14 UTC,10000,0,false,10000,0
7fb57983e2ed92abe908cf033a32ed65bb9bedf5207921dc0f5e8f757715e75c,990504,2020-09-30 18:39:14 UTC,17689974,17680574,false,9400,0
1b3751ba9e81ee00dacfd43b3808ad57099898f7b1b33c3b65b91afc666215c1,990503,2020-09-30 18:35:58 UTC,10000,0,false,10000,0
dd6f0385145c49b6d8bf68654c9c251b439b2b3fe4f105add85c8ccebf567d83,990503,2020-09-30 18:35:58 UTC,815725374,815723792,false,1582,0
2689f830c1558c57f6abf85bdb2470d0c5bcbfaa06d670ec398028c74bdf0d2e,990503,2020-09-30 18:35:58 UTC,10000,0,false,10000,0
cf5968ce0f61ee8672b2f829e099ee652627d0e3bb8a363105ee6de99485f2e6,990503,2020-09-30 18:35:58 UTC,1001884713,1001879833,false,4880,0
e17d4ea91a642cab5389e7f0313af6f9bef88a360c0c0aa140218ae83ec5d03d,990503,2020-09-30 18:35:58 UTC,131587590,131584630,false,2960,0
0dfc231b1e447a9af72423516a93b22f8c6c5c43c51e103485ed9cfcef77a178,990503,2020-09-30 18:35:58 UTC,32426143,32416743,false,9400,0
e48531ccb59b203d0dba7b7c7a5d13e6c01bc1db3c18c8ddc378e1b880896206,990503,2020-09-30 18:35:58 UTC,132553759,132551223,false,2536,0
d45377fd714cc1192ebc8ac478939d96fa0152672cdfd8debd9c674afd9307c9,990502,2020-09-30 18:34:08 UTC,132582319,132553759,false,28560,0
f73829a0e0d044e6aa0a07fe6d87d192e4d1952c578f7d2912c810f0df400de9,990502,2020-09-30 18:34:08 UTC,10000,0,false,10000,0
86c471c1fdf5fe243c038cb763099b8bb0dca7a93a52b0905c6b017c7870e675,990502,2020-09-30 18:34:08 UTC,500110000,500100000,false,10000,0
2820549a69cfc478fcda0294cfdce5d7af27057d2439f9e952134aaa95eec4bb,990501,2020-09-30 18:33:22 UTC,10000,0,false,10000,0
53ccd4e673f5d97c5663dafc21eeea2c9d59e8b6f3cbac9a5fde8d0849e98f1a,990501,2020-09-30 18:33:22 UTC,32637880,32628480,false,9400,0
60f54f08965d6e207048e1eac91b7cf45ed17280b2d5aa777aa669a4b02eac42,990501,2020-09-30 18:33:22 UTC,583842718999,583842716706,false,2293,990490
98e3e2eef50ea77526248573b2e67505a2bbaf1ff89f6fc28d73981b73a2204d,990500,2020-09-30 18:32:20 UTC,24991513358,24991497778,false,15580,0
ab27a9844b40ca51b0622ce066dc647ba08bcf752635e2fbe28d4e0bf464eeb5,990500,2020-09-30 18:32:20 UTC,93922737,93919777,false,2960,0
25671c543b2ef4a3b3cb745b9c4112433f8598b13daf6b5cfeafa0196dd41f15,990499,2020-09-30 18:32:01 UTC,476577245,476554187,false,23058,990488
53c97917820a2a1d0a0bd439b0cdfb1e1d6eca7c2d43d55c8ae67491beb61bb9,990499,2020-09-30 18:32:01 UTC,10000,0,false,10000,0
369c78b571360e12d4ca685398589892adec16f0eacbded3200c1f4dfae89524,990499,2020-09-30 18:32:01 UTC,172122280,172119320,false,2960,0
14f45134e38b6a6b2fa68d23660cd1ede8195d545bd60676fa5aa667361d6cf2,990499,2020-09-30 18:32:01 UTC,32667643,32658243,false,9400,0
285889370f1f6fc9bdfc3d3a2f1b63d3925356236aff82afa54e36317cf40b91,990499,2020-09-30 18:32:01 UTC,1401496781,1401431592,false,65189,990458
5b1f7af851c898f2a897c4b46d773cd1d6aa36df0e335755debf6e604e381037,990499,2020-09-30 18:32:01 UTC,530330000,530320000,false,10000,0
db9f99fafa7245a7fbf2a8529b8ffceeec436aee7bb16b826ef11780685c9bd4,990499,2020-09-30 18:32:01 UTC,10000,0,false,10000,0
dda3b53e302f7a3ca42f5264ae4a202a36b366256c5a5258d46901751ea29ee4,990499,2020-09-30 18:32:01 UTC,3842555377,3842545377,false,10000,0
0181bfd17eb3fe2a5e3d45bdf9039ba05307007e176482d936d03ce18a69bdee,990499,2020-09-30 18:32:01 UTC,10000,0,false,10000,0
00c65ed26079913172403128081cc33765f1c477a974ff0c0d451c4953b379e9,990499,2020-09-30 18:32:01 UTC,131763010,131760050,false,2960,0
8cff2cb16cd50c3005fff1f7c3c79df3fa6aa8ba4499c8ce1eae5c83ca2450fe,990499,2020-09-30 18:32:01 UTC,8234503,8230123,false,4380,0
f51f0c2ef557b3894594c6b4a457ba5422ef5c18ae184becf8a4c7c63aae6b5d,990499,2020-09-30 18:32:01 UTC,1025560274,1025524730,false,35544,0
152aa6fda49399a35022480e69be3e36107dc79b1cb537b0caa05fd83d0010fe,990498,2020-09-30 18:27:50 UTC,10000,0,false,10000,0
397fc6aa49db475da588f90699644f5f2b58e81d3a9e8001e873fcaa44b8f098,990498,2020-09-30 18:27:50 UTC,94118185,94114918,false,3267,0
31019f1501e20fdb447d961cd48e30b35af58ab323c2e4dce8ac0aa4bcac3eaa,990497,2020-09-30 18:26:41 UTC,398116444,398116051,false,393,990486
39bc64775c6331f8a9856c5b2cec6bb9f7e1c7f3c712cc6890223d924940d7d2,990497,2020-09-30 18:26:41 UTC,588284776998,588284774376,false,2622,990486
40792765684f8ddb2d0dde37a3c88efe4b5cdc4bd6398a57717484e647f628e2,990496,2020-09-30 18:25:49 UTC,33707878,33704194,false,3684,990485
fc420a78db74b6b68e8fc32a23cbfc8e52c81f3655c4c1c0cec301760b69cbe6,990496,2020-09-30 18:25:49 UTC,10000,0,false,10000,0
90c8a47f02f0bf731e6b9f3b7a883b3ed86fc7e215f093976e40a71704a9fb23,990496,2020-09-30 18:25:49 UTC,32862162,32852762,false,9400,0
5bd3ffc12ff97f06e1a5fc4ad7f0cac2c88f7ccff8507ea2225005e5ddc2f279,990496,2020-09-30 18:25:49 UTC,199589290,199500000,false,89290,990481
8498462606bbe5876a02f863160b90d94afc3e70d36101f0bab5d02e00567d39,990496,2020-09-30 18:25:49 UTC,560620947,560545747,false,75200,0
731f235e293d77ca8efbe9542f28036cd4244efb553dd5610c8fe6e5a32ede49,990496,2020-09-30 18:25:49 UTC,610146136,610060996,false,85140,0
f11315ae3f68d4823292bcba660c36f25bc0a362e587a948269b8e362b60e165,990495,2020-09-30 18:24:56 UTC,499990000,499980000,false,10000,0
df2a9822b1db2ea2d471182f3b0bb8d46395bac386d5341695039f8827615947,990495,2020-09-30 18:24:56 UTC,1632165700,1632155700,false,10000,0
449fc2f80a17386095d17aa1b54eaa74bc1b43cfd23452b20f489108f259b5d3,990495,2020-09-30 18:24:56 UTC,100000000,99997550,false,2450,0
f091793b1f673978379b821faa995d826d19a7325b129ebc5720e671bdb60272,990495,2020-09-30 18:24:56 UTC,10000,0,false,10000,0
495197e31c946a0ec19fe35cf3fcb908dc0d4384f537423136c135981881910b,990495,2020-09-30 18:24:56 UTC,1473793615,1473787615,false,6000,0
361baea9e31d243cc6abce12000cb605b71c22e24f2843b74418e6c381dbb887,990495,2020-09-30 18:24:56 UTC,4106,2960,false,1146,0
8a16173424f51563f62c07b4af7bce067eb5a1417980e2745289a0b3d20e1901,990494,2020-09-30 18:22:40 UTC,172302558,172299598,false,2960,0
f863dd7e3cbeb8a25893363a8d87d013ed29fbc95f18b4066f6ee48b641cad28,990494,2020-09-30 18:22:40 UTC,500000000,499990000,false,10000,0
92d2bafa82cd809467640717536851af1f9253ea8e43e8fe1a6a44b10aa9b610,990494,2020-09-30 18:22:40 UTC,897500000,897487915,false,12085,0
5465a98a12eaaf5765e0ac6a55a6f8a03a482a2c1f2d60e3449d71fdef5063be,990494,2020-09-30 18:22:40 UTC,32897060,32887660,false,9400,0
1b46c4c65f77c7d6e82c6e0dc9313cb991bb2b7d927d087946c0349a8b733614,990494,2020-09-30 18:22:40 UTC,32944723,32935323,false,9400,0
20fb49cc31761e81d89bd3d63e7950628d9c1fbf44e0779caa0fc90ebff78d0a,990493,2020-09-30 18:21:19 UTC,10000,0,false,10000,0
7ee3aeb040c4591a61a134f2793be8ea66c1f0325b7e7e34944e2cbfdb2d66b6,990493,2020-09-30 18:21:19 UTC,199993220,199988340,false,4880,0
dedcafb45065fa484ba72efaf319f94a28c47705ddd3e3e46297d2623c45d7a4,990492,2020-09-30 18:20:54 UTC,477554089,477525673,false,28416,990481
94ec2741a2c200e209d25bcb7dba460185cd9beacf946fe179b21072e3ab5f51,990492,2020-09-30 18:20:54 UTC,131926154,131923194,false,2960,0
fb7662f4bc9ed45a2dee46f88a1932eb04a7c005aca81ccc8ea1321de859c59d,990492,2020-09-30 18:20:54 UTC,33077572,33068172,false,9400,0
f4cef2155663d61d36693b103345d536043e5fd24c1106fbe95672f7ac924555,990492,2020-09-30 18:20:54 UTC,588383579301,588383576998,false,2303,990481
663cc32c7c09163afd7856668e8c081f40fadb64fc000326b864d35f20a2d283,990492,2020-09-30 18:20:54 UTC,1402920781,1402857792,false,62989,990481
68c09d17ec806e8697d046a5e81320d8a9914b28b5069b43b5f17def9f18ea6e,990491,2020-09-30 18:19:38 UTC,10000,0,false,10000,0
5ce5e4da3a9c61bad2d4507cac1d79ea6f42db99b1fddae6fb1df297c0ab613b,990491,2020-09-30 18:19:38 UTC,1258090696,1258088393,false,2303,990479
f935a480a4e5df880ce37bfbc7560974d1ff79aaeaa2f92e5c31203c853e1225,990490,2020-09-30 18:18:37 UTC,2976680600,2976635840,false,44760,990488
c073074d6ee7f18aff3b53b1fcbd51018fe0aa61def72be692c1ed3e10a86d3d,990490,2020-09-30 18:18:37 UTC,79973406,79961722,false,11684,990478
4e46bb7eb8a424b792cad2599ed10c6ab4cf4cb5d891e054f9001b1cd7206b95,990490,2020-09-30 18:18:37 UTC,94307531,94304264,false,3267,0
d26598ceaf21c9dbc2632621139a94f40e161d8ef71bbec426e18d6dc2a06acc,990488,2020-09-30 18:17:35 UTC,37139696,37137393,false,2303,990477
788423057280b747481453d852b1308b8cbe42ce3e1062a51baad0a108ed19de,990488,2020-09-30 18:17:35 UTC,10000,0,false,10000,0
aa684be065920f49af4c9b17baecbf40ed010609cce24d0c5eac256168a7cb06,990487,2020-09-30 18:15:58 UTC,33105501,33096102,false,9399,0
839c105fdd1dcdb9807a3f1b6c074bbfb061bd7b736ed4c5241342581eb69ae5,990487,2020-09-30 18:15:58 UTC,19092849348,19092839348,false,10000,0
5d77d9c79a1c16d294f7298e43ee352b6d7b62a33e4603224c7656836d11aef7,990487,2020-09-30 18:15:58 UTC,10000,0,false,10000,0
afa0bd3ecf5b8ebbf428c7066eaa15aec2c96028a9f0f6d01e9cad64bafd3e4a,990487,2020-09-30 18:15:58 UTC,172591826,172588559,false,3267,0
8d1eddf7a01d1eb15e162a8b21936b518bee73fb18f8344e0b0c1cf2728a63d5,990487,2020-09-30 18:15:58 UTC,590015747303,590015745001,false,2302,990475
58456b965c3fbc60653e68ed16dc410b6db95830929d7b3358b472cbb01bb87e,990487,2020-09-30 18:15:58 UTC,499990520,499980520,false,10000,0
542dd40f410e8be207bae18050c250debd776bb4df64bae742b9fd6c105e6481,990486,2020-09-30 18:14:30 UTC,19107915562,19107905562,false,10000,0
8bcc7dbb8134993d0caa30b959ef6161f3e4f426a8db985bedc27d4f2b1cc06b,990486,2020-09-30 18:14:30 UTC,19999479999,19999469999,false,10000,0
70f4b9421bc825fa22703707cfaa71d96cb1000944ee1e3e9128f473d9b57adb,990486,2020-09-30 18:14:30 UTC,10000,0,false,10000,0
8e9784e13902b6c5cc1bbbd8ab45f16aa548ff4063053c1aebbbca3ce683fa5c,990485,2020-09-30 18:13:20 UTC,523086,451086,false,72000,0
d3412451e4f8ea9167bbe30bf9397ee08b7109fe17f0187345135231cd8ef314,990485,2020-09-30 18:13:20 UTC,30751858,30713501,false,38357,990473
a2afddc8cf436148382176f8924386afdf0ac070699b9f7db834819faf3d226f,990484,2020-09-30 18:11:59 UTC,19107925562,19107915562,false,10000,0
f61f74909440aed493f621459afc7762a4fe9a895d706949d71025ffff79f10a,990484,2020-09-30 18:11:59 UTC,2499931106,2499927431,false,3675,990473
9bfc92428dc2ddc8bf9f052013920fba0f1283d2c9ee705a90f9ac4845d0767b,990484,2020-09-30 18:11:59 UTC,74263500000,74263400000,false,100000,990473
aa1540ff4219807dfba09b45c91cae379787fa93a93f1d1cb354824df4c09bf8,990484,2020-09-30 18:11:59 UTC,1000173044,1000163044,false,10000,0
dd173b72a4a68cd22fae1efca52a45d92b4d1f2196a9b9c1830a4d50f54a30da,990484,2020-09-30 18:11:59 UTC,131010481,131006741,false,3740,0
ae19b146eb9e739b1e82f11a29420d10255e2760d4012f6ff9e976224053d975,990484,2020-09-30 18:11:59 UTC,166382844,166380542,false,2302,990412
1e89e13da4899d2a08d9eeb9701e0b3974328948d7a6ac54b1d408a996628d90,990484,2020-09-30 18:11:59 UTC,10000,0,false,10000,0
c958052653c239dbb1e7c2d5c2224c25abc9af691ed4511f934764ae1e673b1f,990484,2020-09-30 18:11:59 UTC,244743643,244741383,false,2260,0
6e0e538657f4e605dcaf72ab0a632958db030d9c8fb435c9a4eeb57fa50236a5,990484,2020-09-30 18:11:59 UTC,478354962,478329031,false,25931,990473
4e45c012dbf4957dfcffd1d926af3b1c6ed31519c208938b1a811e04f865471b,990484,2020-09-30 18:11:59 UTC,402196900,402195900,false,1000,0
6284b85bdd6775c11fc3b079531273f7608f47de5c6869c7034ca632b1320656,990484,2020-09-30 18:11:59 UTC,1220662401,1220562401,false,100000,990473
3bb6132fba9e6b19153cfa004e0479f9f47421a706932a80577f4954a1a4f666,990484,2020-09-30 18:11:59 UTC,268167578,268143891,false,23687,0
730c40c8576941b3355f497024ef15f9de703cdaf8891db6036deb8d10a84753,990484,2020-09-30 18:11:59 UTC,10000,0,false,10000,0
fa04ca933481a6da8ed1a3d276b3c88fa5c0eadab76f6a788f9fe0977b899257,990484,2020-09-30 18:11:59 UTC,10000,0,false,10000,0
2e8502d05b404d08e39b17305f543c570d5b1f01d7459f0c374e64fda41f7c46,990484,2020-09-30 18:11:59 UTC,500029525,500017440,false,12085,0
2217ea78e006c4bf4178ddd353dcb8df0244e871e10e047ba34a692caffa3793,990484,2020-09-30 18:11:59 UTC,20771584,20766518,false,5066,990473
756bb8558759859536490841199e3e46ad8a8f75d436c77a7b010bafdbca53f6,990484,2020-09-30 18:11:59 UTC,1404729184,1404650881,false,78303,990473
623c89bbc2a8965291285f4278bbcc07efa30edebccfcad2e5408e1425297919,990483,2020-09-30 18:07:13 UTC,1499980000,1499970000,false,10000,0
302a2b04119f604c8ca5a6974e07b49342a8f695aae34de1d55fd488ed917e20,990483,2020-09-30 18:07:13 UTC,33256348,33246949,false,9399,0
10f31d6367f29bd24376c978b062ffaef40e34eff814a6bd8644d66ed88a87e7,990483,2020-09-30 18:07:13 UTC,10000,0,false,10000,0
11a8d54a488ed328850035c844f7783d30366ee69036f7443465b874da0fa342,990483,2020-09-30 18:07:13 UTC,33639872,33630473,false,9399,0
b8e01796a21842cae7064e6e9fc4438386252d0a1959ff850f0270578753867c,990483,2020-09-30 18:07:13 UTC,45986393,45983771,false,2622,990470
ff338933ef0894153bcbec7878952d3ca3176c8ebb325ec86c4a76d0a55ecd46,990483,2020-09-30 18:07:13 UTC,1112442908,1112438049,false,4859,990472
792f09b22663629167a3c007f3911bee8ebaf8f6cefec9750e6f28499fe22079,990483,2020-09-30 18:07:13 UTC,2623184310,2623182017,false,2293,990472
89e600c77040c2eb350720544406f3dff0fa739919cb3ee16056cc8ca1cc7d0b,990483,2020-09-30 18:07:13 UTC,10000,0,false,10000,0
1172e501c2238307768d02b65d2bacd9a74f141eb986d55f69e96c5012347722,990483,2020-09-30 18:07:13 UTC,66249009,66246707,false,2302,990472
1d45651482de12fece10c78d5250b2f29f1a090757ac5fd49eabf97c8126eaa0,990483,2020-09-30 18:07:13 UTC,33377554,33368155,false,9399,0
ab5a2c83ca929e64ab1d9e6c04c990152b253e31839d1ca9be01490883a1b1c0,990483,2020-09-30 18:07:13 UTC,20183974845,20183964845,false,10000,0
e42388cef7b6a9142db21ba68351456f317b08c9a980e8b3da8c761ecc005434,990483,2020-09-30 18:07:13 UTC,132232785,132229825,false,2960,0
5c5b8201e1718b70f1160aacd11a70ece2165e5dc4383899fc672912f9e61e77,990483,2020-09-30 18:07:13 UTC,10000,0,false,10000,0
98a7d1b7ccd8ac48363d7c4b56b83948fd589e6d96b02fffc3bf1600053d5cd0,990483,2020-09-30 18:07:13 UTC,33297623,33288224,false,9399,0
270ccf367e9b71e9f9355213aa46894a11ce3db14e21e526eeff37495c2f9227,990483,2020-09-30 18:07:13 UTC,18998988515,18998984585,false,3930,0
5235032d5977a0ac131c4a548c01211d7f696e1711fae7fe319c76edbd5cdeeb,990483,2020-09-30 18:07:13 UTC,200000000,199999756,false,244,990472
44a6ab30888ff9fe55eb4958c4e0c1091f9d20d073c1acfa5c6d3991cc8b0e2a,990483,2020-09-30 18:07:13 UTC,19646354,19634269,false,12085,0
664704d579b8b5ff0ec37fc30b0020c1ffa27d0d86976743d9505a6f239c33ec,990483,2020-09-30 18:07:13 UTC,5423810756,5423807072,false,3684,990472
aafce80c77ccbe5b78f37ba6761d76b05df4762a0456e0a9f904649e34d817ed,990483,2020-09-30 18:07:13 UTC,600654992203,600654989910,false,2293,990472
cf18298b9f9191372b26b4fb57e6510012099e29a50f994bd46f59dd058db5bc,990483,2020-09-30 18:07:13 UTC,2500571712,2500561712,false,10000,0
b53d1bdd699b115a175abec77fcd15286a6696016f4aab39961c5cab6baad614,990483,2020-09-30 18:07:13 UTC,500022847,500012847,false,10000,0
16e522b1a61d13867ea93f84e41be497670105c4a278d85dcb8108bacff1c633,990483,2020-09-30 18:07:13 UTC,975000497379,975000495077,false,2302,990472
1e4930d92b1361d7d54f18280390800ecefca5ca24edfc9f9908916da99576b1,990483,2020-09-30 18:07:13 UTC,33133471,33124072,false,9399,0
2ae9d824e91415fb0f87864089fa046e23da42a73e4b562228e7434afecb1e8a,990483,2020-09-30 18:07:13 UTC,237406405757,237406395757,false,10000,0
cbbd53659bd9ae47cc736050c33b8b32734de69bb089183b9cb6f5e25b7d442c,990483,2020-09-30 18:07:13 UTC,33326374,33316975,false,9399,0
e794fb037050b2f4d425771bb1c342fc5e962772c5e7cff8ac5cfc8b84f38430,990483,2020-09-30 18:07:13 UTC,11837488251,11837388251,false,100000,0
5a46d92bb9fc7bf2eacbb657dd6677a4404dc8eb5526462992aa36b8c67aabd4,990483,2020-09-30 18:07:13 UTC,421392210,421317018,false,75192,0
997ca022159df26ef79268ccf1bb7a69ac003cbe5856b18e3fbcb4dfac54224f,990483,2020-09-30 18:07:13 UTC,94484720,94481760,false,2960,0
a1b506c947309728cec0201176f05bbd7d2e6ba465b8e28c875b2c50e1cb5c02,990481,2020-09-30 18:00:13 UTC,1406716360,1406646686,false,69674,990470
201958739e98e84c9c147b948ad9972285f7ee476ab78773d719f0a88370e18b,990481,2020-09-30 18:00:13 UTC,20183984845,20183974845,false,10000,0
ad39137ea53597cbf845509cd617400b519d3a24c146df7ed40d8794461d0469,990481,2020-09-30 18:00:13 UTC,4423851590,4423849640,false,1950,0
b1fc3040f3244cc834e80424afb4d597a1a81f499ff11a98f1f93db992512aae,990481,2020-09-30 18:00:13 UTC,1584000,1577220,false,6780,0
c699cdfbafb89a22239305efffbdfa7255eecde65f59add162337bf3fbbf3f41,990481,2020-09-30 18:00:13 UTC,500000000,499990000,false,10000,0
b48acbbffebca7cacdf7a3485244cab4b29f1c3d31fd903d9a394298e67f5d14,990481,2020-09-30 18:00:13 UTC,24314,20304,false,4010,0
773f23665c69d7d7c3ec32bb57cca974cc0d53e965b769295bbc9a3c7bdea4ab,990481,2020-09-30 18:00:13 UTC,478990921,478964698,false,26223,990470
7ff0fe46faca2163d3813ba2c29c5525993433aeb7cbf82f5036f53d9ecf61d8,990481,2020-09-30 18:00:13 UTC,34200,31750,false,2450,0
a81d154b052f5d9737f82d3c02bff4bd1162a079fe9f2bfc28507e47a5bc5633,990481,2020-09-30 18:00:13 UTC,10000,0,false,10000,0
497ea6bc8cab054c8887e2f66e48486aa0bbbbebfdf9efa9969769ff79cc9c23,990478,2020-09-30 17:57:06 UTC,10000,0,false,10000,0
6d81337139c7d0a18017f8f3d654dfd7ebd36a7656f90038ae674fb57b731ff7,990478,2020-09-30 17:57:06 UTC,172795639,172792679,false,2960,0
952860314835abbf523310c36f2bb54ac37fa6c17b0b81b2a7706e6d1e725ffe,990478,2020-09-30 17:57:06 UTC,10000,0,false,10000,0
51f832dfdfda727b8ef18a546a8d210d834f6b808c89d4090168e523c1025f0c,990478,2020-09-30 17:57:06 UTC,499992960,499982960,false,10000,0
258fd6ec963844559cd3816404c19ae42d77dbb37c815175f517e146594419b8,990476,2020-09-30 17:56:08 UTC,10000,0,false,10000,0
49af4e680b51f77f5ebec175220119cfffc400bbb3f2d67e0365fc3cf7a424c1,990476,2020-09-30 17:56:08 UTC,1320762401,1320662401,false,100000,990465
d00ef9884db16d2647e8ce7e907ce77148f03e7974f25d34ae15d77a2164db39,990476,2020-09-30 17:56:08 UTC,700010000,700000000,false,10000,0
6e789c043eebbc8a239c1287a279f8b885e08caf158fe5ba33c574491f57af05,990476,2020-09-30 17:56:08 UTC,19694072093,19694062093,false,10000,0
670554dfef4760a142004ef7b0ca8d9e6e14b7524a9dd68448074abbfb3b977c,990476,2020-09-30 17:56:08 UTC,134959913,134955983,false,3930,0
2ba87069f60f9e432109abd263255f66eda7ed00e76b3cd5ae3465faa6e38e90,990476,2020-09-30 17:56:08 UTC,244760,207320,false,37440,0
34e39cf863330d14e020f599c4b8721edaf30a92b150a4e49618d988735ea696,990476,2020-09-30 17:56:08 UTC,33669619,33660220,false,9399,0
6545948b5c8927f9df10f2526ee0590f96ceb47818fb775de76b9c12befb4215,990476,2020-09-30 17:56:08 UTC,1652232249,1652229799,false,2450,0
cfb7fee549be567ba684ada03e42e1bb35bca48d5cc59087becf6117d14adde4,990475,2020-09-30 17:54:37 UTC,15031774,15021774,false,10000,0
34b369fd9f69fbb193caa5e14adff14d81f5270eb7f1544246f9eb3d43dfa210,990475,2020-09-30 17:54:37 UTC,33777814,33768415,false,9399,0
cd3324c90e98e2a82c2cdf74c78578bd47af1a51353edf305ba190a28faa4ae4,990475,2020-09-30 17:54:37 UTC,500002960,499992960,false,10000,0
7e29b670526d08f13ade2f7405575cdb715274e82ed18119d202c27ccc4d51c6,990475,2020-09-30 17:54:37 UTC,33714253,33704854,false,9399,0
b71c3a09af0b391639a9ba4eee23e6d0a7c5fcd36d7eb995a00b8bac06f6f3d7,990472,2020-09-30 17:53:44 UTC,254600000,254590000,false,10000,0
7b7e08d2728130075946a9fc15647ef26a6dc1e44003c79bd696369ef30af0e3,990470,2020-09-30 17:53:24 UTC,10000,0,false,10000,0
36b98cf0e76eb6a256db52b304b672917d74d6051fe9479e7bd674e54b702f9a,990470,2020-09-30 17:53:24 UTC,19694082093,19694072093,false,10000,0
533317d91cc5abb42b71f536a1ecdb760dd2fdd3398dfe9e9e83844600728418,990469,2020-09-30 17:52:40 UTC,234093137,234090844,false,2293,990458
cd9d6735645556373278c72d073ecbe26e7e1a05851dc224d37724d3da2dfd43,990469,2020-09-30 17:52:40 UTC,132397471,132394511,false,2960,0
68f8ef6e9e13700f979b4cd430999ab1db629623ce6aae60ae3d6068312f1a41,990469,2020-09-30 17:52:40 UTC,1029878,1027428,false,2450,0
c016b8916111463f665371c6d633f9c320eb7d079228ba3c2f2cc7ee6debcdfa,990469,2020-09-30 17:52:40 UTC,355471532,355468996,false,2536,0
41808b04007810537c5f76b95a21d8756f2286688f8364489bf518b77d01a25c,990467,2020-09-30 17:51:16 UTC,10000,0,false,10000,0
395f9b381d514cd9c9cb4345ce9903a4233cb129ea6772392a796d6c62b1b8ae,990467,2020-09-30 17:51:16 UTC,479617198,479588381,false,28817,990456
f3c6faa53eba513ea2491d63750b4a6ffd68040f1c356e7f2e907b8640f56857,990467,2020-09-30 17:51:16 UTC,1408224785,1408149058,false,75727,990456
e53076f8048de3ae958935e46fa746266b713a182320e964fad487cd0c1d063f,990467,2020-09-30 17:51:16 UTC,355483532,355471532,false,12000,0
017442262b386370475108988d41650a736b1852fa699a2bedd4edbd54261b6e,990467,2020-09-30 17:51:16 UTC,10000,0,false,10000,0
6164a5cce5ee5ecd43145b203a9fab68dd1dc69a2cfcd93eba66b3b96b190ae3,990467,2020-09-30 17:51:16 UTC,430876204,430871024,false,5180,0
736414fdc5bd655fee24434ff20488f00dd433e2af14b328c298ad7509186036,990467,2020-09-30 17:51:16 UTC,20910297466,20910287466,false,10000,0
836b553589160f12ab18a25d8969cab007adfca40dc2ffffc815bf2bb22a5147,990466,2020-09-30 17:49:02 UTC,500074412,500064412,false,10000,0
36c6f9b3fbf6ab3966511842b5a9950691cfa57c3028c3d16977d0dc84910fff,990466,2020-09-30 17:49:02 UTC,142177991,142102799,false,75192,0
e4ffe0b3bb8b2d5a1ac46c6e1e726639a181a20f012ff211c7ff38db8aa2e7be,990466,2020-09-30 17:49:02 UTC,174445949,174444029,false,1920,0
f05f17ba1672523944a833554326127791f36a5f873b9a55ecbc99c5cddfd696,990466,2020-09-30 17:49:02 UTC,1999990000,1999980000,false,10000,0
67f8935ee127dcfb999caa46ff0b93248a6fdd691104809e72ab497972d87860,990463,2020-09-30 17:47:45 UTC,10000,0,false,10000,0
b2f9b4353cd5a244d9253eeda500dbc6f7ffffc09ce4fc349e0e7dd0b418d786,990463,2020-09-30 17:47:45 UTC,94725833,94722873,false,2960,0
bdfcfc870894213de5cfadf8e6678a68dedd263cca53335daf694c8a67421053,990463,2020-09-30 17:47:45 UTC,161378285,161377596,false,689,990382
c1b9887fde044545218232a3a681303cf032e1fed48371ddbb1d15f67cbe2eee,990463,2020-09-30 17:47:45 UTC,53410271475,53410271375,false,100,990370
87c2f2123ebd83a9f3a15b20ecae5abd50f5064e1fabcd479e546e1fe7b136db,990463,2020-09-30 17:47:45 UTC,207576156,207566156,false,10000,0
1c049c0d9b87ae4abd189b26765f6098379f78709f5cd5dc8fbb9faf6c5bf11f,990462,2020-09-30 17:46:49 UTC,500084412,500074412,false,10000,0
628ff430b0fc1712906d1e010057d51af00bbd30320c44d7b21259fb6c247fb5,990461,2020-09-30 17:45:54 UTC,210876792,210866792,false,10000,0
14d447fd800393d7536936466b78d1d81f74e1e9917b4d3994d126a394393b34,990461,2020-09-30 17:45:54 UTC,10000,0,false,10000,0
6d14a58c193223ae6c5fdac720c72dc3f119947b4dd450d2209dd80a7264eddb,990460,2020-09-30 17:45:13 UTC,172982744,172979477,false,3267,0
0db3188e3e4866fa32aa7a84d4e5680f4ac0836f3015bedc2cbc60fb4ddee90f,990460,2020-09-30 17:45:13 UTC,34769842488,34769835618,false,6870,0
7e603775816fd2c7da66ad4e7238cbb8321291d13d406016fbaa45267052cfe0,990460,2020-09-30 17:45:13 UTC,20410243054,20410233054,false,10000,0
1328c06ccf6c0618bf5749de45327ba2cccba86304e1cc988b128380c360084b,990460,2020-09-30 17:45:13 UTC,500021774,500011774,false,10000,0
22ab644f80c1da3dcca3672e25baab61a6d63f05a8ea74b8009f95b5a02a40ab,990460,2020-09-30 17:45:13 UTC,298014430,298012137,false,2293,990354
b296d28d13992f5523635c341aa66fc5a7e6d8a1d780b63cc5fbbc65763e71d8,990459,2020-09-30 17:43:16 UTC,10000,0,false,10000,0
0a173a1494fdee2d30972d42b7a75668166f02ef33cdcc22ddca28130370fc0b,990459,2020-09-30 17:43:16 UTC,162094055,162077982,false,16073,0
bb7204593d4825f34ae93b7ff0150dba155f45c365e4c1db191c2f56409200eb,990459,2020-09-30 17:43:16 UTC,1409838141,1409769792,false,68349,990447
67cf61931fd9591b8c5fa9cb080d5e6326262adc1655bb0df9b73e3ce33c0e3e,990459,2020-09-30 17:43:16 UTC,60000,50000,false,10000,0
af9f534e49e345f9616ad37d440b06e74a30a7333a63ccadb6b6061855f8507e,990459,2020-09-30 17:43:16 UTC,99704756,99700000,false,4756,990441
22375803adf18ee90a857d9b17e1bfc4cc836b871e70b501d22759bdb11ea90b,990459,2020-09-30 17:43:16 UTC,257936665,257873382,false,63283,990447
b0fd859b32bea46bf7065eeedd13ef6f0e6073ae385305ea7e02722d1072dc9f,990459,2020-09-30 17:43:16 UTC,10000,0,false,10000,0
f89e5531310e2403f7896c6178e29b047c3554ee2340a796cae82422bd7bebc9,990459,2020-09-30 17:43:16 UTC,480520644,480498218,false,22426,990447
14f8b5fe91fe703ff80bc0615325a020e0f829a77414ab992d55008e6317f5e1,990459,2020-09-30 17:43:16 UTC,33807447,33798048,false,9399,0
dc4adbf5b9025e953f1038bfa480639b7217aca665ae11576b1437de6b9fb423,990459,2020-09-30 17:43:16 UTC,21270222434,21270212434,false,10000,0
3f46d9fc2d43e6d406823d96010d1a14c34a8ba6856ba8cd103f4adb678b7161,990459,2020-09-30 17:43:16 UTC,100000000,99999756,false,244,990448
9cf0137079661a5637b4e62218e81d823b65debca93a45dbe79dfd753f8834c3,990459,2020-09-30 17:43:16 UTC,114663821,114661371,false,2450,0
6d03252216ab118d25b10d8b0fd8fc19678f02f7ab1d3c6427c22523fb782f55,990459,2020-09-30 17:43:16 UTC,1647567446,1647560446,false,7000,0
8d2c4afb06440e79f91bc2ca807f83cedfa38d5fe291acba17b976d08b3f4cc3,990457,2020-09-30 17:39:19 UTC,3489776930,3489766930,false,10000,0
8b2a6d81d9c0cff0a45ce4f6b9b523e03309cd0fa2106c4aa42ff5f4685ddd5e,990457,2020-09-30 17:39:19 UTC,132589924,132586964,false,2960,0
ea67fb09ceca169530eb1480c08cb2f23a050c6cf19a6f72fb78742f335f3faa,990456,2020-09-30 17:39:07 UTC,33960095,33950696,false,9399,0
13de9de4632142e1e06d51037e4eedbc04d9b00da0667fb72ba922c3d8504836,990456,2020-09-30 17:39:07 UTC,210886792,210876792,false,10000,0
1c8b16d0338160c51d657a5f3676b863909e4e906a8de19788eeb728bbdd3b59,990456,2020-09-30 17:39:07 UTC,10000,0,false,10000,0
3536ce03c99620ca80dc016afcd613a90962b5509b999f79279a8b54b9b184f6,990456,2020-09-30 17:39:07 UTC,33926874,33917475,false,9399,0
0527d19ca47e86bb90c7d38f62e413d6f1f4bca9ff18fc83f4c7c9d71d89b9c2,990456,2020-09-30 17:39:07 UTC,10000,0,false,10000,0
644bfb7052e0ede1519d85b9825cb86fe08a25391fc25154c78d0966f1813e75,990455,2020-09-30 17:36:33 UTC,605327455496,605327453203,false,2293,990444
bef5849d6ead66d12cc307cd2f99e2854f8a8c04333a9cd6ef24035c6ca58941,990455,2020-09-30 17:36:33 UTC,10000,0,false,10000,0
3341b870eca10721e49d554351c877f48350f74e6fd243b4cfe352438bffec7f,990455,2020-09-30 17:36:33 UTC,209531962,209529512,false,2450,0
d6dfe2e4244f5f0c73d4157b80de9d6aeafc62c04baaaa81a42743924be26b7b,990455,2020-09-30 17:36:33 UTC,88069969,88067667,false,2302,990444
9e247b26911e404ab8fd15af567a4c751f183821222628c438f7ef6cc3609f01,990455,2020-09-30 17:36:33 UTC,500000000,499990000,false,10000,0
f755fe6185eeca6f7adf5148da6c2c0c105c805db0a0b2aaa8a9ee8b3fbb25ed,990455,2020-09-30 17:36:33 UTC,152382,151824,false,558,0
33038b71c494c16861de9da453c4fed17252f13feb4dec46dd6af9bd0ada80bd,990454,2020-09-30 17:34:12 UTC,20770242434,20770232434,false,10000,0
a8528a36828eae943bfd2083291c320b9889aa8816660ed07dc1a13cf19e9b5b,990454,2020-09-30 17:34:12 UTC,500010000,500000000,false,10000,0
304ce0f58824e425bde57f17b02d8847ec439209b6795af26099f53ce81acfe7,990454,2020-09-30 17:34:12 UTC,499980000,499970000,false,10000,0
fc38de945119d82807ad25426a575a14a4e63237c4b269bd0604f262253feaf8,990454,2020-09-30 17:34:12 UTC,94878630,94875670,false,2960,0
6e8f7fd9404c5672f4c394e47743a360453e0438d7e2e42fb641d73740dc4a87,990454,2020-09-30 17:34:12 UTC,10000,0,false,10000,0
c4de60f1ede665f1b8237415a5a023f5088a9bb19f4e195dcad85eedf7307b8d,990454,2020-09-30 17:34:12 UTC,76612909,76610607,false,2302,990355
024b2648c44f1a4b94ff9c10428b66a258251016e8160f81fe52c968ea351ddb,990454,2020-09-30 17:34:12 UTC,8131460000,8131450000,false,10000,0
9cb7be78edd287fe6e35327d32fd728adda9f1c377a04dab5e9b4608c72d24e8,990454,2020-09-30 17:34:12 UTC,33032935,33030642,false,2293,990443
a689131dc8aa5143b3e74c352610539442b6e1b08c6c85c1fda525d3ad7f2a83,990453,2020-09-30 17:32:32 UTC,10000,0,false,10000,0
f5f105f8117b8831cd01041b77dc4a4d8a43a0c86716759fd59fd6f53eaa05f3,990453,2020-09-30 17:32:32 UTC,19999499999,19999489999,false,10000,0
e68f95701599fdd01af2f696cd6b9562b73d23ee40e99477f61e1c33d3e162c1,990452,2020-09-30 17:31:46 UTC,34276342,34266944,false,9398,0
61ff4ea0e5065f9d6bcd51145928a47097607eefe2490f44c0e450252f028302,990452,2020-09-30 17:31:46 UTC,1301231899,1301228159,false,3740,0
5025cf020df79ae28e70ff1fdcc96cbad0d5fea6cc107f1340b83649814217a1,990452,2020-09-30 17:31:46 UTC,1411577915,1411505365,false,72550,990441
795bd39f1adc441ad009e36ace4d989f331a169f7630292244fc05bb8a4b2a5f,990452,2020-09-30 17:31:46 UTC,161769841,161763841,false,6000,0
a577d81959d15c0f0af35514a17c41fe85b6ae1d702fafcbfc6189c0bed86329,990452,2020-09-30 17:31:46 UTC,10000,0,false,10000,0
1b5ef84d769941a93274ea87b90ffb8b07665a95015842f34218217138157025,990452,2020-09-30 17:31:46 UTC,85083841,85077841,false,6000,0
3d5a075decb41168c98a5e22fa4bd88db72ec4e24c92036e49abe35d63affc10,990452,2020-09-30 17:31:46 UTC,10000,0,false,10000,0
62eb4b474864b19b704f772f85c8e275258ed2c65d34bd8e1fc6ffcd35701f0c,990452,2020-09-30 17:31:46 UTC,21040223283,21040213283,false,10000,0
f21ad0a2ff28637258db80d7270892ca026b7877c0f74cd7c15fc5813d05bf53,990452,2020-09-30 17:31:46 UTC,610608432,610606130,false,2302,990440
6a45a5c626f8ff1a7cc89c4ac888f2e9dce9fa7aabccfbda7625d1d43061de36,990452,2020-09-30 17:31:46 UTC,499990000,499980000,false,10000,0
a3e4be3afb3cb4b0cdc36e1e4a4c318ccbb14eb1c792122adf673e5c3306fec3,990452,2020-09-30 17:31:46 UTC,34232622,34223224,false,9398,0
af1a19b3bfb2693b532b45fa2493274a44f9e79ed598b34ab9aa4bb6bd82d048,990452,2020-09-30 17:31:46 UTC,502146043,502136043,false,10000,0
5af85dc378c5ede74ec0ab9b38fbc8959c4eb85698c55e0543ef23730f68d4b0,990452,2020-09-30 17:31:46 UTC,307306453,307302997,false,3456,0
3135273be46cb79fe9dd6f1fcbba25451a463631bcf32a0e2dc671eb869e143f,990452,2020-09-30 17:31:46 UTC,481000089,480977034,false,23055,990441
107351d86753a9b3658e2f402338406921d982204099748b6a6b9243f88aae8a,990452,2020-09-30 17:31:46 UTC,174077920,174074960,false,2960,0
9512ee861097eda57a31fe3f9cfba7f399203474fe01827022aaff096941094e,990452,2020-09-30 17:31:46 UTC,1999990000,1999980000,false,10000,0
2e70570cbaea9422c2beec8d1361bf584b7b5eb4c9dd30a9c6cd74a02423c0e8,990452,2020-09-30 17:31:46 UTC,34202140,34192742,false,9398,0
f0156d913b2f80ed6e87ff11ff83fee8434a441ae2b855dea2a04cd79ed5af7d,990452,2020-09-30 17:31:46 UTC,142192105,142116913,false,75192,0
4acce15d7370a7413a2a70983e61d22014b8c6cd3f77c15a24d0307348f43f28,990451,2020-09-30 17:26:52 UTC,169322,166704,false,2618,0
0e34ea3980c34b5265121f75aef10177c99e1411c1545446d818c3da030eedcb,990451,2020-09-30 17:26:52 UTC,10000,0,false,10000,0
17256788b5c5cbef97fab667de2e07639017f44199cdf40240e3c0c243867d49,990451,2020-09-30 17:26:52 UTC,4534446,4531996,false,2450,0
aac6610b86dc707be2d46d90d308bce859b164feec4c94796d68f09a8b962206,990450,2020-09-30 17:26:18 UTC,10000,0,false,10000,0
13d1c068a8a98474c0b8ed678967c4e343c91f3c5975693434381e34d76c90bd,990450,2020-09-30 17:26:18 UTC,500000000,499990000,false,10000,0
d39a4c6401db1ab43898e8129289735830a4b4c9e110d267d08e22cf30bc1725,990450,2020-09-30 17:26:18 UTC,34429728,34420330,false,9398,0
e703ff517089bff8bae8197b81b6c28420972aefee965ba5a1ee4c040dd001a3,990450,2020-09-30 17:26:18 UTC,34553863,34544465,false,9398,0
935f67dd7ac0fd57793d036e8f2382403a833d921f59cd993a9232698892e326,990447,2020-09-30 17:23:47 UTC,10000,0,false,10000,0
871a10aca884323b003b4023bc4747022d8d3f98e094ec41ce620bd7ea797e96,990447,2020-09-30 17:23:47 UTC,72964647,72946647,false,18000,0
9ff0fc0a63efbaa6a99cd3036e1b52412b37eb239708446c20e1c2a36ce0db80,990447,2020-09-30 17:23:47 UTC,528881449,528878999,false,2450,0
8295ab67e58b531466cce01c846e99f7c6a9f9953a5b7dbe9fb7af6756b8e363,990447,2020-09-30 17:23:47 UTC,807862555,807858815,false,3740,0
245cf97730381cdd211efce27cbcdfe1c0a871ebba9716b1b4e3a3fb067e14e1,990447,2020-09-30 17:23:47 UTC,7654609733,7654600133,false,9600,0
2428bbae35ac11e993915ae0ed784a9fbed865f59b7e8bfdf4ce32260831cd1d,990447,2020-09-30 17:23:47 UTC,2240102734,2240100432,false,2302,990436
aae151479d4bf0f031ababce89db199a4a44f1037676f07326ca17001d0a247a,990447,2020-09-30 17:23:47 UTC,115899787650,115899785300,false,2350,0
5e18de8dae9f41cf367e75c6b80d3c908c074a7fb48da88fd528b5f37f6c1e90,990447,2020-09-30 17:23:47 UTC,34590025,34580627,false,9398,0
51e75831d2c2cac45daac74a731e5615ff082a8f0ef8f52a9700d044112f8645,990447,2020-09-30 17:23:47 UTC,34664375,34654977,false,9398,0
5d84ff95ad60573642829f72e09462e3ad10c66af615f01e341d2e1889094c01,990446,2020-09-30 17:21:29 UTC,10000,0,false,10000,0
4c0f83a29e1a22fb0f2db85f4c52cab7147c6c1e6bd50b7459e780fd34f8c8c8,990446,2020-09-30 17:21:29 UTC,99997740,99995820,false,1920,0
5b78a6e98283ada9fdbc555644d17c6504dc65544b9da89427e0b871b86561c7,990446,2020-09-30 17:21:29 UTC,482842264,482812479,false,29785,990435
50e88d14db7425e325e33678c65135d770284965c1aa58f99b6d5e97d935a272,990446,2020-09-30 17:21:29 UTC,1413049313,1412981566,false,67747,990435
dcd224346346584ba662fb410cf913c8e3796bfe5ed9112bdc33007ff2b2fc5a,990446,2020-09-30 17:21:29 UTC,94979092,94976790,false,2302,990341
92a367a97b8ce54b4e5b37491f63c05f40f2f83e4dbb15e40f18e9133848acbd,990446,2020-09-30 17:21:29 UTC,53472640588,53472640488,false,100,990435
188276259015fb9f6a90eba181297710c290f39d7523a4331be09e41991a0e39,990446,2020-09-30 17:21:29 UTC,500076800,500066800,false,10000,0
9a35ac6d388958a65ac502b98468533b052b1986f27e0f2ef6fceb273e7b22a1,990446,2020-09-30 17:21:29 UTC,250,0,false,250,0
9ed83f5aaf052e3b7829920d6820c5871307d348438d61c95fde06b13d0fff85,990446,2020-09-30 17:21:29 UTC,157719945,157700453,false,19492,0
97eed93cc0a6e064ad7cd1c788d1da680865468a1968ca95005c3f78e50c01fb,990446,2020-09-30 17:21:29 UTC,1544779988,1544769988,false,10000,0
58eb8d833f1a7729ea008d909381f0ee5ec7566fe54eacb2a22595471c9a4f09,990446,2020-09-30 17:21:29 UTC,4046667437,4046660436,false,7001,0
e4c4872ffabecfc528d3663051c23dda523110499d0e378370d8e54905a86710,990445,2020-09-30 17:19:19 UTC,250,0,false,250,0
49877a92f5ba05707479b75801219b5bc5c1315e951ab3adcedf96be74a9d92e,990445,2020-09-30 17:19:19 UTC,132743478,132740518,false,2960,0
bebd0e7241f32f29d0e9c119148dc36815fabc9abcc8379acc6d9454bafbe6ac,990444,2020-09-30 17:19:04 UTC,2419915257,2419911517,false,3740,0
4f228942503eb27d76372008d6a34f6691bf67be4d0d2513598c1f2a4eec008a,990444,2020-09-30 17:19:04 UTC,500255247,500245247,false,10000,0
78b33a889c62f9ca5bef2056c5a7189f405aee5b140e3fd1462917bfae714722,990444,2020-09-30 17:19:04 UTC,10000,0,false,10000,0
330ce0f1d3246905375a870ae58018b21d82b37b3a3753b8d40b9e082cb6858d,990443,2020-09-30 17:17:53 UTC,34710252,34700854,false,9398,0
2f9616df5d5b63a5254994b316cc039eacfaf2f77d0a9f65711bad5477bdbe27,990442,2020-09-30 17:17:42 UTC,10000,0,false,10000,0
e1c9a0679cfd600ab496be1fd1c902ad137357f2fb2ffcdd4dba9978497fe48d,990442,2020-09-30 17:17:42 UTC,34757866,34748468,false,9398,0
f27b59fbcd0b94e31ca8d78fb35390f073a6b234456e98f82639263e216cc8b5,990442,2020-09-30 17:17:42 UTC,29257566310,29257536310,false,30000,0
1670bf907d9c5e3fd7e07e00c4b27d5d4c945e99fac687dee4a3b040c8d6f94c,990441,2020-09-30 17:16:37 UTC,27877183,27847183,false,30000,0
17f525c22a1ca045f8fd7b515349d46497da9f3dc47d0351953b00d617f5f8b8,990441,2020-09-30 17:16:37 UTC,500265247,500255247,false,10000,0
ac04ff024161503f8d6aa8e5ab5d282e89772989424aa6784bbf1e46fc98e427,990441,2020-09-30 17:16:37 UTC,64127,62099,false,2028,0
7b67581c12ca64a95302120e651a27b41f12776d1442f35b4416e4415e59c31f,990440,2020-09-30 17:15:30 UTC,7856498504,7856488904,false,9600,0
b71a7187dd50260a6daf7d5434c8c534f8f0327bea8cf72461a7f3831316496e,990439,2020-09-30 17:15:20 UTC,10000,0,false,10000,0
e796bf4c0461342cff1c95164cbb25450ab6db365c9662f8eb7fc2197a0ba1a0,990438,2020-09-30 17:14:45 UTC,929000000,928997707,false,2293,990337
d54b123c8afa3a58eb35639735e9d49faf9858917af43f26f1a9d3731a304810,990438,2020-09-30 17:14:45 UTC,95207701,95203516,false,4185,0
392dd0c121d0588aae4aa950356d191913fc71250585e4100f0d548d23b9239f,990437,2020-09-30 17:13:56 UTC,2500109988,2500099988,false,10000,0
ef38dd26ec3d6ab809f023c0b9a36e36cead558c192808879703ca89fe882d90,990437,2020-09-30 17:13:56 UTC,10000,0,false,10000,0
dfa172b1b08a9fa800208184205f49a2cdf2eb41b94284c9274d8e1a799779f8,990437,2020-09-30 17:13:56 UTC,55465861,55463601,false,2260,0
624dd988d36f556c1dc630c7e1c87899af21dd17b02d68499d40b390a2d034c3,990437,2020-09-30 17:13:56 UTC,1414787910,1414710875,false,77035,990426
9c37c93455c7bef47292c62c8fe844376533c3feb5527310e9f9d9beb4ca1933,990437,2020-09-30 17:13:56 UTC,10000,0,false,10000,0
c3f4ccf0ec6ab0d4695e0183f2344b9d2ed656a27cd27910c3a5fab513b7bd3d,990437,2020-09-30 17:13:56 UTC,483833313,483800674,false,32639,990426
ae34fdd9238bb900589c786950208db3256bb9bdb0abb140846acb29022993e6,990437,2020-09-30 17:13:56 UTC,239701979,239698239,false,3740,0
5603e171816f9a1497bf72b6c5dff7cfc22f7dbc45ee08cddaf251a557835413,990437,2020-09-30 17:13:56 UTC,2365105036,2365102734,false,2302,990426
aa371760d3023e225055cd42a6bf8410357b03f9d1c349cb73f4cfd062061466,990437,2020-09-30 17:13:56 UTC,1280514962,1280439778,false,75184,0
92fb2f12d63fb2ea00b932d100ca549c8c0bb1db08f3f2408fdea38461e48239,990437,2020-09-30 17:13:56 UTC,10000,0,false,10000,0
bb6eb2bec11e293c797da0dd2aebb4956e5344a861c8fcc501bb0b2ded66872a,990436,2020-09-30 17:08:34 UTC,1499990000,1499980000,false,10000,0
e488d4613d95d531586506eb016f97c2212a41ec0d1a45c9ab417a3099dddbd2,990435,2020-09-30 17:08:30 UTC,34995268,34985870,false,9398,0
bdf90b4195e0883dc7bb556338a9cb24b2e6c7ebd459bad8e15a7881d2b2a4bb,990435,2020-09-30 17:08:30 UTC,34930930,34921532,false,9398,0
5cdb20b8842190dfdcc1917f2334ac9b3ea69af03871b46ba7c7299cb45a4c0d,990435,2020-09-30 17:08:30 UTC,100080706,100070706,false,10000,0
9348c871285e5618c21d5bb88bb235ab5d7c11f8d6bb863c126b61358b1d941a,990435,2020-09-30 17:08:30 UTC,10000,0,false,10000,0
58b3a74f1a831d65342a7fd2eeb01fc592b29e2006712cb1a20736d6fa70060a,990434,2020-09-30 17:06:24 UTC,230735588285,230735578285,false,10000,0
182ebb599093c928e5184744765322172142c77d0b51480958d5daa117642ace,990434,2020-09-30 17:06:24 UTC,500032847,500022847,false,10000,0
beec1931d69e45b9ae909453da4f18008733400b517510bd4e1eeb936ee3cd47,990434,2020-09-30 17:06:24 UTC,2000423485,2000413485,false,10000,0
a8e3237d430b33f6a961754d6c7d77e41dc35ab7e88bcaa6c67125b6d96b3196,990434,2020-09-30 17:06:24 UTC,255079729,255069729,false,10000,0
99d6ebe5c9031a229f4004d935cbaa0c161779dcd6b250b9b85f69deb9b68da9,990434,2020-09-30 17:06:24 UTC,174223991,174221031,false,2960,0
e185dcbbab16146423a07671d8a84deda4a9c7b766dcd557f02b365528508c48,990434,2020-09-30 17:06:24 UTC,175136311,175132571,false,3740,0
319b5c891a6873e7e12b418ce4223f20ea0f14c511aa4c7bb53c51dcf3c0652d,990434,2020-09-30 17:06:24 UTC,629825657798,629825655496,false,2302,990417
55e09b6a8317b6b8309f909f2ef9cdfd58b8c1a6a9f568adecb0341d6647fde5,990434,2020-09-30 17:06:24 UTC,7000727187,7000717187,false,10000,0
1ce2be60d9ee0eb95a792d17a6558250f744d0302d9de81b7bbc7aaf269c43cc,990434,2020-09-30 17:06:24 UTC,1000000000000,999999997378,false,2622,990423
c47a7fe31f7180930518aaa4e2eb2a3cceeae2d4c38057e7ebd769466f5f8079,990434,2020-09-30 17:06:24 UTC,10000,0,false,10000,0
c5bbe24f88ec525979e262bc970e83ae3191f55a8110988d2d3b99b2b72b570c,990434,2020-09-30 17:06:24 UTC,117194596,117185206,false,9390,0
669ae6ff55f4e5362c530731c8968156472259fed677c0d36a22379b31118451,990433,2020-09-30 17:03:33 UTC,10000,0,false,10000,0
86385f089204450d04b861a241b3ee2ddd1623d445438c836ce7d5a868a79061,990432,2020-09-30 17:02:33 UTC,113052901,113050608,false,2293,990421
c7839e50cc676f4ae88ea13268660e50e800c8d2c8a144842c282bdac53ed3e8,990432,2020-09-30 17:02:33 UTC,35023019,35013622,false,9397,0
83555b85afeb33489db5ccfaf6540d2d5ed7c6dbc11a0de01516b05f3d6f0612,990432,2020-09-30 17:02:33 UTC,32101000,32098740,false,2260,0
ff0e012747154572bcbab12f4cd7abbbf203eb33e8f138874ce2a447b5c75e23,990431,2020-09-30 17:01:17 UTC,3019413,3016963,false,2450,0
6b01ead49c39db281238edcf6b22989fb08a7f36a06975baf221bf3b996ba224,990431,2020-09-30 17:01:17 UTC,1184151318,1184147419,false,3899,990420
0da8c75fb4c3ebbbaf7d5d73ca163edb3589bd8b776db10426782038bedac3df,990431,2020-09-30 17:01:17 UTC,1021285,1018835,false,2450,0
6d064d5637ae029abbbb2910943efb9a8e864a9a644689931a7ce95c6e806d13,990431,2020-09-30 17:01:17 UTC,1416397335,1416320675,false,76660,990419
51cba9f9f5619c91cb1ac77028ed72405a297d65276df2cfbc078f7b67fd981d,990431,2020-09-30 17:01:17 UTC,3959102,3953698,false,5404,990380
9a0dee76aa3dd481db2cddfbe374e6630734e00b042706cc744740ff597de030,990431,2020-09-30 17:01:17 UTC,56208155,56205853,false,2302,990419
092e7a6b46167595012fd2aa5654d77e14e9d5505ce8c4cbfa652ddc8e50a19a,990431,2020-09-30 17:01:17 UTC,10000,0,false,10000,0
d3c0d735cb3cad3b8adfc27d6f0c4a5e3d72627d7577397cb260a2f80e94e2b2,990431,2020-09-30 17:01:17 UTC,132917718,132914758,false,2960,0
d44d5e65c37281d87f9546302f173ca28b9dd79ae196d77ac42542df5ea85481,990431,2020-09-30 17:01:17 UTC,484380007,484353442,false,26565,990417
9eec7e3c5ca8ed4e5cf7f03de67a4abc15d835acfbe49d29de93f08e07828a86,990430,2020-09-30 17:00:01 UTC,634960569775,634960567473,false,2302,990418
175d516d68b836dd3a1a18702efc4224b9c5c4840a628e7cef97e99a81b1bcf3,990429,2020-09-30 16:59:30 UTC,13535373,13532463,false,2910,0
77dc7a4fb4009b0d66f9aa46dd2c1e3f0af586afbb69862380fbc532a5d96894,990428,2020-09-30 16:59:04 UTC,10000,0,false,10000,0
53212fe8058d29ab0058ed28e9d91db2ab968a0ece3fe6fa7265842187a51d12,990428,2020-09-30 16:59:04 UTC,79110654,79100036,false,10618,990417
1bbc71b6b5fe6eb6d5061a1c9dda821cd9982e1f5ee4541dc2a60dcad5d8d69b,990428,2020-09-30 16:59:04 UTC,10000,0,false,10000,0
81de9ae65b18fffd643d6a7829f7cddcd31c70ab02c72c5e9d3ef4351933320f,990428,2020-09-30 16:59:04 UTC,35084923,35075526,false,9397,0
75f38a6dc6fd5a2422d95044bac6206c4cd00c87c4019f7639e7e378822f5f78,990427,2020-09-30 16:56:25 UTC,1901788948,1901688948,false,100000,0
2879677c5c6dbd2c8f71d251f198ac367ef21ada03c9bff9a7d8f8b1bf4fdb52,990427,2020-09-30 16:56:25 UTC,500029516,500017431,false,12085,0
b462093401ec6dc853569f9fc71bdacee39f3864019d8db86ea4445058ee0e08,990427,2020-09-30 16:56:25 UTC,33832042471,33832032471,false,10000,0
206d49a81fd6c126dfd123c604b53afe5f1d9e3dd96baaff0960d09432832b1f,990427,2020-09-30 16:56:25 UTC,33976537,33966537,false,10000,0
f1b81911273c2c7da1bd7648853d43f8313c81b31298f3b4b9113f57b7653765,990427,2020-09-30 16:56:25 UTC,195264947,195261207,false,3740,0
81cb0ab2c075c3be62a25a0ec223ce0702e9764c8ebc1c4ad43c97b7a23726ca,990426,2020-09-30 16:54:36 UTC,10000,0,false,10000,0
17056638622daf33c2d7dd9c6f59200847381b2afd96aa12218bc46942160b17,990426,2020-09-30 16:54:36 UTC,1332142793,1332042793,false,100000,990414
4a0a06f7cd56b3e106ea4ab533d8e2fbc583593a6344be26c6f54429e52df8bf,990426,2020-09-30 16:54:36 UTC,142221057,142145881,false,75176,0
86b497603243fd49914424422c26b1e5520a04f6c8756edd5f83241b07208519,990426,2020-09-30 16:54:36 UTC,314068,313510,false,558,0
cb50bc1b8714b3da3140e5c451233660eb7eddb598e54242b913ccb4cd497083,990426,2020-09-30 16:54:36 UTC,195113523495,195113520805,false,2690,0
b1a21dcb5d7a2d7926e214aa418bb95ad697363c55bb9271077b9915450645e1,990425,2020-09-30 16:53:24 UTC,1026854007,1026754007,false,100000,0
f52001dc7ffb01694afb394c28a9ec9e1f35d519547291a79a0133c0701f37c9,990425,2020-09-30 16:53:24 UTC,500111000,500101000,false,10000,0
2287d3988b526c3a311d95e74247e853a3b59a3cf8e68aed971eb70dff57c477,990425,2020-09-30 16:53:24 UTC,10000,0,false,10000,0
bd8e33d973ad121296ce956644fce815c1d8793f65c91758663d06fdcb9168b6,990425,2020-09-30 16:53:24 UTC,35133995,35124598,false,9397,0
69d8ce29dbd2713574420d8b434e63ea8e27adbe9bbf84dc3963f6cf4c384814,990425,2020-09-30 16:53:24 UTC,455271313,455265313,false,6000,0
4505fa71ec2facf9c0334a5d248a9127fe542739b125b8bd2a0f9e947d620b27,990424,2020-09-30 16:51:29 UTC,223677165280,223677162930,false,2350,0
d9af940cfe6d48d54c7e72b2c68ecfb449913cba71ec405d20124ff0cd0697e5,990424,2020-09-30 16:51:29 UTC,7000737187,7000727187,false,10000,0
1b71435cd4d7ad7b520514a31859d6a73de022eac7db23ac182ff9d6d1e5d8ec,990424,2020-09-30 16:51:29 UTC,1418062687,1417982183,false,80504,990413
39e601349dacbf460312d2ae3dbe587b99b9301e5d166df64acc390438376dc1,990424,2020-09-30 16:51:29 UTC,3000310153,3000300153,false,10000,0
668afd1a6d5febbab2b9655ab361f1cfbde25639faf92fe47811c560f6f18330,990424,2020-09-30 16:51:29 UTC,500893015,500883015,false,10000,0
6f35acae154c0b1e43c82ab45b9712d3e70d94fb6d263513d952e101f1136aae,990424,2020-09-30 16:51:29 UTC,11665107638,11665105036,false,2602,990413
a8c6fc967b09e145fd1abb70f75fb1c194fed9b6f59a57a1c012fb1b5458b541,990424,2020-09-30 16:51:29 UTC,10000,0,false,10000,0
1f1709806526ca43deb02201ff23fc567e64593da32ca11c25c3d3f1ab84eca5,990424,2020-09-30 16:51:29 UTC,95706817,95703857,false,2960,0
4687e761da3cf24d378a2c2fc59d67f3af7c7169a553218eb0dea673744872c9,990424,2020-09-30 16:51:29 UTC,485166928,485134913,false,32015,990354
32b08a3b4d3c3ba8e9b26f8da793d0febb30dcedb22891192f638d4a4a745112,990424,2020-09-30 16:51:29 UTC,284568175,284547596,false,20579,0
df4cbf0735fbd0bb44c45172de5d6f38733a320b9087937aebdfcda04782f800,990424,2020-09-30 16:51:29 UTC,240183458458,240183448458,false,10000,0
27a76dded0a748192f086b54cbf6e459a8a217ab1f251c9bb228d53a555f0a52,990423,2020-09-30 16:48:52 UTC,153751,143751,false,10000,0
b5b844965287ef6b61e67eed2a829bb494edb06edd05052fde63747a937773ef,990423,2020-09-30 16:48:52 UTC,10000,0,false,10000,0
50ee64b639ce4780586a8a2ae2fd7dc8dcd3d0facdbbee8e65f71d66b5f374f8,990421,2020-09-30 16:47:22 UTC,10000,0,false,10000,0
d408a6453af6f09d9eeac4e167e3f4073abbbc15bf5e7d15c89edb3e1c3ff88b,990420,2020-09-30 16:46:18 UTC,1688340003,1688334003,false,6000,0
c9f456e241eddd1914a68e359f625e7d1090cd95bbf4908b733d1b76e77f7ce4,990418,2020-09-30 16:44:58 UTC,10000,0,false,10000,0
36940f575de3b37397e4f5641a40274aef4d15ecfd0ea10d942f4c4f85399ec0,990418,2020-09-30 16:44:58 UTC,41268825,41264060,false,4765,990394
6d8e0d00c18412e8145370ea39b291246e592ebd639cdad946c06a47dfd3e100,990417,2020-09-30 16:44:37 UTC,304969161,304965795,false,3366,0
75a7931dd5ba1ec2449d950532d04292a2a7c711bc171666d55a3f8036ed7bf2,990417,2020-09-30 16:44:37 UTC,35295515,35286118,false,9397,0
95052c23ffca9c55cb105def592cbfac0ce27a9c013da831e685b2df56900a92,990417,2020-09-30 16:44:37 UTC,500041926,500031926,false,10000,0
ada9b81b91542a376d160c2184c9370efdaed494c92217ffba9201378e814de5,990417,2020-09-30 16:44:37 UTC,1406473578,1406373578,false,100000,990406
e44301a7ff6de26b1360f31b70c4957f41d29f72621f0dcf8b28725370405320,990417,2020-09-30 16:44:37 UTC,35440925,35431528,false,9397,0
d27d44f9df4dae8a3a89cc2e841e6b46778257cea6e6fe4b87c6790b7f93d872,990416,2020-09-30 16:43:06 UTC,10000,0,false,10000,0
e5b78932ecea6e114191faf4c18d0669b77fef1905484ca865b6014bc17d21fb,990416,2020-09-30 16:43:06 UTC,174428484,174425524,false,2960,0
234e964d66f5c7efc495f3339324e22e95e1bfbcab29cef997bf5b35f7d2e457,990416,2020-09-30 16:43:06 UTC,150383260,150373260,false,10000,0
7d8b3238ce235534c24024cab04cefa749a8bd7a6da78b0e7447f121b8c92c5c,990415,2020-09-30 16:42:35 UTC,1401840000,1401830000,false,10000,0
ca7d9f1d28bf75ed2d736dc09fdd4b353966c137aeb7d4b5d49643def0f930a9,990414,2020-09-30 16:42:01 UTC,18806421,18796421,false,10000,0
51465853209edc15662f638e3682c8dd477900498b47c8a44d7527115ba0c04a,990412,2020-09-30 16:41:27 UTC,10000,0,false,10000,0
81fb5257c2a49bc31857d4d39aebdb70452c5e22e9c5e72fb79cc962576ecf38,990412,2020-09-30 16:41:27 UTC,1419636971,1419570168,false,66803,990401
446bc22cda041def80b734ddc6241b2e9b03982d25297cbc3910ffab93699e05,990412,2020-09-30 16:41:27 UTC,500127979,500117979,false,10000,0
f29b97ca31aa846b389cc6014b7321a8b45ac68bbd185782edc03070d34655d0,990412,2020-09-30 16:41:27 UTC,26944,16944,false,10000,0
ad8c45a6147f8a3e847cc2942385b62169a89e5b90aa0f6cfc4ea5cdc80dec5f,990412,2020-09-30 16:41:27 UTC,19757493,19749628,false,7865,990401
06cba3bef7cd07013766742d0aa98c0e7d894b21fe9d94f3e319b6771e89a123,990412,2020-09-30 16:41:27 UTC,11915692740,11915690438,false,2302,990401
0715ffac0aba8843a8d4eae7a93bf31c2c934ccaeb3805d069621ae845945b04,990412,2020-09-30 16:41:27 UTC,6267628,6265178,false,2450,0
83e99ad958d6587ff42d79bcbecca450e71ebbf3bde39c3267938e124a4a455b,990412,2020-09-30 16:41:27 UTC,485832618,485803807,false,28811,990401
d00e95331df46586ddf757917aba1411808c146513f0f6bd3aa65f35125f2283,990411,2020-09-30 16:38:53 UTC,10000,0,false,10000,0
cf2c586a394484ffe8b61a47cd04c0c30cbb7bd3079cbae8988a3046ceeb4e9d,990410,2020-09-30 16:38:34 UTC,3157925703,3157815354,false,110349,0
2ddb7275f6b6814b46556bb9ee594ab1a116618ef33219613fff8191ebf45477,990409,2020-09-30 16:37:49 UTC,20539988036,20539978036,false,10000,0
f8147fecc57b29b81f0612296d276412eddbe3f94b662e7bc92b5bb475d21d6f,990408,2020-09-30 16:37:11 UTC,500121000,500111000,false,10000,0
288578287a9d12228d418a938b605c8d3cdeed6e2864f7baa4a3f3952424502a,990408,2020-09-30 16:37:11 UTC,10000,0,false,10000,0
4f779c339b71ee5ccc7fd59c7ccfc7d0b509464dca49c950d9b851c1ccaafe44,990408,2020-09-30 16:37:11 UTC,1015547,1008767,false,6780,0
52250867bb11adfc6080614d73715888894094d6787ea8daf38f18846f895b00,990408,2020-09-30 16:37:11 UTC,35550883,35541486,false,9397,0
a30c5b00e4e1dabfc82d015fbf794cc0f5b74469feb1a949dc20fbeded262a11,990407,2020-09-30 16:36:01 UTC,1000028689,1000018689,false,10000,0
cf41a89d5c48d004f0d7ccb07b81e28e8eda0eda63e385aed326ff394d1d89cf,990407,2020-09-30 16:36:01 UTC,13999480000,13999470000,false,10000,0
a968f5da5d074940f3e18cea667e8502bc965eb6ec5754d3e15ec9a4a24453bd,990407,2020-09-30 16:36:01 UTC,634239520,634236899,false,2621,990396
e4f2935962504dc7b33658c0c5af5e16f019a4babbc374772c27fbf23ef0e128,990406,2020-09-30 16:34:53 UTC,10000,0,false,10000,0
cf0115e03ce29914564649ddf6940f5ce9f7f405923a484b9a044d13403323f5,990406,2020-09-30 16:34:53 UTC,50201802,50201462,false,340,0
9ccb89e9da81a0ed9b68ad669da362fece910e9f41e8c0eb1eeb3fdaf0696cd0,990406,2020-09-30 16:34:53 UTC,1311829098,1311753922,false,75176,0
f48d57aa8907ce931a9f3670b316fb9712374e62925f73b30294a0e510293f6a,990405,2020-09-30 16:33:32 UTC,10000,0,false,10000,0
f96033982bc4d3cb1d93d65f80049fba96aa13b009aebf37490371beab1ea29d,990405,2020-09-30 16:33:32 UTC,2770333940,2770331680,false,2260,0
11aa8ef0f44ee08860e1e993900180f4aa2a21b99225335e03141128f7a92f8f,990402,2020-09-30 16:32:36 UTC,10000,0,false,10000,0
5487db432a8aff010bf3bbba89bc4a6b9ff3ef28450cc05ce5ec8b88cecc149a,990402,2020-09-30 16:32:36 UTC,5588412882,5588409142,false,3740,0
6539538dd7b421dc6801438794f4e70455d0418925c7c02177fab42625971628,990402,2020-09-30 16:32:36 UTC,56919498000,56919398000,false,100000,0
91bec6be2520be2995decbbd8385f85dccd9713e61f2e84ada5df6ed6a71b9be,990401,2020-09-30 16:31:04 UTC,5035879758,5035779758,false,100000,0
7a8e569191e9bea7fd93804ff030351ac9a3389c0d45cdf53f049b1075f8b232,990401,2020-09-30 16:31:04 UTC,499990000,499980000,false,10000,0
be5cdc5f3a0fd0763a772171697a25d923cd5b58c1d4832d447660d118bea773,990399,2020-09-30 16:30:17 UTC,716601219,716598959,false,2260,0
0a5d9660d26380d5a5042ebc9d88ba7fcfb1f5233a9e761b3bd8bcb19d26c532,990399,2020-09-30 16:30:17 UTC,486541560,486510838,false,30722,990387
92950d9a5bfde0485ada000843c89f6cc7185400a993c71d11e19f5df0b5dca9,990399,2020-09-30 16:30:17 UTC,103911867,103863267,false,48600,990397
154f0240bd65d412ef8c602bf5f5d40bb186de51e127e790c099536acd132b83,990399,2020-09-30 16:30:17 UTC,31625199240,31625192880,false,6360,0
e1c8207ae59da692b4793773a42306f0f2b36ffc319fe46424993a204569c671,990399,2020-09-30 16:30:17 UTC,1421369195,1421297620,false,71575,990387
4b880296cd7cbaccb0b23edfc1789deb5e37db6448707752cc2bdbd7d695175c,990399,2020-09-30 16:30:17 UTC,133163646,133160686,false,2960,0
634dea4bfd5d870481ff007608e9ff209518a347e281c85b2500eda28925e58c,990398,2020-09-30 16:29:39 UTC,500000000,499990000,false,10000,0
138e442d3abd5e4d5ec1d8cc9119352b5acfb891a976a1fda54ff159fad674da,990398,2020-09-30 16:29:39 UTC,67736659247,67736643667,false,15580,0
4c06ddab6604740fdb8216d0616ea08e44225b2c93c88f40c3471ed205d53be8,990398,2020-09-30 16:29:39 UTC,10000,0,false,10000,0
74558e87df5b115864c9ce8cab2ec76aa4617b6140a66423c260d69027ab828a,990396,2020-09-30 16:28:24 UTC,100055998,100043913,false,12085,0
d862fbf2dac11b3ac9abfd07f58c5d89d1def575fa760c16d4fdbff7ad7b06a2,990396,2020-09-30 16:28:24 UTC,49974610,49973610,false,1000,0
f60ebce2b65e062524816b0f5abe5e4e3ccb5e5d4f19e4997ec508888859e76c,990395,2020-09-30 16:28:12 UTC,100000000,99997550,false,2450,0
71bc047ded731189f4c01769c9d39f8370de3f1fbea9a9376f113831a050af40,990394,2020-09-30 16:27:45 UTC,95856373,95853413,false,2960,0
73c5851cf9f5e6f7ce8560413380ec78729d60818fa860e17beeb02edd4507bf,990394,2020-09-30 16:27:45 UTC,35668839,35659441,false,9398,0
cf698160622d9d7f389c3bcd9b785cd17d9adc1ae6803f3cde913711f0a52da3,990394,2020-09-30 16:27:45 UTC,500058689,500048689,false,10000,0
6ebae0094d6f50c1d2b5b361ff6c5f325795ba232d1728aed792b88cef16b8f2,990394,2020-09-30 16:27:45 UTC,316686,314068,false,2618,0
7fae08b5ccf9beac39d78b610f6265a2d1177851fe6a25e8c6b79eb2e17acf6b,990394,2020-09-30 16:27:45 UTC,100182774,100181798,false,976,0
14219d84e22359278adb89d759de875852c6b3285fa07e89de501dd65fb582b5,990394,2020-09-30 16:27:45 UTC,2057826472,2057821252,false,5220,0
5269a0ae0ed0792b3002ec2687c58caf6d7f631ca84c1b22510b5d727097aa3b,990394,2020-09-30 16:27:45 UTC,10000,0,false,10000,0
241b4e81006d8924951cdbdedb50023556f76e1d6bbc43e2b8649a20fdb679ad,990394,2020-09-30 16:27:45 UTC,104943265,104911886,false,31379,990383
545a8ee8b9061967139cd9432ab0011ef1b387e9edd36bf90fc5093725fce89b,990394,2020-09-30 16:27:45 UTC,10000,0,false,10000,0
7701da30ebe31ed3347fda3c9dd1e8083a850afc9ef742097026b482336fb08c,990394,2020-09-30 16:27:45 UTC,132000000,131990000,false,10000,0
3af0c8cd30cd4563675a35b9fd76aeef066e49f672ce69580ca4155745fda5af,990394,2020-09-30 16:27:45 UTC,98625,88625,false,10000,0
72d9d1ba826b5bca84f1c671e7ec6119817132fdfa156a1ca830604cf574d42a,990394,2020-09-30 16:27:45 UTC,35640887,35631489,false,9398,0
7bf635b042067d7198483b4f518882ea87e143e5857e772a3e2664a9d5064f25,990392,2020-09-30 16:24:33 UTC,30000000000,29999997740,false,2260,0
44cc3bc9ecb464ce68966b22d6b663c7a57d7ef2d2b8b105c89158e80408c025,990392,2020-09-30 16:24:33 UTC,10000,0,false,10000,0
a885a0da8638675edc28e22155031289ab73eea9659626756993eb4b8025e602,990392,2020-09-30 16:24:33 UTC,500068689,500058689,false,10000,0
8205b9b6caf1f770139d667cccfd0958bc754e82b4815262fc502192d3edc782,990391,2020-09-30 16:23:07 UTC,12090140982,12090138689,false,2293,990379
283b270de845b24f0d94479eb213a3ba633618ffc66910b460f5fd4768b1ee1d,990390,2020-09-30 16:23:03 UTC,10000,0,false,10000,0
35e8fcdba5792cec7cc5e4f2cf894db96c4a1292f87290eb8f542101986f4796,990390,2020-09-30 16:23:03 UTC,35728935,35719537,false,9398,0
88832f657b59cfbd523bf7a17a61c5d62a19a0eaf6ddd458a092a1e2fa4a2927,990390,2020-09-30 16:23:03 UTC,35765502,35756104,false,9398,0
6f510890b3c0fedb9a01a3b2b39000e367ffca7c4d03d85a4e2168e465c4e351,990388,2020-09-30 16:20:18 UTC,10000,0,false,10000,0
67113b96f556a1221eae92037df4597eff39e3a62df364c68a0f6eee1ddc9d2c,990388,2020-09-30 16:20:18 UTC,487485218,487455154,false,30064,990307
b09614bb540ca309cb7538767d512979dfa4ced68bf57b9d0dd8192ae985cbaa,990388,2020-09-30 16:20:18 UTC,171623862,171602972,false,20890,0
9882c019a05847b23c598dd1ff6040178e092e5085a2c5a17c4e93f4700d3e45,990388,2020-09-30 16:20:18 UTC,1422670842,1422604013,false,66829,990377
af547ee1ea85e0c2fa38c9ef9e3010e2cb202fb47bb3b82ace4a9eef2e9e8fc5,990388,2020-09-30 16:20:18 UTC,97372813795,97372813026,false,769,0
a712294c5c9e17f8819586435c1e600770674abe1ed7e9cddc336d62461eb3f9,990387,2020-09-30 16:19:14 UTC,174694958,174691079,false,3879,0
b23a13c155671cb0993e439b7484753f563225f7658bf6ed8fc85937617e3ffc,990385,2020-09-30 16:17:38 UTC,266384459,266382157,false,2302,990291
437789bc1e5356b72f56adeb6d74af9807b2df4f36ede8ac300fac0d905ee2fa,990385,2020-09-30 16:17:38 UTC,10000,0,false,10000,0
890421891a8a18d6a4e20256ac4fcdc73f173160aab48d2feefe7af23ef0ec4d,990385,2020-09-30 16:17:38 UTC,21736548450,21736546148,false,2302,990374
271c352d831f64412947254bb37b140a3c7b6cb9f967e74077d15d5d10b7a327,990385,2020-09-30 16:17:38 UTC,16999500000,16999497550,false,2450,0
1ced0893f5810a2e2d361747ac73d7992a070bd6cdd2afc7a7c180ab246d0856,990385,2020-09-30 16:17:38 UTC,607775215,607700031,false,75184,0
be1c9464f14fde6c8a7a699b85edc54c7e10ff27982285ba272972650ae54956,990384,2020-09-30 16:16:23 UTC,10000,0,false,10000,0
4b93203e74a39b4f8941c54d7a150a27d09f550018da710f7664672cacd5b0d3,990384,2020-09-30 16:16:23 UTC,1330930000,1330920000,false,10000,0
28ef74e5b40f003c3742c7df9f5ed410b3e2cfd7363022b797ca2fbb2764b02a,990384,2020-09-30 16:16:23 UTC,100187549,100186589,false,960,0
86f12c1c21f8cf684988b3d9ac4d493c848e8944aba9ff57eecdce9217385035,990384,2020-09-30 16:16:23 UTC,256680061,256673281,false,6780,0
9608e603ef4b5d04b8433b21c3f867111301abd3a2e91930482a683f27a2417c,990384,2020-09-30 16:16:23 UTC,106082535,106072535,false,10000,0
c0b939a8ba49015d3edacfdc2a8027219c90e98996e363c1d408d95a99e1e178,990384,2020-09-30 16:16:23 UTC,10000,0,false,10000,0
f42c9eef29009af08b4b536b3d8d0e2f32f5d8d5e88717ff12be0241fba5a120,990384,2020-09-30 16:16:23 UTC,20010000,20000000,false,10000,0
c72d0793b684503b18548e98bf8b3c585948d2f742bf5af9a7b59b7775f68966,990384,2020-09-30 16:16:23 UTC,30061438,30060438,false,1000,0
624db7d34397225b62ac9a7425e7b03f5d4018ffe934c7f2d94a2b9de7cab0cb,990383,2020-09-30 16:14:59 UTC,10000,0,false,10000,0
a76b7de79ae9a4c141fe24e27de6ecb2835de8283a279d5156e0b129fba4cc61,990383,2020-09-30 16:14:59 UTC,38490463466,38490461173,false,2293,990372
16a1ca3e362596558c20eb318c39f77117a006a90a9c0dba12c50e8641be0411,990383,2020-09-30 16:14:59 UTC,35876823,35867425,false,9398,0
d904a27018623288bd79db3e94cfcb9d287ffb10b8ed88e087f2cae56d4aa5a3,990383,2020-09-30 16:14:59 UTC,133322698,133319738,false,2960,0
81b79af176995e24350c315eb249940b60a768605451e4eb410dd2aebcf3f9e1,990383,2020-09-30 16:14:59 UTC,488325149,488293187,false,31962,990372
8e55053390dfc6a78c5e5d4f995ca8226cb919c0600cf04e4cacb2ba8d699104,990383,2020-09-30 16:14:59 UTC,10000,0,false,10000,0
8b1f253cc6122412cd6db3bc15cdf387ad66ddece64a94eb4b6e6ea077ac03a4,990383,2020-09-30 16:14:59 UTC,1424391788,1424309979,false,81809,990372
1cc8ccb0fb34dac7d41709cd759ece1e6f9e552e1bd60895387a8f189478a689,990382,2020-09-30 16:09:52 UTC,1000002303,999992303,false,10000,0
34cc013be06f0676ee0f7a21088fc98d3ce437bf7293564c47312eb6975d3d6c,990382,2020-09-30 16:09:52 UTC,11998630625,11998530625,false,100000,0
7d120cc0ea0ddba93932568da89b6c751548fb4af8a2e7b56c08309b2ac084aa,990382,2020-09-30 16:09:52 UTC,10000,0,false,10000,0
bfc1b5c35efb826a266187750c72325d9140e857b31c296613b5564ef70140a2,990382,2020-09-30 16:09:52 UTC,16122996905,16122991179,false,5726,0
889ee4046a4e0dfaf79b9b0ba0e281616a9cc2e3d2bec30e67be0c0927dd926e,990382,2020-09-30 16:09:52 UTC,3158822738,3158818998,false,3740,0
2eb68fa241638019ce9f3cd9efecda458c338e5408edbda4540e486332ebe41a,990381,2020-09-30 16:07:06 UTC,96096890,96093317,false,3573,0
1bfa43249553a9648be4b15091ae1149cc7d001ad2fc2ce288bdb9837cba1d57,990380,2020-09-30 16:06:49 UTC,50169045,50160865,false,8180,0
fcae473eabd7761024a1606c3472d73e9893a099922e96c06e7e7ffec94d5eb9,990380,2020-09-30 16:06:49 UTC,84300000000,84299900000,false,100000,990369
01cbf3b979d13e30a30749b98c94a1e3bad6d9cedf1e656d0fea85e621fdb322,990379,2020-09-30 16:06:12 UTC,338832772,338830150,false,2622,990367
f65e43863eb493391d39a457e0776280d5b739a534bb040d97564a95429fc4f3,990379,2020-09-30 16:06:12 UTC,500012960,500002960,false,10000,0
251366f10d261230db37756afd25ac3dd537601b5a315fdeb7a081989ec0bfb8,990379,2020-09-30 16:06:12 UTC,20090343999,20090333999,false,10000,0
1c6f0af451913932ff100af646cf5ac86f2d12542153931f7dde79d77739c386,990379,2020-09-30 16:06:12 UTC,175336225,175333265,false,2960,0
1bd44af4fe96c3816b9dedbec9882ace47ef286ff37e5e336d8e1c68f1c1c056,990379,2020-09-30 16:06:12 UTC,35947519,35938121,false,9398,0
f1c9ffde1307291082c7b92c85c4d1bd2bc391de8b5ae4cc78c94e5438cf098b,990379,2020-09-30 16:06:12 UTC,1273285567,1273281348,false,4219,990367
b92c6c77ce4d62e4214e598658c48e24f6655e744241d001dbbe569438a1c323,990379,2020-09-30 16:06:12 UTC,10000,0,false,10000,0
f33dc02aa40d286eeb43f773757ef8384d4bf049f72650f6fca444e180b00355,990379,2020-09-30 16:06:12 UTC,24685,14685,false,10000,0
b9bcf5e667f738da77a7538bcf82baa0cbdc3caef18c596168092e298ec4fce0,990379,2020-09-30 16:06:12 UTC,10000,0,false,10000,0
83e1c24594166fe32e7562f78c0deb62f1ad34e8c4b3f27c582ec3b75ad8c939,990379,2020-09-30 16:06:12 UTC,8173978924,8173878924,false,100000,0
116300e9d02850cc34c089cea3319baecd8ccb4d8bda808b2c3d26e2cdcb705d,990377,2020-09-30 16:02:27 UTC,10000,0,false,10000,0
377dbef72fc3df809bf8e612f722cb91129bff6849be1d589e82831bebad016f,990377,2020-09-30 16:02:27 UTC,112074295,112066115,false,8180,0
7bc67c5091458a667b8e7e356b8ead59b556987b97e5b16b79ef6c4860181500,990377,2020-09-30 16:02:27 UTC,10000,0,false,10000,0
92a0c308d6c8c1bc4ed493f7f691065990085d6f6d0916f85a96aa19e3c2d635,990377,2020-09-30 16:02:27 UTC,3174061,3171771,false,2290,0
6a0d6a28f9a2d4d1267775ee16a83151da7e0e0c5b0a81cbf7190064509f44e4,990376,2020-09-30 16:01:15 UTC,500273847,500263847,false,10000,0
b2b56145918fcbd951230748faef1d9b8fc7b237cfc42ee3b1161ae347bb74c7,990376,2020-09-30 16:01:15 UTC,10000,0,false,10000,0
9bc68f09b0b4b3cd62738b4350aa81da88db6216b7128d42c0c1cf0c4e2885a2,990376,2020-09-30 16:01:15 UTC,699813088470,699813085529,false,2941,990365
af3c0a097f486ebdb3b7986510d7312ef64b6e172fb2a866181b32fb46bfe4eb,990376,2020-09-30 16:01:15 UTC,86910236,86907295,false,2941,990365
f4954a44f5e3f5b45209cb2660a8c3ab99d879971c6a4dd7116351e6097cb3ce,990376,2020-09-30 16:01:15 UTC,489044788,489013409,false,31379,990365
91ad24ddd8d02d0525ed0c2dbca2d72cc85b6038ccfa8b90e84e840d23021fa4,990376,2020-09-30 16:01:15 UTC,10000,0,false,10000,0
f0abedf6e166a9ba6602358cbe24374e2dda0f4514d2efd6c7d21b4021f76a05,990376,2020-09-30 16:01:15 UTC,6006631883,6006588183,false,43700,0
ababc524f1cb2062b135fdcb25d33e86f695e3394059b4afcf690946a8fcc540,990376,2020-09-30 16:01:15 UTC,10000,0,false,10000,0
b1cc30795d39b2f857a583d3eb397ac56f1855f1d2d27b8c3fb89a83b2d29b3d,990376,2020-09-30 16:01:15 UTC,256906,220946,false,35960,0
41abb88eb85c93f14b761790d75c1a793c54db99beb674974dd151a22cf49777,990376,2020-09-30 16:01:15 UTC,130209,120209,false,10000,0
110e7df9a43507158c03628baefbc0501bfaec2260fc28869e710ac9bc9a622e,990376,2020-09-30 16:01:15 UTC,27115,25969,false,1146,0
1a36fd3f9c3c398752586df965748cace4dfa582221d6bf43ebd077399fb4e6c,990376,2020-09-30 16:01:15 UTC,17725973,17716575,false,9398,0
73748e84ea85253d0048a5b231771137e1f0e9f4e33730fe3d135a3ee11a70c9,990376,2020-09-30 16:01:15 UTC,560461514,560386330,false,75184,0
886040195c1bea670fd1aa17e70383787b0353bed89c9af4372c24109fe0caea,990376,2020-09-30 16:01:15 UTC,8416000000,8415997698,false,2302,990365
d04774d093fa6344812678a3f369098603d59fbc03bff8d92b390811bcce9a93,990376,2020-09-30 16:01:15 UTC,96284122,96281162,false,2960,0
cbb98fab8e55dc2e80dfe6bb22f955af2fcbc687890859eaa6522e7cd639ad31,990376,2020-09-30 16:01:15 UTC,48303888260,48303885977,false,2283,990365
7ac3927116f3cddf978e2845a915b502df233a786ca501494eb85af303f76ef1,990376,2020-09-30 16:01:15 UTC,2499939716,2499936042,false,3674,990365
2b964ca0345733942eb51185ade6853965f6a96f2a7577fc4344f5b5f7cb627e,990376,2020-09-30 16:01:15 UTC,133755505,133751626,false,3879,0
f923a2e20442927b6438a6c9e4cfb9948bb24aee3893f42fa4947acd9ab2bf4d,990376,2020-09-30 16:01:15 UTC,35977388,35967990,false,9398,0
a9089fd3d913cf88a114ba7a0c1967d5cc8627c9308b80b26b958a30b5191372,990376,2020-09-30 16:01:15 UTC,1425941355,1425859508,false,81847,990365
fce7e8781da13ceb93cc1a06cca43740099ae718a0b82865edb68904b08e3f8a,990376,2020-09-30 16:01:15 UTC,23265037855,23265031855,false,6000,0
8b8f1441377ac4874a140851bbddf999386a710d8f9cc03dcb273053d4d9abe2,990375,2020-09-30 15:56:13 UTC,130468800,130462800,false,6000,0
004a38870e9d5e220cc898f211ad256672f6b0ea0a5ad5799ac0b1745dbdfc51,990375,2020-09-30 15:56:13 UTC,58799443,58792663,false,6780,0
33f0536e1c4ac0887da5a8a997f6cd8ed385c89b7754c05898a69fb8ccd1f7ad,990375,2020-09-30 15:56:13 UTC,56719890562,56719888260,false,2302,990363
7cba566703fe82c835fac6d95af7b1e3d30542fb76834e1d03a6a10737c8982e,990374,2020-09-30 15:55:59 UTC,1499980000,1499970000,false,10000,0
595ff3180c4972b87075424c89267543be75f148275c706258bde04f235a4728,990372,2020-09-30 15:55:23 UTC,1075537,1065537,false,10000,0
bbe15ad7223ca9ba5740f42c9f4071442ef98eb3b5798a4b3100837016a93560,990372,2020-09-30 15:55:23 UTC,36133798,36124400,false,9398,0
35c315c9bd06369f2c968cf292487b400ec656370748e2662e48db3b10a14dce,990372,2020-09-30 15:55:23 UTC,143045181,143042731,false,2450,0
a48508790226ed595a81cd4362989a45b4a1c44908c76a4ad9f68373b188c3b2,990370,2020-09-30 15:54:19 UTC,256690061,256680061,false,10000,0
db01479880efd6aa21efefaf4eccd27f35839d960806f95591e6dc3651903e5a,990370,2020-09-30 15:54:19 UTC,10000,0,false,10000,0
65e7c10ef6715a8e1fb99c919e4699bf2efddf431bf845c6881d2d20df1a8dff,990370,2020-09-30 15:54:19 UTC,100000000,99997550,false,2450,0
c07bb0e0f298a686dd5716c295874aed789067ec6cc3f95b02d8f8aa1ad88686,990370,2020-09-30 15:54:19 UTC,456426427,456421547,false,4880,0
77ee06d1ffebdb0661eb1fe8bc6a8abd16576392a0cec266a2491e0737bf9ce0,990370,2020-09-30 15:54:19 UTC,175746325,175743058,false,3267,0
5f877413548347cff788aa1534733e9b606dc1e5b675216ff30a7c5d8670cf33,990369,2020-09-30 15:52:28 UTC,133914189,133911229,false,2960,0
f113ac6a711d2822e6c7de531d98658b8a101ed5abd602a2878533a8dcf8506f,990368,2020-09-30 15:52:02 UTC,9032800000,9032797698,false,2302,990357
047f5fd2342ae14978fa25503a94872a2fe881aa55d9002af608f548bcfeaf8f,990368,2020-09-30 15:52:02 UTC,2111040937,2111037263,false,3674,990357
93a200d4813f4b2993a74fae6e2fa25d020b9f9bf2c62f7b08c64c0806e0d4ff,990368,2020-09-30 15:52:02 UTC,23130166165,23130147504,false,18661,0
cce959b2bd081c8ee1feabca43dfb525207fd82178070f3536995649a3ec1c5c,990368,2020-09-30 15:52:02 UTC,4992277517,4992275215,false,2302,990357
ecf91aa894347add5cadbf05dbe59cdfeecc2df6f0aca9d271a7dbde32bd7279,990367,2020-09-30 15:51:35 UTC,489673594,489647966,false,25628,990356
d120824030a518fcd68d7c6c63f15d30633d3ed3fe091b4c20c6b6387419741f,990367,2020-09-30 15:51:35 UTC,49724261,49714261,false,10000,990355
9568634f94824c1f2d07f5e6bbd6f86eb9e62324ee05cafbd2f1ce8b1d0ccee7,990367,2020-09-30 15:51:35 UTC,36204395,36194997,false,9398,0
16b98b52f3535cbb7d9bf2b45c83af6386b6e28373700d73e08ac2874edbfe08,990367,2020-09-30 15:51:35 UTC,1427707189,1427635586,false,71603,990356
f3e187750dd06341a9b281e9b9444c611043ef6df4a484e530841cc8695dffe4,990367,2020-09-30 15:51:35 UTC,36167882,36158484,false,9398,0
b04724877fba0f0ac2a66daa680bda050625957537f269c56168cfb9ae758a3a,990367,2020-09-30 15:51:35 UTC,160218056,160194058,false,23998,0
a5331cba15024ef8fe4304c493b0a3a17afe2739e0f304106e200914081fc709,990367,2020-09-30 15:51:35 UTC,10000,0,false,10000,0
8c88e1c1721be3b5b9db6a885f7e080d58815e83db344f23e05ffc5bba057529,990367,2020-09-30 15:51:35 UTC,305614765,305542765,false,72000,0
80f22e19d27e76218375efa9c9d7a27d69776d0948deb59c4d7f2dde3fc3c7ca,990367,2020-09-30 15:51:35 UTC,19770201179,19770191179,false,10000,0
91611591910eb6ee98a9af35a32db5e08313d8950bfaf2bdbe0f6ab9f94adada,990367,2020-09-30 15:51:35 UTC,65752692855,65752690562,false,2293,990355
63d331bb44551e3229561ca092c95f34fd0a3a0470cd7ffd399f13894f5daab7,990367,2020-09-30 15:51:35 UTC,10000,0,false,10000,0
60aee8a940507b481ac62ec43f4fc82c963f00d46c5ab0dd9d2b6acd95f8fdaa,990367,2020-09-30 15:51:35 UTC,500283847,500273847,false,10000,0
4c249c65f206278a14249f47346c9970aba81e04df32395a57a1979e458113d2,990366,2020-09-30 15:48:14 UTC,504940099,504930099,false,10000,0
11377e5727e3de9f008962337ec1931d6040e32a98dbbc28bf94134826c06417,990366,2020-09-30 15:48:14 UTC,82452195157,82452192855,false,2302,990354
b13ab985ae78a20c12ceccfdc92836d4771319c04094acdb2e69103a25ba0a36,990366,2020-09-30 15:48:14 UTC,96743128,96740168,false,2960,0
05db0232b49c247ffa66ebd4ddbb43e618b466c6bdf5d811621c8556157aca06,990366,2020-09-30 15:48:14 UTC,26532934,26531934,false,1000,0
e14c69dda691cf34794d8ca4a857cf19ec7e90f47327f9589dc01dec6ba3adbc,990366,2020-09-30 15:48:14 UTC,3049967035,3049964775,false,2260,0
76488c903bc634a1ca86485de842276888fc23bc09ad6e56c0accb700afdf095,990366,2020-09-30 15:48:14 UTC,10000,0,false,10000,0
ed960c03f0ad235b4a2815c1ff6a357995d0b677ba12d7ed677e64b8314b25af,990366,2020-09-30 15:48:14 UTC,551868462,551826162,false,42300,0
1353e37e52508c018d9bbb7983b7ec9a35df7501e68864871ba3d48b5b16c755,990366,2020-09-30 15:48:14 UTC,31144,29998,false,1146,0
e91e63e79ca6459f287c9a8ee9e391b9593119011b4a3aae054b2a35532a8a96,990366,2020-09-30 15:48:14 UTC,10000,0,false,10000,0
31d6f615e919c1980dac47ef69c9afb5c8bd834c522a06b2868003c4515aa560,990366,2020-09-30 15:48:14 UTC,36457999,36448601,false,9398,0
fe74aeff21f317a02bb3187778bc51395f04f1b48f53bca5cf943ce855be312f,990366,2020-09-30 15:48:14 UTC,500002450,499992450,false,10000,0
ae79a2c86544678a623e8b4f51367cec483ac6bf086c0cba31cd1bf5510d5868,990366,2020-09-30 15:48:14 UTC,500293847,500283847,false,10000,0
c38c6bebb6f5052bbeb8f0eb14b94230d105a5abeaeb350b2c6f9c91e15794f5,990366,2020-09-30 15:48:14 UTC,20072725079,20072715079,false,10000,0
46dcf5f1f817f655a94303488cdd2741a97ec2213ce974b7733853c55a53028d,990364,2020-09-30 15:43:18 UTC,17000630468,17000621258,false,9210,990352
9578a740951b63be2f2ade95efed83aa23352fc83122ba3b7c5dc5aa39ee5ff1,990364,2020-09-30 15:43:18 UTC,51973816,51972816,false,1000,0
048b0564ab67750040ce9f2a4d2d75656c90a437c80bac60bfb1334388f813e6,990363,2020-09-30 15:42:26 UTC,4718207517,4718202443,false,5074,990351
7126c5af1189130f9d71f42a364ba52136ed300cfc05a02dc8779c29edf49130,990362,2020-09-30 15:42:22 UTC,36485464,36476066,false,9398,0
14ae56f91290520d7410c816072fbe1167b4c530805b6b351470b011864b74b0,990362,2020-09-30 15:42:22 UTC,10000,0,false,10000,0
7c857bcf9c369cc4f3d9de068a4afb580868a200ea82193eb3d2510bc2487ec5,990362,2020-09-30 15:42:22 UTC,1410481791,1410381791,false,100000,990351
6e1979a18f4d8b8d284506dbd67f0fda7296a0be7b26e90a23906388061c8509,990362,2020-09-30 15:42:22 UTC,20072735079,20072725079,false,10000,0
af5cb4578f1d380c9ddebbe0a3f8d57b8487684c94469b61f96f6d93cdc48155,990362,2020-09-30 15:42:22 UTC,10000,0,false,10000,0
9fc1ef376cb8c3c6c76ddc33fff3ec46f4dbd1918a1e3e398a7f52bb374d11e9,990361,2020-09-30 15:41:30 UTC,9619080563,9618968845,false,111718,0
d41406efb31af7b401b6cf2997a0aa6ebef4c4a6b2475b8bc8c1fdff57c4dea0,990361,2020-09-30 15:41:30 UTC,491616181,491580037,false,36144,990348
302552d2e8c9f05547e6e81eaa29f76268d852a4eb1b8f2beca62d20c188b157,990361,2020-09-30 15:41:30 UTC,9436701,9426701,false,10000,0
bf8f451296c698a8355f399141c9f211f99d0be1e2da443c99022c0dbf012b8b,990361,2020-09-30 15:41:30 UTC,15412434,15404587,false,7847,990349
fa7377a81c9fd1d298601e393dedcf79e908cde7308c009e9e0f74938def281e,990361,2020-09-30 15:41:30 UTC,468448769,468373585,false,75184,0
48d0b7d9eca4ee4692c21532d59b9e50a024ca147331a685e128bd9f7dede071,990361,2020-09-30 15:41:30 UTC,36518615,36509217,false,9398,0
7bd65279321ca888dbc59207be1f096fd77d587ccf5c8faa8be4bf054a5c1cf3,990360,2020-09-30 15:40:06 UTC,1429737790,1429656338,false,81452,990348
231331b749cdb3f402185b7165ebf7f90b0080ee87d17b7c7694bfd7bea76b8a,990360,2020-09-30 15:40:06 UTC,175902446,175899486,false,2960,0
429a5a490e4af7c6565a2720b6fa89e6b4eac9d687e96188cd72d4da8cd2525b,990359,2020-09-30 15:39:56 UTC,10000,0,false,10000,0
71563cd43e0fc24cd28289636a7ce497d5234c418eaf529a479788ddf99c1ee1,990359,2020-09-30 15:39:56 UTC,80094838,80084838,false,10000,0
97a1a4ab615a337f0fe64fd440890b08b744b49e25adab68aa1286210c9d6f42,990359,2020-09-30 15:39:56 UTC,36547870,36538472,false,9398,0
68c4acb293ce92c6acff06ae79c7fcd0f8bc44bf73d6b07bd215f00525410129,990359,2020-09-30 15:39:56 UTC,10000,0,false,10000,0
6a6ef566c852dd4252ec931d9abc709333131215fe8afcd022c6e660a4b355c6,990359,2020-09-30 15:39:56 UTC,1000083670,1000073670,false,10000,0
9bd06e07278782127e0ecfbb704bb421ff517224b0729441c37db2a5ceca4e87,990359,2020-09-30 15:39:56 UTC,2990405569,2990395569,false,10000,0
1186ec5e4a903f3ddcadff0e2fc5992eea9f98df13182261dfbf768805619ec6,990359,2020-09-30 15:39:56 UTC,182209000,182199000,false,10000,0
48771642d8d3ed0a544689e53164cbab721eeee2d30c28c175eb59f906684d47,990359,2020-09-30 15:39:56 UTC,10000,0,false,10000,0
a7a4bc8c694dff1d3285d6fc526c87f55aa72b6134d6e9d818596fc83085c27c,990358,2020-09-30 15:36:50 UTC,387136060,387133800,false,2260,0
0bed785f64404669ff5dbdd6c5a8655d9a35b571a0ec3f360e613122ccd6733a,990358,2020-09-30 15:36:50 UTC,10000,0,false,10000,0
9156a5101535ccb37da5e3d100df03d42c9c845a0d9e26b1d5c417cc19bfb7aa,990358,2020-09-30 15:36:50 UTC,1198873,1191017,false,7856,990347
809571de42dbfdb9ff206a80bdafeda9a9be54a27b82d7bc96349746e89b49a3,990358,2020-09-30 15:36:50 UTC,2628920458,2628908373,false,12085,0
2cd7befc32da6907525d468d1664927bea6cb0ee5cece95c8ee5ce48618fc4c9,990358,2020-09-30 15:36:50 UTC,725979,715670,false,10309,990346
d5a1820742ab478f281aabab47da98110bc3e3d14aec9953b27a1781cfe71a9c,990357,2020-09-30 15:35:42 UTC,36827391,36817993,false,9398,0
0ba982fd010cb8e5a3954ab41c2fc1dd7ebcd378cda8367ad2f494ad0cda04d6,990357,2020-09-30 15:35:42 UTC,500110403,500100403,false,10000,0
d02d65a77c4dc27943378ecddfd30e4cd3d6aaf9c5b24b6211fa5af9e6f83db7,990357,2020-09-30 15:35:42 UTC,134417265,134414305,false,2960,0
6198d80519a8cb1619dc8c65fd6cbcb9be95880f7c707ba17083cb4a6b55bcac,990357,2020-09-30 15:35:42 UTC,358481428,358479126,false,2302,990250
698700086e3853709bdd95adf46380205296324ba338028ee2dedb492e103049,990356,2020-09-30 15:34:53 UTC,382070061,382063941,false,6120,990332
5db30f1fcd22b6801a0f865e1d99a89c1a112b784d45536287d3941c7b410c23,990355,2020-09-30 15:34:43 UTC,10000,0,false,10000,0
146fc5683251797dc0892a86fb7303b78140017df58350f2431cd2e0321f7ff1,990354,2020-09-30 15:33:24 UTC,15004986100,15004983807,false,2293,990343
02a4b927b01d7a036a619c26dec5cf8a326af0ae9d3a1b7e974bfb0cff72262c,990354,2020-09-30 15:33:24 UTC,10000,0,false,10000,0
3d4bd9e02aa25f67a70d1c1a3cbcae9c069accdd5ec7e0ab175d369de687d9c5,990354,2020-09-30 15:33:24 UTC,3083027149,3083021262,false,5887,0
58a241ae83da353bd5f9485b160994fcd3e21634aeebe50bf8709a4de60f5a64,990354,2020-09-30 15:33:24 UTC,500120403,500110403,false,10000,0
03d888a3606c7addbf502c41079e570721fe5b753fa466eba9ceb6af8fb35aa8,990353,2020-09-30 15:31:44 UTC,2160373292,2160366292,false,7000,0
ad08c941a2a994ec91f7e1031025017e65353a4ad992b1db59b72acaf5c63b22,990352,2020-09-30 15:30:48 UTC,499993267,499983267,false,10000,0
9f4b2de0fd6939451fd83de273172fb1910b0f26b67f85a93adca829318013ee,990351,2020-09-30 15:30:32 UTC,74272614955,74272612605,false,2350,0
23dad6a0824ed784095fa4ccec7c03809b211149b346d4f22563fec7cf3112e2,990351,2020-09-30 15:30:32 UTC,1191819900,1191809900,false,10000,0
c2a0a27d81eb2a402455591be325b27740acaf1acf91f29843550c5e882c635c,990351,2020-09-30 15:30:32 UTC,172122919,172092919,false,30000,0
97fd0930b166461acd333058e112b39cb23f5d9af89df7c03fa1fda1f63dc813,990351,2020-09-30 15:30:32 UTC,492568638,492535069,false,33569,990339
dc3e09a7a692bee720b40e33763c972e9d2e59d86392162e9f4b081255d73443,990351,2020-09-30 15:30:32 UTC,10000,0,false,10000,0
43804d8bbe9ede5562fec49b3d0b11f5c33fa2cec8911705d93d44b1ce2daebb,990351,2020-09-30 15:30:32 UTC,95560391,95550391,false,10000,0
dee08972f127bbb476ff46706085ec82aa9b60dcb53f63e6a3ee4627f744edd9,990351,2020-09-30 15:30:32 UTC,96888015,96885055,false,2960,0
03d545ec1532b43aeb0b069f474242619bceec07822e3eb40ca4b86e6a39e907,990351,2020-09-30 15:30:32 UTC,1431251180,1431169409,false,81771,990339
bca5825ec304f1f62c3e855b531c5a1fd8131839e540d9ef383a3679686cd6db,990349,2020-09-30 15:29:37 UTC,81216,71216,false,10000,0
024e176e3a3cc86e589be80dfacbf2438248b92322a2e69be6b41189992f562e,990349,2020-09-30 15:29:37 UTC,36866680,36857282,false,9398,0
77295cad657e6391c1f6e5abd14f12d99a691e5874328ae2f510795174c9b44b,990349,2020-09-30 15:29:37 UTC,2110951156,2110939071,false,12085,0
74f4dfdb2f0222dcbc9559570caca4848fcb00bb76d6012b2b40b3a53721ba4d,990348,2020-09-30 15:28:58 UTC,176242729,176239462,false,3267,0
9c5e3561fbfb6501f0dece061e99bed41b3bf6ef26959f250f4d2e6385535321,990348,2020-09-30 15:28:58 UTC,500003267,499993267,false,10000,0
c4a18aa5f7b0ed1129d29bba7136cab4c809fa253535fd717e6b25e10ea2baf2,990348,2020-09-30 15:28:58 UTC,500000000,499990000,false,10000,0
d1a597aaa384bd8fcb63108257b11ff7f2d255290cbcb406c452507d7a1f75a5,990348,2020-09-30 15:28:58 UTC,10000,0,false,10000,0
45d17b682a5c9096b716f1b6bdf4e34b01c61dc7ad8740152ffd7cd66a23669d,990348,2020-09-30 15:28:58 UTC,82634406459,82634404157,false,2302,990337
708ac2a79b7a66458e98814f15914120bb0680e82dbaedf17dda5c1e09ac35af,990348,2020-09-30 15:28:58 UTC,5132111256,5132109674,false,1582,0
01bba15322c7bd1fd2fb064d7fd2da173632876913cc2522cf8cf8f7ea13f8b7,990348,2020-09-30 15:28:58 UTC,19670789254,19670779254,false,10000,0
073cdbd101732026b7f1fe8555392eff5ee8f722980e921fb97b1cb4151e5b35,990348,2020-09-30 15:28:58 UTC,13533085004,13533075004,false,10000,0
af32f152d199bd18f32cad1f85cb7ccc761c91635729c55e551524a1a351e944,990348,2020-09-30 15:28:58 UTC,10000,0,false,10000,0
3dcd947b3926f2bbc0bdda72def6d0dd33e5bdfd99384bd2d90c47a71c2fbcef,990348,2020-09-30 15:28:58 UTC,10000,0,false,10000,0
02583805582f47ad9b617305af09ca74416aff0759df90d186ef21b96b46b6e2,990345,2020-09-30 15:26:08 UTC,100000000,99997550,false,2450,0
6c3843ad200ad356ec938a5bcc5fa0b1fe2dc56f005e17484f8f130e05bc011c,990345,2020-09-30 15:26:08 UTC,10000,0,false,10000,0
e31fa5b047460ad249f209bcae73b2e69329ceedf46a0b5261b3775ac0db8384,990345,2020-09-30 15:26:08 UTC,19992241366,19992231366,false,10000,0
407b23e58cfdfa5c1497fa93fdc6906e3fe96d9b17dd857c1e7c4d7c13809ef9,990343,2020-09-30 15:24:11 UTC,10000,0,false,10000,0
3a1465fead138a2c5d0332a9257df6f0b4519e09304cbe89513cb2b8b1f18c84,990342,2020-09-30 15:23:44 UTC,280000000,279997550,false,2450,0
01c236da4a8a79c53ae76312593d6b032fddacb484bbf5d9295627abcbea7ab6,990342,2020-09-30 15:23:44 UTC,421121607,421046423,false,75184,0
98ea969f4ac56493b0fda1fb7ad57478fec93a270d79cb6a4a22e044992c271d,990342,2020-09-30 15:23:44 UTC,74351622089,74351619739,false,2350,0
43ca226f29ae2667b9091076689d48813331e8a052d7d4c4e75e33fcfc5b0718,990342,2020-09-30 15:23:44 UTC,19992251366,19992241366,false,10000,0
dda1b96363832193202b17f284c5b420d314c0eb340427361fe18d2ef612e3c1,990342,2020-09-30 15:23:44 UTC,5991912613,5991870505,false,42108,0
0f3cbf6c0363b06d39d1034af0ea51588f86d29b95bbe103f916e11921beee6f,990342,2020-09-30 15:23:44 UTC,134655281,134652321,false,2960,0
2337cd0a3529e491dcb76a55bd92ba3a872ed005d8fe6bf1ffbc0d7b13cf8f31,990341,2020-09-30 15:22:46 UTC,5355019287,5353743384,false,1275903,0
840f8eb9d6d9cf6e938b5afb4acf58fb227ea463530e1c28a78af89b2bdcccce,990340,2020-09-30 15:22:28 UTC,58811443,58799443,false,12000,0
12d3faae824fbe26e0fbef3d9694ee870c8ab5f7953a4b60e1f45e6b65eb074b,990340,2020-09-30 15:22:28 UTC,88783013319,88783010697,false,2622,990328
1e2713a9eae5704272bbcc3a5acd24f56c73846384a7bf8520dd80680779b46f,990340,2020-09-30 15:22:28 UTC,10000,0,false,10000,0
bb3b8532c1206b00ffd4c0b256e62346915ecea9739523d632ece64ec5c357b3,990339,2020-09-30 15:21:47 UTC,10000,0,false,10000,0
8caa6b3cd9e2a75e8dbf872ad4205def5860293766dc572607b5743b0ffa8dce,990339,2020-09-30 15:21:47 UTC,916013551187,916013544487,false,6700,0
bffe6a80ab8e5de89c6240d7998d2bc4bbcc67c954d12694ffd35c145892d60c,990339,2020-09-30 15:21:47 UTC,15455065,15449991,false,5074,990327
a714c47785dde8ddded23f34c58b51b68484bb9fabaf5de6c5316a9021a13932,990338,2020-09-30 15:20:44 UTC,94374839920,94374837570,false,2350,0
7af518b0749ae12186eb2b399244750a1066b75e4b245eef2cc185dbb6402301,990338,2020-09-30 15:20:44 UTC,399436740,399434820,false,1920,0
e1f05269c678a8770c0d0afdd12403a506c456d746438924fed6f1d08a52dd45,990338,2020-09-30 15:20:44 UTC,1432872838,1432793642,false,79196,990327
e1eb34df27b427e500af4881afe7b1075738234623b24816497da5e9db915f50,990338,2020-09-30 15:20:44 UTC,97280173,97277213,false,2960,0
b23839bb8854da3a53274ea007922a73392bed8cee5d3b77720a172f90492183,990338,2020-09-30 15:20:44 UTC,2113322055,2113321984,false,71,0
0dea560c25e34b5e61a8caacfad90387796c96a556dda24b331b9cd7e17710ab,990338,2020-09-30 15:20:44 UTC,12094291016,12094191016,false,100000,0
b81fb89516c3f92e8999a1fd65b071e8edc304f869840356bdd888d5374570b2,990338,2020-09-30 15:20:44 UTC,10000,0,false,10000,0
cefa598963c2262f7b6600959fef5fa78d7a2e0fd2d9fc153969f1657a2f9206,990338,2020-09-30 15:20:44 UTC,457258320,457256060,false,2260,0
859f91d659e041771ee7068aea9fd4e2188d625c835b1dcd1cc0591a79146fb8,990338,2020-09-30 15:20:44 UTC,147027182,147010332,false,16850,0
5b5994c5a2cf5397bc12eb84457d0002c0f471f91e99094cebc61eabb12a99d7,990338,2020-09-30 15:20:44 UTC,493681556,493641916,false,39640,990327
7f413ec8efce28aaa94bee52dd418b9bf7ce659b0494666c5e8cdbc4dfeb45bd,990338,2020-09-30 15:20:44 UTC,20340893771,20340883771,false,10000,0
220f401df277ef1046abb83d083988df6b950a8f091c70dc11c382f741024902,990337,2020-09-30 15:18:54 UTC,2480345550,2480341857,false,3693,990325
5127af4d9bfb63865fe6e9dfd3fe9101fc4ec97e6fb6bb472c3fa50ca864f61a,990337,2020-09-30 15:18:54 UTC,10480990000,10480987698,false,2302,990325
3ac82eabddfb151f704aa7e64adf3158eba554c9cbc8c19c084a1819174d57ed,990337,2020-09-30 15:18:54 UTC,10000,0,false,10000,0
3a13ad72c8bb48ef0cbb807bb1443ccf68054719a0faab9ca6dd619a5621c3bf,990337,2020-09-30 15:18:54 UTC,178825255,178821562,false,3693,990325
302c0e0810a32f6c2d0b64feeb53b67a1a05586bf1fa5cb854cb61f61970e00e,990337,2020-09-30 15:18:54 UTC,480341857,480339555,false,2302,990325
bfbee811fdd7408549be42d0bd1aa750cf0462da6099b6a34681626d9daf56e4,990336,2020-09-30 15:18:22 UTC,379918750,379916457,false,2293,990325
68aec97fa595e821a91d23fbe1a796a94825b9bda4ea4d805610348dc4ea39ae,990336,2020-09-30 15:18:22 UTC,20340903771,20340893771,false,10000,0
ebd534ad2cf3d17ac746b377727674b3595d47b74d0c7192de4df4bd977aa1a7,990336,2020-09-30 15:18:22 UTC,2379938500,2379931500,false,7000,0
a2973c661915c7d5a7220229e73968066848f50a1b8f234e06d1ac0c4c9d7420,990336,2020-09-30 15:18:22 UTC,49798490784,49798485700,false,5084,990325
64089521f78ca653099ae0e0b718b4bd711977d8fbd775e1cc11a6d43b83cace,990334,2020-09-30 15:16:48 UTC,10000,0,false,10000,0
06c6195aa0bb2d91f7cdf17a067150018ac02f3631e9e2331b1fe54cb349d979,990334,2020-09-30 15:16:48 UTC,36927243,36917845,false,9398,0
9482c60237519b3aa98b6f94325be00d4834eb00d42f9ce5f4c88202ee058d02,990334,2020-09-30 15:16:48 UTC,151582019,151557557,false,24462,990322
91164a18a62c81abedf39f9470771d452a18a683c964e1e7e00000050ce15bfc,990333,2020-09-30 15:16:31 UTC,36999100,36989702,false,9398,0
fe38569e4ff15eda0735f1e17217433ba83e06a079e30b6fe9dae6717298ddb7,990333,2020-09-30 15:16:31 UTC,29974397,29943365,false,31032,0
f1a380b97ffc495ba402185be4ff85772fd4697beca807c7a0362d04d5e75644,990333,2020-09-30 15:16:31 UTC,36969463,36960065,false,9398,0
4921dcc530d3f71ce2f9106fe67577ae37de815b53de8b589af5c7921d1c2aea,990333,2020-09-30 15:16:31 UTC,84076,74076,false,10000,0
2d68b4c1d9458c1b60537c9f4edc9dc5d336b3f41ee8e8da8301d074c399ce9c,990333,2020-09-30 15:16:31 UTC,499997074,499987074,false,10000,0
d3f187a19a13b9ef30b1113eea4df2e3ea77c051e89106b1d4539454bdce02ad,990333,2020-09-30 15:16:31 UTC,47802,41802,false,6000,0
2feca70d53869c69fdd7ed47be67cc5ce97996ea97ba619aa23e32eab5e6e27c,990332,2020-09-30 15:15:15 UTC,6577540000,6577537707,false,2293,990321
760e59ed5df6f840b115984b923b41e49670d348669733d60968f754bd2e7d2a,990332,2020-09-30 15:15:15 UTC,2379948500,2379938500,false,10000,0
51a6a72199cb817e5879ea41225f48f297c469cd69343b797973ea726d5cede7,990332,2020-09-30 15:15:15 UTC,10000,0,false,10000,0
c72864178c1abab8ae93f3e10bea8877422bdfe463fa7c6d2f2e377f0c2fd21f,990332,2020-09-30 15:15:15 UTC,10000,0,false,10000,0
42b71111a47f77ff2d272c15b52e49fd2044a1a35466194a4a2419a9681b1fab,990332,2020-09-30 15:15:15 UTC,88906420604,88906418311,false,2293,990321
efab80b7789a83314a6d8c2102c1c9b421a2173c1408848c696d0e7fb7367001,990332,2020-09-30 15:15:15 UTC,49921319131,49921309131,false,10000,0
8ca1e68a1ce2ede765b669c954d7b570cc5bdc80d584f82372a7231491827b24,990332,2020-09-30 15:15:15 UTC,10000,0,false,10000,0
b947b2b50cca1b7b80bd3a6085330ac24130abc0e0f514f82d4fc62bad466ec6,990332,2020-09-30 15:15:15 UTC,500007074,499997074,false,10000,0
71ed19ca4823cd105e587c74cc4c8d271eec722e54e5f79c3ab859104938ca02,990332,2020-09-30 15:15:15 UTC,176414064,176411104,false,2960,0
0e27c8e6525a469e4541d1bc550622007aac1322c38e9d15aeb0da48ccd59d46,990332,2020-09-30 15:15:15 UTC,177036661,177000000,false,36661,990321
e6bd26dbdddd415328589d38bfbe0ee6932a97a145d8929484f6afdbcfd4ecd3,990332,2020-09-30 15:15:15 UTC,21225415963,21225405963,false,10000,0
a96313d135f31fd4470b478d81455d38b4dc4a4d7cc95b4da91a282e071d7c7c,990332,2020-09-30 15:15:15 UTC,40194727,40160725,false,34002,0
0099028c78ea5a6a056738dcddc09c52e555442da536f0faa29c239b15b9d699,990331,2020-09-30 15:10:35 UTC,1434511934,1434435576,false,76358,990320
ce537caeff7f7d5f1c98e60f2f067fe4ba9f3aa60e2a22f80f30a648d6872f65,990331,2020-09-30 15:10:35 UTC,99813567,99812421,false,1146,0
7d747c2144ad125fd5c8b43b71b941f4f614f9c3007f621927a49c06925d129e,990331,2020-09-30 15:10:35 UTC,494542508,494503479,false,39029,990225
1de09c6834cf3682c555200a81a1f4e8f0a9bd0b5bb46fca8831ce2cdf0717c7,990331,2020-09-30 15:10:35 UTC,134905099,134901526,false,3573,0
f19841dc0514e9a00f71cc109984abe4cbd816c6075887dd4b322a735bf1a0a1,990330,2020-09-30 15:09:37 UTC,10000,0,false,10000,0
396975028e887494d829c82a8f7e5eee521180f422924e924a54dab8d016d3ba,990330,2020-09-30 15:09:37 UTC,1500286422,1500276422,false,10000,0
938efb860a60f9d3d78038d177f85678238ffab88eb5a0af357b66543821aa8a,990330,2020-09-30 15:09:37 UTC,130000000,129997698,false,2302,990319
531195b6fdba8cffdfe0380131d9ab1b447f607e834d7876c900157d6c29b586,990329,2020-09-30 15:08:09 UTC,5616455341,5616450267,false,5074,990317
6621229948bfc00e63f2d87c0f9c6d7f16c74efbd98b46aaf1226fca0a17286a,990329,2020-09-30 15:08:09 UTC,102439507900,102439505608,false,2292,990318
6bfab091c28ed5c882acc88492488b93bb44f60e98d779f33b8469763de26749,990329,2020-09-30 15:08:09 UTC,10000,0,false,10000,0
b56aeca70545b60a7da912f17adad4d09f57df7930a09d6ff9bacfaf457e2d1e,990329,2020-09-30 15:08:09 UTC,37062467,37053070,false,9397,0
3120e7d95fa11bd16b1b2354c55ffb7b97142bb8f8a9de583e11c3a897a6d4c3,990329,2020-09-30 15:08:09 UTC,10000,0,false,10000,0
3bad60db39efcbcbd90536be62e8d65199e451bce100ad14c1dc5a24b5d9ad03,990329,2020-09-30 15:08:09 UTC,500196823,500186823,false,10000,0
2c12e08712b7970436b5a2d36309a5ded574450121f930925a7316ba1f8521df,990329,2020-09-30 15:08:09 UTC,281722584,281647400,false,75184,0
caff3fc314a8b87bfba9a8f0c0f46bbfa324504bd9a680701b5d1d8eec4149a7,990328,2020-09-30 15:06:28 UTC,1397557376,1397437496,false,119880,990326
bbd90aa0de8d16b2e0f1be1a7afeb0f90ab05dcccb43181f31c7baba333582e8,990328,2020-09-30 15:06:28 UTC,1609282919,1609252919,false,30000,0
ae3dec23ab897c5ff38bba077e28aeebbf5e3a3fd3128cf8ad919f2642f01bdd,990327,2020-09-30 15:05:41 UTC,500206823,500196823,false,10000,0
6721428be0eb60d887df538aeabe153f5c72d8981746b5e5c9accd0c09c04fe5,990327,2020-09-30 15:05:41 UTC,12134391016,12134291016,false,100000,0
75924c7c7b3e31bfeacc2b014e6c69d2d9adf0ed857eea01371058a5d9fd8b3c,990327,2020-09-30 15:05:41 UTC,10000,0,false,10000,0
76966953736f96ab39b33380741e6949421bd9f2abffd38dc243e42236332514,990327,2020-09-30 15:05:41 UTC,1000409211,1000403211,false,6000,0
db18822df0f64478d1e2b92d9759ba3c09adfde6378815d5aa64a99bfa0a6fb9,990327,2020-09-30 15:05:41 UTC,555963361,555961441,false,1920,0
c773da83738192574661bafb4d81276d0358629fe58c3f8acd94b86f31750d08,990327,2020-09-30 15:05:41 UTC,1199980000,1199970000,false,10000,0
4ad7cd6aa28bc234f3d7d7e1ea6eac23893165a0c1759312e0e0426d4cb27d2d,990327,2020-09-30 15:05:41 UTC,172067019563,172066819563,false,200000,0
4b69dbeda8ab1525a60bf000a5a493141f4630b890f47bec30c499b8ae959a2d,990327,2020-09-30 15:05:41 UTC,1946838154,1946835894,false,2260,0
748e6118af78d471d816ce790211663a854920007ecf23adc95e98d9df8180c6,990326,2020-09-30 15:04:12 UTC,97706881,97703002,false,3879,0
12fa204800a135ad3ddb14c632a4315a1bb4af439b894905f816cba811825890,990325,2020-09-30 15:03:52 UTC,486413620,486403620,false,10000,0
f8aa62fe76a8dd187bfbcf98e26859a6d601bd19fe02d92cd79b05999a97b687,990325,2020-09-30 15:03:52 UTC,37104731,37095334,false,9397,0
d94b1a87ed314e0f89bbde38c29c9385cc1e30fe93a7f762b21616e393eb6e9a,990325,2020-09-30 15:03:52 UTC,599957710,599954260,false,3450,0
b1b7f37b4ca5646a3eb87874ac3ab001a016ebeabc9f6c8c1da6499e5a8c6ba6,990325,2020-09-30 15:03:52 UTC,10000,0,false,10000,0
164ab1006f5ded558f72f62275f087c41fe4c7ba3c61483ca7f4c0e4319c39fc,990324,2020-09-30 15:03:21 UTC,144784187,144780927,false,3260,990313
ef13050483ca9607e2b975d3a96953c511dbcc25fd1f53e9e90cc2bb46f8b22d,990324,2020-09-30 15:03:21 UTC,104932746,104926746,false,6000,0
12f6769c02de0a364ec6520359a7894a44472b570543bd4fcb8cd9f156bc08af,990324,2020-09-30 15:03:21 UTC,105856035543,105856033241,false,2302,990313
9ddf04c7c8745046e4f6a7688ee8d57df3368382a25e6d0604c65ac0b40d56f3,990323,2020-09-30 15:02:02 UTC,410940285,410937664,false,2621,990312
503e68537fa8420b938ea95a7be6c6d56ab875378c3fbc5c5fa9d23a6a94e6f2,990323,2020-09-30 15:02:02 UTC,6500908178,6500903640,false,4538,990312
a352c93ecfadec81c9fd7e8399aacbeb8c1f83dcd9df8a3b28a8cb032566e39d,990323,2020-09-30 15:02:02 UTC,25669279295,25669274212,false,5083,990312
d5e1da11ef39a2caf70fd6207da137557ed67ba7fe37e516e1c7c41e0a389919,990323,2020-09-30 15:02:02 UTC,499990000,499980000,false,10000,0
eb395abc69ba2b44f0cd575d1e4a2b8afca9748b70ddb2455d4c85e8e20020e8,990323,2020-09-30 15:02:02 UTC,130905,100905,false,30000,0
a4d01aff991e2213ac4271f9668c149e684a3bd49ea7a207ad0d394174018471,990323,2020-09-30 15:02:02 UTC,104014581099,104014578749,false,2350,0
43b2debde2de0be56c3e4f1111c976ead658bbaad18b0f6e87da736165bf78da,990323,2020-09-30 15:02:02 UTC,105940804226,105940801943,false,2283,990312
7d5111a12186653725d17cf5340614e9c79c741e00737966e84b0c46a4709de7,990323,2020-09-30 15:02:02 UTC,10000,0,false,10000,0
25aa1b2f92cfa05929f9ce56b3ddc6b07ebe48ee236ce739ab82dc838e528ac2,990323,2020-09-30 15:02:02 UTC,10000,0,false,10000,0
9a33d1766345e0ef59f3e64328001ae82edd49318e73d16f3210bf47871714f2,990323,2020-09-30 15:02:02 UTC,1436130114,1436050964,false,79150,990312
8bebfdc38c156076d7cc2ec83858fd5a5b1831df7a69f0fa3f5fd3abba32f256,990323,2020-09-30 15:02:02 UTC,2500000000,2499997726,false,2274,990312
423dfe3c66f7c65cc788f105dc4547dd3d04f080ee9114c4ecc4fd8f11c17a94,990323,2020-09-30 15:02:02 UTC,10000,0,false,10000,0
5990a54b3af9186fd4420ee26f0053909a73f3c2e69340846e238928aa45bd58,990323,2020-09-30 15:02:02 UTC,37155590,37146193,false,9397,0
42bf736b38bf377e606eebe3d2aaf8f7100a03a7da3f562145875478d6d7ccab,990323,2020-09-30 15:02:02 UTC,11115154,11112212,false,2942,990312
63e340fee5533fd454db2cbe3aef00b52ef7a1a761f2901680dd0e398b1d5572,990323,2020-09-30 15:02:02 UTC,141646248,141611216,false,35032,0
92d496b8a8baae2ccf07ab9033aa3056ad54c730a5d037ebd9b80ad5b2099a0e,990323,2020-09-30 15:02:02 UTC,15342,13314,false,2028,0
bcdfc89f161e1f4cf1b03c42c076e20f6ef749c8e06888d95f00167378f6836b,990323,2020-09-30 15:02:02 UTC,495373171,495338337,false,34834,990312
29ff58f6c6befeac961a7b0f52a64010440c2c45c74562f55fd7283b8147d63a,990322,2020-09-30 14:58:21 UTC,10000,0,false,10000,0
3a4bd5f7dba99396789c88f012b76892262149bbb94f84b5c1ad453b089b2790,990322,2020-09-30 14:58:21 UTC,341328,315486,false,25842,0
4acbcec5f11c15744f0c2658812577eebdaf54f41e4241ab4a9329bdd761015c,990322,2020-09-30 14:58:21 UTC,176699414,176696454,false,2960,0
7008f09e6dd0153a51ef1c8b088a8561057c4b5d1a47d7b1c7a5728228e7517f,990321,2020-09-30 14:58:08 UTC,37334085,37324688,false,9397,0
4a94d61f69d1ace1b3b5c07d1f477922c181cb89f84f402c1bd7c01012649ee1,990321,2020-09-30 14:58:08 UTC,6351061,6349000,false,2061,0
2f8d7fe1563ff352b8f2ba3d7ceacc1f459fed33246a673c0092b012bfcd87bf,990320,2020-09-30 14:57:16 UTC,500000000,499990000,false,10000,0
5c0847f50e1fb096706f6c2fc3456c2806538fa0c9209a0e9d7ca8ccd3062c43,990320,2020-09-30 14:57:16 UTC,28968790000,28968787698,false,2302,990309
3fa5308a85cb4a6b3799862dc36107845d8aa7dccc4f924929f9e479eb0f711b,990320,2020-09-30 14:57:16 UTC,10000,0,false,10000,0
956deeff415cbd4a8ae7f02150d800b680526547e43985a0f9f38cc9ad9b49ff,990320,2020-09-30 14:57:16 UTC,20225259140,20225249140,false,10000,0
06121fcbf78f379670e0f7cdb419d151c39fa3e455f92ae957ab3f1a73de6629,990320,2020-09-30 14:57:16 UTC,212610068,212600068,false,10000,0
ab7f0ab324a42580d8d733271e53beb5fd8f2263a0a2132fdcd941c7e0416a21,990319,2020-09-30 14:54:26 UTC,135150290,135147330,false,2960,0
15272eb61a7e776a2cddd5ed3aef3fa9dae20dcb7f1e8f064a7ab6f3c43ab584,990319,2020-09-30 14:54:26 UTC,120342383,120324183,false,18200,0
6da81509eb336b6ebe35021952b29c6bcd25dd6a3a8a9fc1513d592b7df7cdd5,990319,2020-09-30 14:54:26 UTC,1977931614,1977925164,false,6450,0
3369025fd4805d5432714e7c580ae66003ef12209122a427705142d28d314372,990319,2020-09-30 14:54:26 UTC,10000,0,false,10000,0
3c5275e9a0b0480ed47d7ee7b50dbae0ca563fa4a2b785e74c46010f562b9fda,990319,2020-09-30 14:54:26 UTC,10000,0,false,10000,0
bbdba3e636923d652c84c2bd5a4ae48c00e842c89bd9096e82fe66bd36cb4505,990319,2020-09-30 14:54:26 UTC,102883399,102878179,false,5220,0
f5f092afa1af9bc12956647bec164eba3fae490e61cc0469f2ae71dd7a4d7807,990319,2020-09-30 14:54:26 UTC,2000000000,1999988320,false,11680,990308
599d406a56eb3d703f1713aab1287160747357c7bdfe23951f70fe6a6cf28e6e,990319,2020-09-30 14:54:26 UTC,689980000,689977710,false,2290,0
e6e8268bcdea6117b5462560cf4c7e042fbeec8354ae3b9fa253b08af1d707be,990319,2020-09-30 14:54:26 UTC,20275285588,20275275588,false,10000,0
e546085557d9c39d316f3cce2563ba07e6bdc33e09c3b2ea498d1baa2d03061b,990318,2020-09-30 14:52:20 UTC,190833969,190827269,false,6700,0
be1c8881809465fe9faade26eb0b7cb6ef31990224fa9b1d2751649934f8d589,990317,2020-09-30 14:51:43 UTC,77411786,77410786,false,1000,0
e8765d650ccfcd64ad8dcc1eddca7f03588b0b61bf8e411ac637ea3eaa4c8217,990316,2020-09-30 14:51:29 UTC,139416452,139400318,false,16134,990275
e1efd175b948fc7be7c1c621e3d1552af4035a23a22572d1f66464999b490fc6,990316,2020-09-30 14:51:29 UTC,3049628501,3049583321,false,45180,0
0a3f0fcc85fb60e0b6806580734349c6d11d13421ffe83e99e184b7f93deb385,990316,2020-09-30 14:51:29 UTC,176879433,176876166,false,3267,0
686c106c406f03c82a9a71d914d3fb383aad701e5e982d9d1bf8f06bb51ff285,990316,2020-09-30 14:51:29 UTC,10000,0,false,10000,0
902bc3dda31e350529fd937422288cd036848138360a2978df2bdcb0060941a9,990316,2020-09-30 14:51:29 UTC,107965532619,107965532537,false,82,0
c42b9fb6634c90f8001f9ea496d9ffe13d09dc3442bb6f22dc3c69df00a407a6,990316,2020-09-30 14:51:29 UTC,495955751,495929506,false,26245,990227
2112caaeb16ba3b23827a18f9a998537b8727445fa058fdfe713dcdf22f4daa3,990316,2020-09-30 14:51:29 UTC,1437729852,1437653840,false,76012,990305
17787d98deeafb3738e2caf3b0c85c337e6c888b42fff62d40482496d3323c96,990316,2020-09-30 14:51:29 UTC,10000,0,false,10000,0
506c4d96669f2ca79d20927a526b319f85fe70459938ab715100ce4f3ba56bf2,990316,2020-09-30 14:51:29 UTC,20275295588,20275285588,false,10000,0
d14aa9d1e457ba5e61cd86a9a097087ee225df2b19a885d68363ad9b98da7e3c,990316,2020-09-30 14:51:29 UTC,433445278,433442976,false,2302,990305
860868f3e004bf6c5d7e69f677b0fc583688dc457821f56e42866c0ca9d85e99,990316,2020-09-30 14:51:29 UTC,100000000,99997740,false,2260,0
e508a0912bbd4b83799fe1f541a7b7a5b79dc12a05cbe5e559510f822f2927cf,990316,2020-09-30 14:51:29 UTC,106125518747,106125516126,false,2621,990304
7206915229e56ae7ae19d3472fa0598aff1e6b89fbf390a5b62210331e58df19,990316,2020-09-30 14:51:29 UTC,171229314,171079314,false,150000,0
e37206e835cdc3758c99bffac591a4bbb77967a67dd9eaf63412d9b03e9828fe,990316,2020-09-30 14:51:29 UTC,2000010000,2000000000,false,10000,0
96b75f846cd9ef2b5f1ff24b62f2db28df52c650c12627be8c45e4fbf4086952,990316,2020-09-30 14:51:29 UTC,3000000000,2999997464,false,2536,0
d79456b4e968dfc0a0a724d791b6d36a93602255ba659811f3f73a2f2822411c,990316,2020-09-30 14:51:29 UTC,97875676,97872716,false,2960,0
1c535905fa95286981010201ce83874e89c4d086051e531ca16d1eeb7139b350,990316,2020-09-30 14:51:29 UTC,10000,0,false,10000,0
707da814542456b97df10c630120bf7111cdae4e41aa82a7256b1375c7dfec57,990316,2020-09-30 14:51:29 UTC,10000,0,false,10000,0
237709fa34756fa1627d0283553536ad4a84d3f19ea22734d798939006117312,990316,2020-09-30 14:51:29 UTC,2000010000,2000000000,false,10000,0
f98114de25ec0c233d25f3a7f2d14733e354fcf69b02e7bfe4c2dad03b9cdd1a,990316,2020-09-30 14:51:29 UTC,50374350,50341680,false,32670,0
3a197ee4b2e80fae225ef7f25ae7aed78fc5e5e4710cced435326993623e110f,990316,2020-09-30 14:51:29 UTC,281750660,281675484,false,75176,0
c86f8c205e9ef5d36859c6f50f49662539d8d638b42c90c61d41df88fb8004ef,990315,2020-09-30 14:46:00 UTC,135297733,135294773,false,2960,0
62f56cdf2bf8c1921976998ae245cbae24e64b8b937a9d00a886cdd9d7a8e672,990315,2020-09-30 14:46:00 UTC,849830203919,849830201307,false,2612,990304
d99d728f22fd8a5e95ddff9f272143ed4c3dc775a038860aac62e89484ee4c05,990315,2020-09-30 14:46:00 UTC,20636015465,20636003090,false,12375,0
51e6948393f56cafff53f9737c0e6fc6e1d78dde9e9a4a56d60005fe3333191a,990315,2020-09-30 14:46:00 UTC,21026877467,21026867467,false,10000,0
6547932f54672a5e00ef96e77718f66ee7c092b1ce6023166b42ea27f2d6ce3e,990315,2020-09-30 14:46:00 UTC,30888,20888,false,10000,0
baa171569c13aba0047590857bfba2fa633bb57ee2d4a5ff4fcd7d425fd3144f,990315,2020-09-30 14:46:00 UTC,10000,0,false,10000,0
7a04807326c2aa250e897c12fb411a4178df11d5b384a969be8f9860541241b5,990314,2020-09-30 14:42:13 UTC,17858639735,17858624155,false,15580,0
be11937b0a2fee6188ac9e682048fdab37a4d8f41eaefe6468f177e0f8a8ea44,990314,2020-09-30 14:42:13 UTC,999689290786,999689288165,false,2621,990303
20f60b82e5ddda6bef18876be0c8ec1c6766d537b3467d47d960bf933a8b28f0,990312,2020-09-30 14:40:47 UTC,10000,0,false,10000,0
9c98ac14ef0e3e90becd423399bf4c4c4d87450f1420770905ea087e9859d03c,990312,2020-09-30 14:40:47 UTC,48980344,48908524,false,71820,0
b378874293375f2f48796310a508328acfb2f3b474674ac80af864c70d39578b,990311,2020-09-30 14:40:35 UTC,129453861,129450901,false,2960,0
83aedadb90468293d6db66fae4a0ecb715c67351b46cacf30c971c955e7664a6,990311,2020-09-30 14:40:35 UTC,496704883,496674230,false,30653,990300
4b2715a2844ad6a48201dff15c84f270e9d3cbe02cbb652d53ab4ca692c87356,990311,2020-09-30 14:40:35 UTC,1439269272,1439187575,false,81697,990281
dc0932582241e8bde856c17eb18577db16b88ca396d35bbcb850b65f06de4eca,990310,2020-09-30 14:39:01 UTC,2210190116,2210183336,false,6780,0
738c7e6c76fdb8e67dbb7ce1ccddff065a162e8cf546d94d97c708e132e8aaaa,990310,2020-09-30 14:39:01 UTC,10000,0,false,10000,0
e656c6ea7e0e84cb51a2ab948e7d5b396b2f0c376d6787b28f614875235ce93a,990310,2020-09-30 14:39:01 UTC,10000,0,false,10000,0
cf282ab63dee9d2ac2b937c281072f921d86b90aa0d4d1ff2eadae9038f55b5f,990310,2020-09-30 14:39:01 UTC,130010000,130000000,false,10000,0
f1885ce0d34bb7729976042a495f1b7a1e0317b4e08b4c35fdb7378febc76119,990310,2020-09-30 14:39:01 UTC,500015717,500005717,false,10000,0
76a982fbdf3a00d1805204f9dac7cbaa9234f71f8086b63a7f358ff28237d7f8,990310,2020-09-30 14:39:01 UTC,10000,0,false,10000,0
1857c64dd7c3281ce14802fe778bbcae28047bd0e0aa248728021b62265e271a,990310,2020-09-30 14:39:01 UTC,114425021039,114425018747,false,2292,990233
fc397c74bf640e2b52c8115a4fcfff860a5877096234572b70d906522f1a434d,990310,2020-09-30 14:39:01 UTC,177578547,177575587,false,2960,0
63473f7075ef8973d7407d78650167baa916efa14b51227d83d728a89ef38eb4,990310,2020-09-30 14:39:01 UTC,101287551,101281086,false,6465,990299
d17cfb00cbf9da99c5d0ee0e776e00fa33462b0067428dfd34afa4673df9edfc,990310,2020-09-30 14:39:01 UTC,76060213599,76060211249,false,2350,0
be1f4e655ab1d69337e42e4a37189ac569ddc1be6e07004f4e7d9ad1a6f4dfd8,990310,2020-09-30 14:39:01 UTC,500013740,500011438,false,2302,990299
3c0f82560f5c4e3c10e0156690ee41061a15770ceb9a60588ac364260c756cad,990310,2020-09-30 14:39:01 UTC,15882280596,15882080596,false,200000,0
8c32e8422dd3faf1b0aaa2cac4a0b019f46d52f00d844fc17ea9f3b00685dd67,990309,2020-09-30 14:34:44 UTC,142335325,142260149,false,75176,0
36051ab05dd4a80d095e56da1e18c14425489025c18604f08206864fbf5db607,990309,2020-09-30 14:34:44 UTC,135496449,135493489,false,2960,0
0e848afe2793627c5a0541426baa07723c59807b685d5545f4129d0220484cd7,990309,2020-09-30 14:34:44 UTC,10000,0,false,10000,0
b13b509254a66c1f1cbb32743a280db97bb16569525e42ab5bbe35fbddec899c,990308,2020-09-30 14:31:52 UTC,300454336,300452416,false,1920,0
a33d641181ad94aedae24a675f288d399c4cfc700dab62ba1421bee9d4913812,990308,2020-09-30 14:31:52 UTC,10000,0,false,10000,0
34c9771501196bebda4bf5197b6b5c3a1f7b516d78326de73d528ea91f9918d0,990308,2020-09-30 14:31:52 UTC,129609047,129606087,false,2960,0
769923c9defab0b8955deb6d5f0724cf53c8396730dd4ed251c57ac64878e2b1,990308,2020-09-30 14:31:52 UTC,114664795929,114664793308,false,2621,990297
4e7ef3e5af82d613d5df0915e5839f4d0df43c046c3f0ff9827254ea9189d5ba,990308,2020-09-30 14:31:52 UTC,74993223,74960484,false,32739,990296
6206f9909dfeb1610420d1e80c099bb4e6c0429eee6ed411f21a800ad6316c05,990307,2020-09-30 14:30:43 UTC,497861495,497831162,false,30333,990295
b5fcfc6aa5c8865bef721157b81130cb94c9d2da75ed9a7a67e31cd27bcd04f8,990307,2020-09-30 14:30:43 UTC,2291254084,2291251824,false,2260,0
3aa5542a30fc41c32f54eebfa9f37f25d5e9a120fdec818e673b84010d5ede3e,990307,2020-09-30 14:30:43 UTC,1441047346,1440967500,false,79846,990295
c3e5559e95805b54c32ce1fbfdcd9b90cd5d2aaccee60e3aee9609f055e224d3,990307,2020-09-30 14:30:43 UTC,75892625,75890175,false,2450,0
cf4703bac09edc5376b0ad6a8986234209ccf270fc1017886fb74fbe57a41178,990305,2020-09-30 14:29:31 UTC,10000,0,false,10000,0
6e005c29dc19c872d7f566dc692c300ffc2547e474ea1a2d927644c5479f0b9f,990305,2020-09-30 14:29:31 UTC,115183851402,115183849100,false,2302,990294
0a5466e8e9ca186faf81ee25ac1224e68ff6580a6de61fc2b054f611c3ea2e08,990305,2020-09-30 14:29:31 UTC,500000000,499990000,false,10000,0
323c01bf19ac0752003537df0bb8ba3cc3cce94946b857c14e4b3644e1c52291,990305,2020-09-30 14:29:31 UTC,10000,0,false,10000,0
5ed6c4ff1b13f573eda4a041526b4cb39db7c8be21543d8ac734fc74f74ede25,990305,2020-09-30 14:29:31 UTC,500023740,500013740,false,10000,0
9a974448e2ec6bbf08befe2018b7d2f879b7faa67db85c5527069bfe486d6d73,990305,2020-09-30 14:29:31 UTC,4692302,4587962,false,104340,0
0a154f7610b29d006990865fa9a0647c29cc91e4a626675dfb30d0a0d7da4d1a,990305,2020-09-30 14:29:31 UTC,10000,0,false,10000,0
250d788c962f6cfaf5e59a2e212c50d4442e850cc45a9f87a47654484a1723bd,990304,2020-09-30 14:26:19 UTC,177722036,177719076,false,2960,0
3afca418e675b79c7ada0f8370171fbcc7c83689a05ea794fa9f9f2d99b56807,990304,2020-09-30 14:26:19 UTC,10000,0,false,10000,0
8df4a4c9e7d4affa0a21234c54ea427b7d8e1fc5e6f876271a815674aab8fc9c,990302,2020-09-30 14:25:05 UTC,500010000,500000000,false,10000,0
e871757ee8a60fa2786379a92102ef4d20585e2a591a45e04dba627a5eab186a,990302,2020-09-30 14:25:05 UTC,10000,0,false,10000,0
f11efe32b6175d49cf464ed04f36e5c5eef35f7872b16d2294281f11e2e7e872,990302,2020-09-30 14:25:05 UTC,95640081,95639081,false,1000,0
eb4ab7a5e30c6a4dc34650a541ce95e4ded3087af3e8706a21f0c4f6cf464dcc,990302,2020-09-30 14:25:05 UTC,12504668542,12504568542,false,100000,0
42a6e0417d9312564b4c17922ecf98451bc1bc72c68bdd76f85253d05e3a9302,990301,2020-09-30 14:24:14 UTC,135747969,135744702,false,3267,0
c075433a2944680b2eb6534c51b231ea531798964c34d794c354713721743a28,990300,2020-09-30 14:22:51 UTC,10000,0,false,10000,0
dfcbb171889f9b423e55b6022119cecae3eaf894ec938e43a77e85d0044ad793,990300,2020-09-30 14:22:51 UTC,999976251,999961461,false,14790,990289
737ed225532d32811f4bbfa5dbe0426f3241a1b9cc0a086b4cade235e90ce135,990298,2020-09-30 14:21:46 UTC,76906010,76892648,false,13362,990286
3bb908efc67b68c658970c58d6bffcdbd71c42383a95f8cc1352227162291d9e,990298,2020-09-30 14:21:46 UTC,999813193088,999813190786,false,2302,990286
9ddb0ffb5c9c111303858a2b8e039f19730b7b8f750cb1ee4afa252fea91d1d8,990297,2020-09-30 14:21:08 UTC,46734908,46732988,false,1920,0
5ffe64bf75453c1e35624584715771590e90542d09f37979255e64999f16d0be,990297,2020-09-30 14:21:08 UTC,498746892,498717752,false,29140,990286
ed51bd34013f182728caec41ab08332457859e133333262d8f73c9fcc16521ed,990297,2020-09-30 14:21:08 UTC,20526897467,20526887467,false,10000,0
35b8a5648d5b3841b5d5e21d0045ce90b0dc5e2caf79078d983f6238c5a15138,990297,2020-09-30 14:21:08 UTC,115283353704,115283351402,false,2302,990285
ce754f82c405a779760057d53b9f9f34ca20c27cf44686f36dac4857928f9f89,990297,2020-09-30 14:21:08 UTC,97994336,97990596,false,3740,0
6427dd3e65f30362f46ee8d0f047d92a4a83a1b68af426a2dacc9ba7de7b997f,990297,2020-09-30 14:21:08 UTC,129932194,129929234,false,2960,0
b318fcdde2088038cb21648ff0b97a31fedef0d6ba32f4469543cf4a9ddcb173,990297,2020-09-30 14:21:08 UTC,1442765782,1442688436,false,77346,990241
1f3700792d61e8c6fd03178d03facc96990d7e2bbd0479ca3df5059f0ca2209c,990297,2020-09-30 14:21:08 UTC,10000,0,false,10000,0
a08c596153e151607adfec43ad83290f0a30a530fe51d9121a308eff7172acfa,990297,2020-09-30 14:21:08 UTC,9806552847,9806532522,false,20325,990286
a954d88427fb3b0561d88c088e50c03bc9dcf741b9260584faf02b4a7e00e1e9,990297,2020-09-30 14:21:08 UTC,999970000,999960000,false,10000,0
16ed3b47ace27e2e35119a82facd2e45de8f8ce5c0fc3d76830f666a072dde85,990296,2020-09-30 14:18:57 UTC,10000,0,false,10000,0
0358d306cbabb42bdaa7c6aca27962782243330403cfdb720fcf5294798b8946,990295,2020-09-30 14:17:52 UTC,117767856006,117767853704,false,2302,990284
d7639367d1ce7cb93958fa1f7cff6960dc435a86d495f04fed1ad6d47804e03c,990295,2020-09-30 14:17:52 UTC,831060160,830990002,false,70158,990284
f86d87eab11707d1f5aa9c7c358e6b1c1c0ae3d7b21652a17021740214507e45,990295,2020-09-30 14:17:52 UTC,76320000,76233720,false,86280,0
20ffe6c0b999a57974a15685544ea35680a6366de8ea7f5eccedc59515fed539,990295,2020-09-30 14:17:52 UTC,178208342,178205075,false,3267,0
21e0d8b92053b113c227409e0f025348d1a6d3d31877eb5214594bb0b0db1a6d,990295,2020-09-30 14:17:52 UTC,454767943,454765651,false,2292,990284
8709ed3ca4922672e91f450dea9f2b4a55ebf810285e76b9119e161571236eb6,990295,2020-09-30 14:17:52 UTC,500033740,500023740,false,10000,0
51b9cb780b1c17c2b7d23750da04a12d9f4460a0fff1eb18f1d79be9c052a8b3,990295,2020-09-30 14:17:52 UTC,20563257516,20563247516,false,10000,0
54f8adde72a80c0e8dea302c5a0494dff595daaba4d36b363afa8e5416057c42,990295,2020-09-30 14:17:52 UTC,167398080,167387462,false,10618,990284
a263b60883aa19a12ec50e09ed12eae276b3dc21c86cdcae8ddfffb8313a49ad,990295,2020-09-30 14:17:52 UTC,10000,0,false,10000,0
99f413e311a3e631461e4ff755fcbf411da385398a908b3544ec6c9f042b5d42,990295,2020-09-30 14:17:52 UTC,10000,0,false,10000,0
776ffa69fa6ae5acf98744323f8c717f7f38b9bdbc8353c1c77e45a94cb34201,990293,2020-09-30 14:15:16 UTC,1000000000000,999999997388,false,2612,990214
7a3300b1687efc074b033931cee661d69a73ee0ac7b9861c8998278156f7e6c7,990293,2020-09-30 14:15:16 UTC,10000,0,false,10000,0
e023a234c3319d563559fead5b69abc80adf306354550fa2d895e112e9896c8b,990293,2020-09-30 14:15:16 UTC,142350285,142275109,false,75176,0
143592f792c0b765af4be2252c084036feb742f3650add86f395c5bbab0a6c20,990293,2020-09-30 14:15:16 UTC,25527014,25521014,false,6000,0
6e6436bd45d7aa90ad785b8f23304af046b38e1cbe34a5152e2be5e449beb801,990293,2020-09-30 14:15:16 UTC,117916358721,117916356419,false,2302,990281
627bdb88d772dcfcd69907765b269b7a0fd84efdb4fe29594c83f55dc66455ef,990293,2020-09-30 14:15:16 UTC,74465689068,74465686718,false,2350,0
bc2d2e35f48d837e7fa146e55ab4b93ded990310489ee24eddb41adbd2efcb49,990293,2020-09-30 14:15:16 UTC,37368167,37358770,false,9397,0
bc6743964e4d0c723557058a242543048feafeb292f9eaad2e615c404c667c52,990293,2020-09-30 14:15:16 UTC,10000,0,false,10000,0
9d5f476b0be70fae30739871e21a82bcba8a2f699bfe58da12ca03eaab7a50ce,990293,2020-09-30 14:15:16 UTC,8938904,8931064,false,7840,0
7d2ea4097c39e920c3399eab62a91cfe6872fd525ec4c5f0615ad1b68d9b57ae,990293,2020-09-30 14:15:16 UTC,1200000000,1199997698,false,2302,990281
20c990c791093f3634c9df177e9f18cda684034b303de35d86947ef46b6d499d,990292,2020-09-30 14:12:54 UTC,4602252760,4602242760,false,10000,0
59ce2cb6c6f7c2a067e917655a5cd7f5bda696f967d6acc462ee91ad8d91c981,990292,2020-09-30 14:12:54 UTC,99794845,99792585,false,2260,0
dce5b8dc1fca34cdf3e144d1b7ed4fbfed1e7339972b9e42876ecba9075baeb3,990291,2020-09-30 14:11:30 UTC,1249340368,1249338448,false,1920,0
2361b7b3b05efeab477b69ef65316a5acdd56b1a84be6a6f8aebfa3a938bdf4e,990291,2020-09-30 14:11:30 UTC,105173555,105148469,false,25086,0
e17082049c206a5f0ddd6fec3136003b53b9189bf16145536202ef26a57835f0,990291,2020-09-30 14:11:30 UTC,499718612,499680842,false,37770,990280
7a88883af0942d76a89584259ee6efd0a4937b2627c0f21598f64b1bd4bb34e2,990291,2020-09-30 14:11:30 UTC,1444497096,1444418210,false,78886,990280
f290928073b3a8213cb9dd13649ef6f87eebcf5f1ac62efc3b873c3083effe81,990291,2020-09-30 14:11:30 UTC,144093088,144090828,false,2260,0
2107f23b3189eae7bcc9327f589530740f95e975af447fa70c673d2588d6ae45,990291,2020-09-30 14:11:30 UTC,126023744431,126023742129,false,2302,990280
9eeee6d5f1d3fe4d0e5bcf032ad7accff986ec34dc3bcb58307c43358cd46725,990291,2020-09-30 14:11:30 UTC,74634605134,74634602784,false,2350,0
1ba546815edee136dc692638f165f0901f7047a8b8d2150fb7067ccd3a278984,990291,2020-09-30 14:11:30 UTC,10000,0,false,10000,0
2f21ca34d6d92afac15085c9064efd67bd5a74fbddb3de863e9f4c8c7c28a701,990291,2020-09-30 14:11:30 UTC,136267954,136263463,false,4491,0
8d62fd4aca83044c7f9f2e212581b24b398f400a084ea9634b53c10e32a6199e,990290,2020-09-30 14:09:00 UTC,53480340688,53480340588,false,100,990279
48926d79111c1e4635fcd38791c9d44e8575ceb520ef22a3811b5615afbe4ed8,990290,2020-09-30 14:09:00 UTC,10000,0,false,10000,0
a4dffcf2de63530155907ddfaf2fe6709ea2e03351bbb11829a9e8761db0bc80,990290,2020-09-30 14:09:00 UTC,38089145,38079746,false,9399,0
f005a9b546cd39d57e71bbcc90e630586f9b746f8186ac6c6411a5883cd7ff67,990290,2020-09-30 14:09:00 UTC,481883867,481881565,false,2302,990279
6b850428e7d0bfa3ef8f30bcc7a3a793f474937738186c136745a0f554536d41,990290,2020-09-30 14:09:00 UTC,1000146927,1000136927,false,10000,0
f87af382b674f7f5fe3f0d5058f8bf158f78abe0ad1425967da2ea1af405e149,990290,2020-09-30 14:09:00 UTC,188394769,188392509,false,2260,0
ae44e9d46c7f0bd17a960c698c9fe2effb9c66cbb965c8e03f20b1e878266666,990290,2020-09-30 14:09:00 UTC,38198618,38189219,false,9399,0
ebf8642bc6e5eae5bfcb90ebe03d575de05cd350d7197c966731160101e6a63b,990290,2020-09-30 14:09:00 UTC,10000,0,false,10000,0
53f704801f61ebd2dc11c08b35e650ca8cae568162e9cd2e75aeda883b4b02b2,990290,2020-09-30 14:09:00 UTC,130150803,130147843,false,2960,0
a8483376f1f3e61219f90be7e64564e7611922b6a33d0a142252348c9d79d3b9,990290,2020-09-30 14:09:00 UTC,2176398939,2176386741,false,12198,0
70a3ca9ec54523f523c688d9d1179706352f9aa1a034d185dd9543eae76f5dcc,990290,2020-09-30 14:09:00 UTC,8699900000,8699899929,false,71,0
260e916d22994ad3d9212f38567ca2c6f90f43492f25ad0ebcb5cddd94935696,990289,2020-09-30 14:05:56 UTC,12541500000,12541487915,false,12085,0
e886c5f093926ac44a185976fbb8e8f5a89ff0ed12b41415d903de8c7c2c4f8f,990289,2020-09-30 14:05:56 UTC,1000031009,1000021009,false,10000,0
16f7e377263dd80e6f48da7a8eb29821828dcff40bfd193add63bdf50dc2769d,990288,2020-09-30 14:05:30 UTC,4501447940,4501444200,false,3740,0
647ab30faa1de66a56ff97c56ce7b0e9c33402f7d566f79a389daa220574cb51,990288,2020-09-30 14:05:30 UTC,500000000,499990000,false,10000,0
7dc9e8d7e10c1ec819b5d3f6994d0fa616e6d5218863f46673362d3eed8bb88a,990288,2020-09-30 14:05:30 UTC,3000320153,3000310153,false,10000,0
e98d38a6d6585bcd930b124de276ae565091dc36ecf6119d22b9cd5a28001197,990288,2020-09-30 14:05:30 UTC,250527934293,250527924293,false,10000,0
eec0814c6ee4c08701709aed91b1f4ba54158b8daaab14bfd2f6c0a1dbdeb9c6,990288,2020-09-30 14:05:30 UTC,10000,0,false,10000,0
a71961717558f897c32a3b1ba71cb60962f37eaf5c776d414628e879ce82671c,990286,2020-09-30 14:04:04 UTC,193955694,193945694,false,10000,0
aba735f2dbc27ad79da3633f8c943c8cec922d34a6a032d5c98c4404d32ea496,990286,2020-09-30 14:04:04 UTC,103196348,103195348,false,1000,0
b9ba91a84a9742ec1ba1982d5a6dca99031647d9472e4f8eafdafe4d0f7a57a0,990286,2020-09-30 14:04:04 UTC,10000,0,false,10000,0
c225ade4e3da7390411bc347c397f2f2230118f4df2f74dae9d5f018656361c8,990286,2020-09-30 14:04:04 UTC,10000,0,false,10000,0
cfe81779989ce44c1ad7b1c50f0fe288450e76f5a2d752ea789280d87d78dfd0,990285,2020-09-30 14:02:48 UTC,1450481791,1450381791,false,100000,990274
eb80cffafa3a9ad296e7a1b7928e9442132a4f087edc30ebf8c8b75118411f46,990283,2020-09-30 14:01:25 UTC,500000000,499990000,false,10000,0
74d4df17d5e82c738ee60c3ca9fb9e5eced13d53b6f3b627eafc95d14a25491c,990283,2020-09-30 14:01:25 UTC,3799316324,3799312424,false,3900,990272
0a66930ce34d118bce7c1d7e3d02ab0617579693264c4392bca6cfb3e485ba9e,990283,2020-09-30 14:01:25 UTC,1446300238,1446221625,false,78613,990212
00585d83bf1276778aeb46459102136b58387690f1c1bb9f0c62e6dde30d44c2,990283,2020-09-30 14:01:25 UTC,500640669,500606109,false,34560,990271
0882d32a762399d1d468de34fb79e57378d6661cb166348133735f04677b8371,990283,2020-09-30 14:01:25 UTC,177693073,177690461,false,2612,990272
d1f870da3994aebd703df8323a126d787d33d143564bdec235d7983cfe621f3c,990283,2020-09-30 14:01:25 UTC,581579580,581577320,false,2260,0
c10769f2c40b01acffc80febcb762a08f81be945f2bf9160c8935895411a7dc9,990283,2020-09-30 14:01:25 UTC,56260,53810,false,2450,0
f48c7b7c955aaa16ba05fca9b6cf6d65335a59b625dedae0e05a31f3da631bcf,990283,2020-09-30 14:01:25 UTC,10000,0,false,10000,0
39e8cc5ca076d95473c18b8759e14390f02e9d178abc40a0f68ac989a0f64123,990282,2020-09-30 13:59:45 UTC,50481483,50471483,false,10000,0
9a71dad39dcde454a8789aea730b4902e60eec0ab3a098c2310f3eb507fd14e1,990282,2020-09-30 13:59:45 UTC,128583247053,128583244431,false,2622,990271
8d94fb4b7a8d0ae3f3de46be356f3695f7b3191b9855bad3424dd1cb1a3767eb,990281,2020-09-30 13:59:04 UTC,10000,0,false,10000,0
2536e2567e9bd4495eb7910b48d554b1a9e99a86569af7cf936d8c148eb967bf,990280,2020-09-30 13:58:33 UTC,10000,0,false,10000,0
42bef6d7cdb7e5b11561a5c0af1f02587e786131b6410eb41406b21df0aec9af,990278,2020-09-30 13:57:34 UTC,1218377960,1218302768,false,75192,0
7e13cefe1a89545f1d03e82fe57ffeefc4f5edd25d7a750c8d17af2cefaaa7be,990278,2020-09-30 13:57:34 UTC,191639633,191637097,false,2536,0
f66f1a0ea7056275cae7ab018cf63ca44592075c24250c6e4d4c9e1cad7be488,990278,2020-09-30 13:57:34 UTC,178356410,178353450,false,2960,0
436a3577fb487725d8fc53aa0e153bbf4a1781d683ce0a93f1c8108a57f0d387,990278,2020-09-30 13:57:34 UTC,10000,0,false,10000,0
87a8288e755946995282348c6cdf0be17ea9fa24fae087b2f498d15d79b608b7,990278,2020-09-30 13:57:34 UTC,1352009630,1351999630,false,10000,0
c2c89fba04efeb62f431b3f4822f283a86902a05823dae5a44f4d6d25ff20a8f,990278,2020-09-30 13:57:34 UTC,81455129,81355129,false,100000,0
f0453a3c03ece06cac4c1eabb51dc132ddf1fe647e8264a131eb2ba135650c23,990277,2020-09-30 13:56:24 UTC,7225,3825,false,3400,0
59ceb31b69ed924a1f6a6c945caf1c736d396aa6a29f472de382793227d27a3f,990275,2020-09-30 13:55:55 UTC,11499990000,11499983220,false,6780,0
1ff713a7256ea52b9a7f758c4157fc45f0c955d9b2bc24ffacb300a309f3dc50,990275,2020-09-30 13:55:55 UTC,128794737146,128794734853,false,2293,990263
d3f056e3f09660439a5ba0d21fc363974844862e32a83925cb8f48a1238d32f9,990275,2020-09-30 13:55:55 UTC,155566081,155558241,false,7840,0
fb6891041458aa47141e844efb52bd9aad3c2c480d4ae75baebb697666bc1342,990275,2020-09-30 13:55:55 UTC,10000,0,false,10000,0
2dd514c33db8e6c54ca7713175f2e37738422fa135c475d8407c5184fe60923f,990275,2020-09-30 13:55:55 UTC,10000587,9800587,false,200000,0
6d3632fe969a103084d6cc5450e54715ac0f43d3c32762042f89a454368c97c8,990274,2020-09-30 13:55:23 UTC,20760920,20560920,false,200000,0
20f41b09a408be4fdac57a9d69ac3c8b39648e94d3c29f30ad28fa5dbdec0dbc,990274,2020-09-30 13:55:23 UTC,207034100,207032150,false,1950,0
13a35a6b23514bb1cad50055c6fb7e776f4a8e7e17193a2f5cf9953b84b926e2,990274,2020-09-30 13:55:23 UTC,10000,0,false,10000,0
c275e378a7eed3a47319e681e50512274c0e37806ac96ba1ede18fdd0133e687,990274,2020-09-30 13:55:23 UTC,191645633,191639633,false,6000,0
e0de63df7242c2062b99c25b41f93072640a843819e19c2f9853cb39b3d04348,990274,2020-09-30 13:55:23 UTC,4569699,4564625,false,5074,990263
fa2a89ac6bd483c9dd532d7c33b2e6c6a7065d18aa5976a537412c5e0cbf383b,990273,2020-09-30 13:52:54 UTC,14488,13342,false,1146,0
c2421971de538412833da0689b5f60152065112783a280b323764bf204815d44,990273,2020-09-30 13:52:54 UTC,34125068467,34125065677,false,2790,0
0f81e1c39efd55a6dc54d5f1d11ff72677358c02f8697f08581957225e4ae42b,990273,2020-09-30 13:52:54 UTC,32364,29914,false,2450,0
594505f018c073d6a552ab402a461fac5cb01a99f99b56fd512978b48f39b98b,990272,2020-09-30 13:51:46 UTC,47428541,47427541,false,1000,0
1ead526797f510cef7f6a41a1ec31ad25392ba06a64a7d1dc619c49624973b6c,990272,2020-09-30 13:51:46 UTC,2781484,2772085,false,9399,0
cd599d1aadbeb0cc27a53980db407ec26779a973b82ba9a7630a92725ac9fc77,990272,2020-09-30 13:51:46 UTC,1447946167,1447864443,false,81724,990260
b955d96ac54057b018eeaf1d0644d43a52b08c55e60511fb9a6a7d685e9020d8,990272,2020-09-30 13:51:46 UTC,501532832,501500199,false,32633,990260
8adc8ec277aba61a856c54445b8c00f1286f32ab011b95765a65e9b50ce32039,990272,2020-09-30 13:51:46 UTC,136437282,136434322,false,2960,0
94f53b6d2734e9758c679a1ca46000b9c51bc8d862992079b658452ad685b99e,990272,2020-09-30 13:51:46 UTC,1732184000,1732174000,false,10000,0
96d87d0f455ac67a3b41440a0ea5d35916d5cfc25c7ab07c8e246a1f966b45bd,990272,2020-09-30 13:51:46 UTC,10000,0,false,10000,0
63d56f926f76497ab873865e497047c775aab9af8cb17d5326d81dfb117d1735,990272,2020-09-30 13:51:46 UTC,232562696,232560436,false,2260,0
13b55301083be4cc717082ad9aa6a4d9a78b4417360adc33b4e74a35bec22532,990272,2020-09-30 13:51:46 UTC,2599135,2589736,false,9399,0
26008a22f67b49e9c3208e168557a91268852e4d925c35bfad3d36ca4fe48172,990271,2020-09-30 13:49:54 UTC,7875497849,7875488249,false,9600,0
61af06177d606ce3fda42027d958d77d695191e6f44e0cabec5fcc7da64f26dd,990270,2020-09-30 13:49:16 UTC,38329009,38319610,false,9399,0
17f592c75611707e9fd0de9d94068288da71aa938f340314b9a4ef8940fcf466,990270,2020-09-30 13:49:16 UTC,10000,0,false,10000,0
00b7b486ed6e508203187b574207cc0952394a6fbbcc26a7450e44b799c85027,990267,2020-09-30 13:48:13 UTC,8184095882,8184064082,false,31800,0
443a9bab881f06142e11704c2127b1948405e83d7d987f034b813197bc80f3ea,990267,2020-09-30 13:48:13 UTC,1408811159,1408805403,false,5756,0
4dba37c88574b1c48d74bae1d947be359593c918aa1602fa512d8a43fc5bfe5a,990267,2020-09-30 13:48:13 UTC,10000,0,false,10000,0
aadac835c5f58151539a63fc5467dea9b27e0da2e9fc5e51df843ade90ccf932,990267,2020-09-30 13:48:13 UTC,18028,8028,false,10000,0
10c3b5cf3fa069524590ad73a95a86e498b80b7606ec94b138d52238ab6cd2db,990267,2020-09-30 13:48:13 UTC,38588652,38579251,false,9401,0
babd9f5ee8ac040a1b5f7ef55a14144965013b05aaa6644c82270a36556ba914,990267,2020-09-30 13:48:13 UTC,4497585872701,4497585847289,false,25412,0
4a4284bc7dcd1d7bbf37b51e10afac0dfbae048515cd31ed7551e86abd8c8dac,990267,2020-09-30 13:48:13 UTC,7400010000,7400000000,false,10000,0
0a55b31a5d6893ab58d271734f7e4b3461e467f21c6ce294bdf04acdd3843d81,990267,2020-09-30 13:48:13 UTC,499305324,499295324,false,10000,0
a42d8f9e951cbd38d9ec7afd40c16a1ee365289fbf212aca64d625ba738bc61e,990266,2020-09-30 13:46:23 UTC,5850823395,5850723395,false,100000,0
8220be38137596a28c8553abf556ffc88932909f4b1d82d8c9c70fc2bc5749ef,990266,2020-09-30 13:46:23 UTC,131381061,131375346,false,5715,0
0c2edeb324346ac616eb51b8d785398cbf130dfe773d6f0702e00909cf8e4240,990265,2020-09-30 13:46:05 UTC,20563267516,20563257516,false,10000,0
88b272538ddba018e2bcdea2dbe1a5338de68cf8434a0a4cdc2997922cadb5cc,990263,2020-09-30 13:45:14 UTC,42535228,42532935,false,2293,990251
e6f897f97de7c718e57fc908399c9052ff1d8c8dc1a92c661076a0a6bc661a8b,990263,2020-09-30 13:45:14 UTC,299786756,299779866,false,6890,0
9bcffba5f0f3b01beb4c2a1deff836e0cd55eb8f4f7f566f258c7ecbe2f9200a,990263,2020-09-30 13:45:14 UTC,10000,0,false,10000,0
816ec5a09015ca37a4094487208e14b3f70dda2228851b08ed2e8b821baf4a5b,990263,2020-09-30 13:45:14 UTC,10000,0,false,10000,0
b9262c0687552e517ab1450f8b1232fb2d3871dada3f8849d47d7cd787e7db0e,990263,2020-09-30 13:45:14 UTC,129613438419,129613435806,false,2613,990252
0a064bf4cdb0fd8dcb1b4b003409142fa3164323e95ec0a6dcae520e2c707636,990263,2020-09-30 13:45:14 UTC,800977115,800974788,false,2327,0
ba8ffe13f8a5482eda20e1345b03baab795cd92eb385e1e242530afa9dab6372,990263,2020-09-30 13:45:14 UTC,1958,812,false,1146,0
e20351855406bcdb0c58c2f6632d6f570d6dc2635d95a32f87e9efeb7fc3bd2d,990263,2020-09-30 13:45:14 UTC,178817112,178812009,false,5103,0
8e98b00e80fb2796d853c307fd296e4dba9b92985f4b4a33b8ff896dd7fb3353,990263,2020-09-30 13:45:14 UTC,1988119099,1988089099,false,30000,0
f4875ecc5a018fc5d7d936f394dce4bdaa7e3138d3faecd82816fbcc441bb841,990263,2020-09-30 13:45:14 UTC,4702262760,4702252760,false,10000,0
7c6008371085961da385a9ad6b4786f9f709edda72e70770805e841292d600eb,990263,2020-09-30 13:45:14 UTC,20567845758,20567835758,false,10000,0
e5df53586435d7e53cb8b3400693bdbda92459a67f910165fb5e6c94f55141e8,990263,2020-09-30 13:45:14 UTC,10000,0,false,10000,0
cca30e5e7ec37eb86ad6907e6e860b33f5a3b557529eb5cd6fe9bbac5a551da0,990263,2020-09-30 13:45:14 UTC,659778,649778,false,10000,0
67ce298c5992df58b46c3d9cc094be298f1de22f8d423e4041f439f66c343ba0,990263,2020-09-30 13:45:14 UTC,186893,176893,false,10000,0
b6683916d6f53df16c4eb4cfe07825aecde5a42b5d4a600625e9a5c6eac7bfe2,990262,2020-09-30 13:40:59 UTC,53084195,53081901,false,2294,0
8d5d02f390aad5eb4fe23db02f99ca3746b392062a3ce31c147f836028d2c310,990262,2020-09-30 13:40:59 UTC,1449881571,1449799755,false,81816,990251
3e3dc3f34190266671b1f920ce112bfcd9d5c9d32dd29bb20120fb01407d849d,990262,2020-09-30 13:40:59 UTC,4450325905,4450315905,false,10000,0
392bf0361c3562f8670e9887e603279216e9ba040eb60356ca1a26f2d5dc4fc2,990262,2020-09-30 13:40:59 UTC,671025014,671019014,false,6000,0
bc7367cf4ad0e862d29293272e7de66cae947a67d93b67e8c5433e01ba1033c8,990262,2020-09-30 13:40:59 UTC,196893,186893,false,10000,0
62f6489d00f4257b43cd40cd945c17e3b42baf62df1fdf99176d951cf0d36c1c,990262,2020-09-30 13:40:59 UTC,136820696,136816511,false,4185,0
3313577865c6a1e5dfc58ac4a01967836665dc000ec64b32d3dab34a47e04adf,990262,2020-09-30 13:40:59 UTC,502425816,502394756,false,31060,990251
60aedbbce7d4e186f4328c801bf8042efbc2d001f3a2da3fe52e34cafbc82ae1,990262,2020-09-30 13:40:59 UTC,32730,26730,false,6000,0
f0e50ce2301893de99f68c252fd2f3d7d65f21f1acb3ee8bb950c20c221a6398,990262,2020-09-30 13:40:59 UTC,3166000000,3165987915,false,12085,0
c844e606cc47edf7cadcf0f0b9d46ec05c0de4a40497f3b108ce7a738f9a61c4,990262,2020-09-30 13:40:59 UTC,206240822,206224905,false,15917,0
7e7f4a24dc2cf86442e6c05d33fb100366fcb51c5a7e1816af1d9a830e9c2133,990262,2020-09-30 13:40:59 UTC,250,0,false,250,0
b32f912ab233b911ae6307ede3616fb8cf21485fe5d9fcbe90c475052bc12c58,990262,2020-09-30 13:40:59 UTC,10000,0,false,10000,0
e2b48e9aa24f665fa38d38a321c2cd17f521bba96332d7a22337d2739b42ee8b,990262,2020-09-30 13:40:59 UTC,500050360,500040360,false,10000,0
441cc7fb4b4f3caa5bb78b9a4857c1ded4954e271a89a46f24f4d0cfee46bad2,990262,2020-09-30 13:40:59 UTC,10000,0,false,10000,0
15d222d10096bc57a82f6638e6ce8a0b2941780915d60938387acfa17a5a2cc3,990262,2020-09-30 13:40:59 UTC,155876924,155792684,false,84240,990261
dfd5c0f0a43167aa561baa00ea828d64ba85beb516afc42363b8902d1a932199,990261,2020-09-30 13:37:32 UTC,183874832,183681652,false,193180,0
d1be1b365da48441061067626f4cb5ac4ca0c9c02ccd9393d8058e5deece5290,990260,2020-09-30 13:37:27 UTC,151170000,151160000,false,10000,0
0e591161f63355468a926f96c0ecb8dcdac2eaa8e030c1d340ad03b84c52038c,990260,2020-09-30 13:37:27 UTC,26547140227,26547127852,false,12375,0
922e8361cf8f7d126ee2d2f1a365a655488b00eca3f1bdffacd54235dc4a80f2,990259,2020-09-30 13:37:11 UTC,133413440713,133413438419,false,2294,990247
4d167cbc3073603cac908ef09937a09687e07222656ea0bd65525b2f94a052b0,990259,2020-09-30 13:37:11 UTC,276746337,276744077,false,2260,0
dae118c33c252bde55b2c1fb288e2810d428f3408d6e6e7bab52b482857f5185,990259,2020-09-30 13:37:11 UTC,821563208,821487992,false,75216,0
972f8ff2b49e80fa8d5a53a8f9b43af45f350e100582a5ebb0757fa8772a51d1,990259,2020-09-30 13:37:11 UTC,10000,0,false,10000,0
693b675bde34d1a51984d8bd6bdeb8a7143d314d2fe286a65cee36b8fa7da7b7,990258,2020-09-30 13:36:47 UTC,38722752,38713350,false,9402,0
9bd49e1dd9fe658f046741ab9a718fcc7ae1335658ca812efe9a8d62cd82b65a,990258,2020-09-30 13:36:47 UTC,176736,166736,false,10000,0
bdc87b0af5cb52432a7f99d57d68b9547a5be4d9ad2127c87bc4095417077850,990258,2020-09-30 13:36:47 UTC,500102028,500099725,false,2303,990247
add57e635968c3ac42a2e528382a393ae540cd5b0faf8489d75d9fac311e32a1,990257,2020-09-30 13:35:30 UTC,817965043,817962593,false,2450,0
661c1ba66767655e4093ff7c71047e45ea9feac21a7725629e38964804782561,990257,2020-09-30 13:35:30 UTC,10000,0,false,10000,0
a45a600f12b9b0972e88cb0221d416176e3d83e044342493386ed272c620ecf3,990256,2020-09-30 13:33:35 UTC,10000,0,false,10000,0
a77e87214889e858c3ff5c5a7be749538a5ba56fea53c80168edd84d4fda3d24,990256,2020-09-30 13:33:35 UTC,40671148,40667463,false,3685,990244
7eac9ed57fcc84bed839beba87b0eeb28c6e2b698d95a74f2fb328320235eac1,990256,2020-09-30 13:33:35 UTC,131674552,131671285,false,3267,0
93ccb801e570efa01380d0b5dd7a2b372a4dc73cd3a65d09c6e7b00b5bea91ac,990256,2020-09-30 13:33:35 UTC,157012943006,157012940713,false,2293,990243
af46649c491b6c88848165a080660b05528bce4333ec9d8c16db28d4358a6a5e,990255,2020-09-30 13:33:05 UTC,200932300,200929850,false,2450,0
c0cd5cd5d51c433fea647cb18c605397bde10025a3b059a6f904799da3192beb,990254,2020-09-30 13:32:40 UTC,2280626478,2280622738,false,3740,0
a599ae835b18600c1b8ac231959dcfd0e1c29d786abfa349a6ce5e7cb7a88d45,990254,2020-09-30 13:32:40 UTC,2090871512,2090841512,false,30000,0
48cc5e5b710065982af55d93e02fb336a3cc14082680c992a8533433a1d4bd9a,990253,2020-09-30 13:32:00 UTC,10000,0,false,10000,0
93fb6d2042d02b694ef9a45ae9c82a916b51e9bae234a948da800f3b6969df5c,990253,2020-09-30 13:32:00 UTC,179930802,179927842,false,2960,0
edfb4730785405f2ebb35b86396b488082dc8c90efb1048d8fa163a163cf5ea1,990253,2020-09-30 13:32:00 UTC,2503935682,2503835682,false,100000,0
d23b4c02395a609d988c52be5ceea181e7773dc96593ed9bf205c2f87895e4af,990253,2020-09-30 13:32:00 UTC,1451407153,1451325299,false,81854,990241
e79039c1a021fcafa655ccb6e1cf0138a37f069ff7e038e19c7101f90602944c,990253,2020-09-30 13:32:00 UTC,503279039,503253741,false,25298,990241
4c32cb4ab447b5652571b680fde8cf21b33c84a058bf9233de961b18ded8cdb4,990252,2020-09-30 13:30:02 UTC,500031049,500021049,false,10000,0
586e82cdb5ab798f019f31694d5ec3949cef9ae15fbdf9b8ee34ce5f8fd110e4,990252,2020-09-30 13:30:02 UTC,10000,0,false,10000,0
d6653c0e13165bf5c0b369581c22a655fec30a8f30bbd890c5443ca381fea801,990252,2020-09-30 13:30:02 UTC,77478941,77418941,false,60000,0
5462c39bf466a72ed1c31aee62bdc6b5befe8e063bda4bdfb9c3df854a007301,990252,2020-09-30 13:30:02 UTC,1499990000,1499980000,false,10000,0
8752543fb8964c7e19970eed0b96bea7dc12eb59bcf8091a5cdcc9c3b7dc23c7,990252,2020-09-30 13:30:02 UTC,10000,0,false,10000,0
da0a9e2e23d7f6df38bcac797e3f739012a5d30db90b572e00e0c900d0cc756d,990252,2020-09-30 13:30:02 UTC,119465523621,119465522619,false,1002,0
572a7dd6d809b1b88dd869397a101b6443c2d685ab2ead59ac24a68c77075b68,990252,2020-09-30 13:30:02 UTC,994999915,994989915,false,10000,0
b80d73e40ed7f40a48258564c879f3e14ab4600ff9b3e27ccb9a6743c9525209,990252,2020-09-30 13:30:02 UTC,38787863,38778462,false,9401,0
88cb3ae27ed4997f52aed5604899dc8b1f80eddc5fb62b0fb1f42e744dd54440,990251,2020-09-30 13:25:19 UTC,321549947,321547687,false,2260,0
ad1b31e6f88b09d78dd3174bb3a5c35c3cea842844adcab3dfb5b64d42b0d649,990251,2020-09-30 13:25:19 UTC,38849722,38840321,false,9401,0
85d965f7c1b0e42186fd704d5e8c7126431565d036cabe12b3eee58aeb2a9f74,990251,2020-09-30 13:25:19 UTC,38901548,38892147,false,9401,0
7c0372ff1cfb50ede7d915dea271050263663b67faba8b069fd314a03add667d,990251,2020-09-30 13:25:19 UTC,10000,0,false,10000,0
42cb8f0d3dbbe9d342c18bbce4a6cf4c58e5c69205a8701c613906e7f6ddb479,990251,2020-09-30 13:25:19 UTC,10000,0,false,10000,0
2164a070eee6e447709e957aa4f0ab2ad2598805f3433defa799315bbd97f4e5,990251,2020-09-30 13:25:19 UTC,100000000,99997550,false,2450,0
d7c29ca31af8a1ca63517813c5cbbd007bb75c95d85b4f4ef2a8677682bd40d8,990251,2020-09-30 13:25:19 UTC,71911835,71881835,false,30000,0
f156d9453d165d2e4e160633250ed45b43abaf0ee606d72e3b0fa5d7b0ff9875,990251,2020-09-30 13:25:19 UTC,137489199,137485932,false,3267,0
2217afb8ffa5c3243f07f84c7c4f38750e940444429d24b09dc5d162fdf97c3f,990251,2020-09-30 13:25:19 UTC,17783888320,17783884105,false,4215,0
3e25946d45d2f795afdcf4217729073e42b00e591c6ebe9df48b53d337b45699,990251,2020-09-30 13:25:19 UTC,160288245309,160288243006,false,2303,990187
9baebca679baa534c6d48e4df7691321e5d9897a66e4fd2fa87168fa946e926d,990250,2020-09-30 13:22:13 UTC,503825376,503799148,false,26228,990239
8853e28364cf745732387612e9b8dc11518c032a538f8d95dbd9a7cd04e000eb,990250,2020-09-30 13:22:13 UTC,14000000,13997707,false,2293,0
e76c02fbf1eab1ea7068004aff0f992eefc053e9f7fc35c2627290993b9d0a38,990250,2020-09-30 13:22:13 UTC,425728,277288,false,148440,0
df8974b804fe806287dfa7c3078e7c5358029a4d0d4902964c163a709ac8b033,990250,2020-09-30 13:22:13 UTC,53528003831,53528003731,false,100,990239
e3939422f730dca92cb28d51b107e6479e76f5ff7ef29ce41c3370e12473ee68,990250,2020-09-30 13:22:13 UTC,204813780700,204813778410,false,2290,0
f6c8bcac65ef3061967582f1b0101d76079dce5137fb85bd12a9dcf3799cef67,990250,2020-09-30 13:22:13 UTC,39175738,39166337,false,9401,0
feadd433cfc3b04c6713b9a8c33f3091726504b6ca6ea6c21c227562552c3bd6,990250,2020-09-30 13:22:13 UTC,1452997844,1452916009,false,81835,990239
0d1f0ffb1d613fa878496d2744c5f03c3ed454b5c6f2afa19bc1563a84d1ad29,990250,2020-09-30 13:22:13 UTC,100000000,99997550,false,2450,0
4ba16ed310639308fe2cef57967b4dd48a43b6a8eef4f5acb715210ec4d0f4f9,990250,2020-09-30 13:22:13 UTC,53485535361,53485535261,false,100,990239
b1f970483871557b213c11b8bd021cf99bee4e6937cbf9138e0166597bd1d348,990250,2020-09-30 13:22:13 UTC,39261018,39251617,false,9401,0
3344de5b71c210b24e583156ff27589f250e36e667df6d2a1a4443b020892cc5,990250,2020-09-30 13:22:13 UTC,150200000,150190000,false,10000,0
0a08068fef66eb29228da91ce770a3def01503ef7cc10164be14bbab26e77c13,990250,2020-09-30 13:22:13 UTC,39206149,39196748,false,9401,0
06bcca3a139f734be25ab4478da70728d3e7f9a2f9739bbc7a2ec93665149b9f,990250,2020-09-30 13:22:13 UTC,10000,0,false,10000,0
95dc9d97798b6d978a908b26bffa283ed2809908c22c0f6a2ac57bdc4485fc6c,990250,2020-09-30 13:22:13 UTC,144876049,144875597,false,452,0
07bcf2c10bd06977deb4800fa20907dc29db40b9d6ed2e905a93e7f9c306f556,990250,2020-09-30 13:22:13 UTC,183735718,183716071,false,19647,0
9ee02731f34d67ac354199c7156e73ab10eb1c9e6dbb4fa44b1316dc9ab7534e,990250,2020-09-30 13:22:13 UTC,500112028,500102028,false,10000,0
369a794dec9f15523b6958067ed567a201690c4cc6b124f26bc898420066b015,990250,2020-09-30 13:22:13 UTC,3329970600,3325710000,false,4260600,990237
a02351df2e82e3c28f8454e9aa13c155094d090623c1db5e7220641033be409d,990250,2020-09-30 13:22:13 UTC,131839596,131836636,false,2960,0
2d101b4133751474a68c972f804074f368b43da72bd7febcf37a9f371a1491b0,990250,2020-09-30 13:22:13 UTC,20567855758,20567845758,false,10000,0
7be6cb3c6d90a48cb5e35f93d45f4d54243a1c52c41358d7f2ac7505252d46bd,990250,2020-09-30 13:22:13 UTC,10000,0,false,10000,0
7c71ff6427ed939e94ee3cb75406db276ab511d7d30b3fa78c1d6f255abe64cd,990250,2020-09-30 13:22:13 UTC,38942093,38932692,false,9401,0
9c8e33e76cd39c132d07a92c19747756ea28e613b7c47fc2a4cfd70709fbf8dd,990250,2020-09-30 13:22:13 UTC,260295517,260220309,false,75208,0
55b6ef5512a1f94c2d4159653a9aff9e70de3b0967bdc9406eac2646a8ea79d5,990250,2020-09-30 13:22:13 UTC,180197715,180194755,false,2960,0
81655c6c7929aef676a862a886c52bd885df65747a7d5eba283f1eb415d9d5a8,990250,2020-09-30 13:22:13 UTC,39006609,38997208,false,9401,0
b07e389fe6914fb5a75a86ec6a9e66c5a173a01fa3507510c0273d3878d4ca35,990250,2020-09-30 13:22:13 UTC,10000,0,false,10000,0
bb3704154e4b918f124f85192c2dd9936da15f6f234327039e853a2c19f08e7e,990250,2020-09-30 13:22:13 UTC,1500000000,1499998418,false,1582,0
e80e497226992a70127944e1425b1a596790ea7863164c00b9ba127c2a537413,990250,2020-09-30 13:22:13 UTC,64607,30127,false,34480,0
52ff76f824a21312b37a7492d1923fb2e6d3726048413a2fd2a37f9425e10867,990250,2020-09-30 13:22:13 UTC,581502997,581492997,false,10000,0
20d1bf557f9f90bc5198f4f590374b654abaea6c87907731bc1d65a633356c2a,990250,2020-09-30 13:22:13 UTC,653375713,653373410,false,2303,990239
26811f461033ac115357eaba20c8860729f879f9efe4153dafeb694486285f3d,990249,2020-09-30 13:15:33 UTC,6420234,6417941,false,2293,990238
909694e8ad7dd340d4e2163013b939978201e63968f85420a3ae9ff1b7697a95,990249,2020-09-30 13:15:33 UTC,10000,0,false,10000,0
b0dc59a07125f60e34b1afa7d4fc3c928b85b430efff736781d84e3ca93c4230,990249,2020-09-30 13:15:33 UTC,499980000,499970000,false,10000,0
b91f41f103c9baa1baa267ecc26ca7c0880d2fc4e8429886a60c0c5b318d3f5b,990249,2020-09-30 13:15:33 UTC,50565789,50538447,false,27342,0
df33cbeff7f8d2e04dae21c56392557a99a3217106b5f8dfdbf474c47741a2e9,990247,2020-09-30 13:13:36 UTC,10000,0,false,10000,0
ae1a174e7361267f52192aa4db54012469bca39b86d6996e9c79a939507010f7,990247,2020-09-30 13:13:36 UTC,535863070,535780322,false,82748,990233
be53ae7c1e96a1345e8c2fd2162574b356079a8acec32341ba3fca2684705a00,990246,2020-09-30 13:12:29 UTC,1199990000,1199980000,false,10000,0
3317fb8314ac2ebe0f0b153ad0ea164401635a925900246332e9934d91990ac0,990245,2020-09-30 13:12:11 UTC,137763910,137760643,false,3267,0
4852fcc5adead9d5e88cef6f7fe2c676f44b1d8b71f48f078f9b4612bdbda094,990244,2020-09-30 13:11:58 UTC,39323628,39314228,false,9400,0
251a28a6b866110adea5c77561baa4de8ecc53e67586f866e7a1010a654ae6bd,990244,2020-09-30 13:11:58 UTC,1454522170,1454440400,false,81770,990232
76837c47b733b0c02a9c8fa7e508e03f185fdd8f8f19a463d4cb494697e86534,990244,2020-09-30 13:11:58 UTC,51097186,51069844,false,27342,0
6dcd8306fc825dcf61a8ab249914df7338b7b2829c80bf5ae30bdb382b097a45,990244,2020-09-30 13:11:58 UTC,1187262951,1187259211,false,3740,0
12b41c5ea498b17063fcd719640ec80eac33abd13b8fcd76b4b6fc9eb8f68ef4,990244,2020-09-30 13:11:58 UTC,10000,0,false,10000,0
3d874643404b2be266f9ce8595ee49253ef7ec47e8fe7016c0840cd876b7e180,990244,2020-09-30 13:11:58 UTC,504468858,504442595,false,26263,990232
930d21d2c6e7654340b6f36be6e37a487d261f16ebe176f5880b8dadf82f8b7f,990244,2020-09-30 13:11:58 UTC,39293198,39283798,false,9400,0
353a578472e93d45cf0435beae216403d1dfbda3ad826109dc7742572aa7581e,990244,2020-09-30 13:11:58 UTC,1000010000,1000000000,false,10000,0
2ddd10206eeefe6cd801f07df8488bf74570efe407fec0ed8035514a42953e24,990243,2020-09-30 13:09:46 UTC,10000,0,false,10000,0
9ce8a604616dbc6c5c49a8ce5e920b4a117b5bc588dfd34632dfc3b2c6633a19,990243,2020-09-30 13:09:46 UTC,171030218,171026478,false,3740,0
20c76b2ab712fa1f42c1ba34a9e8b2285864b49cb1c8f6eb97838d901eb92d7c,990243,2020-09-30 13:09:46 UTC,500095200,500085200,false,10000,0
ce496e83d9aa8e21ff7ff59398bc42f40aa08e262df5f1f43e70cb35ba786668,990243,2020-09-30 13:09:46 UTC,85600,75600,false,10000,0
50e8234e5d6f29cdef63af729152f6d36d009ee6a6d25d350f9e710c0556e995,990242,2020-09-30 13:08:15 UTC,1601547795,1601447795,false,100000,0
90735ef9a71f2732e5a2e37f1b98983041e3c039a15884bb8d8b112b7b93478f,990242,2020-09-30 13:08:15 UTC,10000,0,false,10000,0
2ab3658d66ec85fb945c71524dbc555b84ad4143ca819b586a37816b91d1a79a,990242,2020-09-30 13:08:15 UTC,247468178358,247468168358,false,10000,0
d429c04da3782a4a9ca0d37f1f4f8bf1de1a621ef085f9a1b3b7acd114ca1a43,990242,2020-09-30 13:08:15 UTC,500010000,500000000,false,10000,0
ccbfb6adfea238614ade1c10084984b34f2f0f5815040b9925a3ea526005b7ee,990242,2020-09-30 13:08:15 UTC,1000236885,1000226885,false,10000,0
8b5e723c4161884cc8424b7c82aea019ca02bda4dc2e7a4a56b922700a52c6d1,990242,2020-09-30 13:08:15 UTC,210069292,210057289,false,12003,990231
ceb47f047cd547544cca926324139ba0bd92119fcdfb7a2f551e1319e267c576,990242,2020-09-30 13:08:15 UTC,3500723294,3500713294,false,10000,0
153ba208ca7d3bf1de618dd642645c9941dd8a753bafb21731f655393174d5c7,990242,2020-09-30 13:08:15 UTC,39384130,39374730,false,9400,0
3f39f95ae3d3a1916e2b14c7e8f664a5f4acc74e27e4d25804b2c473a085ab51,990242,2020-09-30 13:08:15 UTC,10000,0,false,10000,0
c5ddb24bf002ef97ebaa4b8aba8757cec848c87c21a49023d5a6cde812d3c32b,990241,2020-09-30 13:04:45 UTC,3319198495,3319191605,false,6890,0
491cd2577794a2cc7b94b04cbf3efbda253984eb495aaf3c8597925770edb07c,990241,2020-09-30 13:04:45 UTC,252201076,252199156,false,1920,0
2820617fd8890ca9e60eddb1ebdadd55e9878fe52a00a77ea6bda6ece9133b08,990238,2020-09-30 13:04:10 UTC,500122028,500112028,false,10000,0
01bc1111a6f6f948ef3d54449b2f046606600f0f02fc272d1e585c6aeef4ca5b,990238,2020-09-30 13:04:10 UTC,132012365,132009405,false,2960,0
95626b4300c7d493213fb0afabe40cf98ab6e2440d0e89dd76bd1c26271c4554,990237,2020-09-30 13:03:46 UTC,337328758,337326498,false,2260,0
6700ad41b8280620d71dfb4746e3a14c9d02dd39f031df49ff1dc4abda3c0215,990237,2020-09-30 13:03:46 UTC,154195010,154179430,false,15580,0
739ebb0783b13023915ed27baa37213fc20f03d91230e458c2d53d9d038c7638,990237,2020-09-30 13:03:46 UTC,187130625,187115045,false,15580,0
f373d7adb2a309948e1fddbf3b4e48588b95868192d6cdbf21c5724557a51cd5,990237,2020-09-30 13:03:46 UTC,141711932,141696352,false,15580,0
40ef1547404d6ebc61d6cfaf3da015017e7420ba0ffc8b275ac9db82720f48a7,990237,2020-09-30 13:03:46 UTC,208964167,208948587,false,15580,0
e3692d2c58146129f037bd034c55a14c27277f5a2f32090a3831a517c54d8713,990237,2020-09-30 13:03:46 UTC,227303702,227288122,false,15580,0
eb66970c018cbd02f74743bc42e2a1b58efe78f07d96fc0cee61f92d332d8be6,990237,2020-09-30 13:03:46 UTC,4238739,4228739,false,10000,0
a18a7f5094252dfe2a6ec5e6e3680dc439f069685d927222a2f968c883d8d56b,990237,2020-09-30 13:03:46 UTC,20390953766,20390943766,false,10000,0
27ac140dc65bef3acb7d29cabee03bb425444b81ba8801760a7ecf9ba51187f4,990237,2020-09-30 13:03:46 UTC,682106106,682030890,false,75216,0
ca47b3c57b3e30060891c48537ff40b177c7a6c64707ec0b001022c7e6cb83af,990237,2020-09-30 13:03:46 UTC,114719294,114703714,false,15580,0
c12f485071dcaf6ad49eb2bdee4dd5d3233d15c3b9a24c9600cbc28465588996,990237,2020-09-30 13:03:46 UTC,112861241,112845661,false,15580,0
2d84a62ea55121db62cbcce62b85027ad2ff0ece96607ecc393e22408c201dbe,990237,2020-09-30 13:03:46 UTC,15445016,15439949,false,5067,990225
163ea5f9b838fdaeff9df02f50928c90073420fd1fd976251d03230be84afe4c,990237,2020-09-30 13:03:46 UTC,180473271,180470311,false,2960,0
cb15fb9796e152718e7dcaa04bc95fdf4cc32c2d949d18ce0b4a5df24a9cb01a,990237,2020-09-30 13:03:46 UTC,106716280,106700700,false,15580,0
d1721dc94a0d5ed93267ec549fc27f1aaf2440f2758fc0865bc78967bbe91592,990237,2020-09-30 13:03:46 UTC,168760127,168744547,false,15580,0
e49eab986c9567f688ab9d15900a180a08f1dd9b60fdc2f5207e9a22086c5d02,990237,2020-09-30 13:03:46 UTC,131111699,131096119,false,15580,0
ab27e0e8073ef64ec3328c0dd8b00843790a38b05adc5943aecb8c1553ad7f78,990237,2020-09-30 13:03:46 UTC,499990000,499980000,false,10000,0
295d4a83b421fe6f774ceb1179fdcf79154fcf7b870b56c68c2d062495c35415,990237,2020-09-30 13:03:46 UTC,10000,0,false,10000,0
cf60466737b878cad3464eee89e311c7a527af9fbd8d9028d65ad2e85ea0c64e,990237,2020-09-30 13:03:46 UTC,688812745,688810442,false,2303,990226
7515d9379b96ed402e70e7f706a69aee9d0cf32ecd63a6eddff533fc95b97ee0,990237,2020-09-30 13:03:46 UTC,3845970359,3845967417,false,2942,990225
9186d4daf04a005a331f8f9c0a102bf62895cfe4e3644c6ecca0f5a78308135a,990237,2020-09-30 13:03:46 UTC,121499803,121484223,false,15580,0
7c50c7b796ce132de80eb321272787bb09e0e6e0f33d5d1aa92db68f62049dc4,990237,2020-09-30 13:03:46 UTC,241376841,241361261,false,15580,0
e81b6e2e135214f71e625883639d5c48bbfbb07daad069b636f269e0fa73d47d,990237,2020-09-30 13:03:46 UTC,388499951,388497501,false,2450,0
ab517788c85893ff278e383aaf842ac421aeed7619c24d465c34366c7e8df608,990237,2020-09-30 13:03:46 UTC,10000,0,false,10000,0
6c77ec7e963fa9ccfc2a3834497a4f4265754a781632269333b35132a25d89d5,990236,2020-09-30 13:00:55 UTC,162849635,162749635,false,100000,0
d08a7d38e633e0b7b3cd4ae5448ea9aaeed582dfc6693e0b07b95e6a7f3f9477,990236,2020-09-30 13:00:55 UTC,329168557,329152977,false,15580,0
4841105b31a398f345269b57020c183af11962169a9a3bca5cb22ca35d8aef72,990236,2020-09-30 13:00:55 UTC,1029699172,1029683592,false,15580,0
fa29d3784bcb6686ae87dec2a9eeb49a8c7316e33483c52de227a100457c983a,990236,2020-09-30 13:00:55 UTC,448320452,448304872,false,15580,0
c523476d845df2fbd3d163129a60afafc3f9736980fd64c03e169cf558e6ee4c,990236,2020-09-30 13:00:55 UTC,1159711112,1159695532,false,15580,0
a40f5ac3cccb9fba6a92cae5e15bc00275ae0ee1ebc987447111edbb2a707c7a,990236,2020-09-30 13:00:55 UTC,403089995,403074415,false,15580,0
b69dbb89d602ded47b8a57b547e93f451d42f73fd0ffb468bae33b787ecb16a0,990236,2020-09-30 13:00:55 UTC,679881534,679865954,false,15580,0
33dc0c0de372cf22f365c76362ceca33dc3788217c807a0e83750834c0f71886,990236,2020-09-30 13:00:55 UTC,838488658,838473078,false,15580,0
240098ae1a0ef25fdb158a3ab149282717a20e5403997f365d60d0690d0ad81c,990236,2020-09-30 13:00:55 UTC,20706229529,20706219529,false,10000,0
a8729e16eaba1e71be9128fd7cd9d07e8aa5b5918544206647d775b01498cb42,990236,2020-09-30 13:00:55 UTC,1456213669,1456131825,false,81844,990225
b0dbc9660b97553e3a167860a97cc669f095e36a491b8b9d6042d5d0e79f5e8f,990236,2020-09-30 13:00:55 UTC,583666743,583651163,false,15580,0
744c20467c57ac00e8901e243bd94274adca774ecf7084edcb5bd2731cd8e2ca,990236,2020-09-30 13:00:55 UTC,73678144,73677144,false,1000,0
ad35b3cd6eb5b6f8655865a1a686040792eaa0ef4e726be7b676716a8a00441a,990236,2020-09-30 13:00:55 UTC,501299067,501283487,false,15580,0
f820030083aeede013bcefbe1c7c560962fb17155066fe4934cb5cd1f572651a,990236,2020-09-30 13:00:55 UTC,13999500000,13999490000,false,10000,0
2e6794c427936373e82e626a11d4f0801f8e29b2d5a782c2eee439bf7a00d269,990236,2020-09-30 13:00:55 UTC,505379746,505343257,false,36489,990225
cc255479da9a8cb696f8122bbc77299b1ce338312f1e61c8c340a0f75d6bc160,990236,2020-09-30 13:00:55 UTC,160698803612,160698801309,false,2303,990225
30a2cd55170dd26a1b1054e47ebe4fa138e0b59ce4133e28dfe8f5d1288434a2,990236,2020-09-30 13:00:55 UTC,364799435,364783855,false,15580,0
e3cffffbebb653bfc763046c555d66c84b4856e397f8d91d6647b0b84348febb,990236,2020-09-30 13:00:55 UTC,500000000,499990000,false,10000,0
190864393b746cd3037675cc30edfeb007537eb5236e173d399080650d085bd2,990236,2020-09-30 13:00:55 UTC,958893505,958877925,false,15580,0
800905931376f7ae5054374feca3e84173cc767a4ff69276d25858802928aaab,990236,2020-09-30 13:00:55 UTC,281574110,281558530,false,15580,0
5ee23bdcecac8b285d1265768658157a449fee5c4f54501ac425b748fb5bc533,990236,2020-09-30 13:00:55 UTC,677869092,677860912,false,8180,0
efcfed2db62ff68b9d2d85ec1632c23fde9fe192778853552bfd27eb974779d7,990236,2020-09-30 13:00:55 UTC,137925258,137922298,false,2960,0
d16c1c2f9cc4ff569e4bcb8f3f3534416a13d9bd6c1a449cec0ba5bad990b200,990236,2020-09-30 13:00:55 UTC,540984811,540969231,false,15580,0
6e024a26a2e959aa2c97c2e526fd7eb9d2a8224a9769d5cfbd6c1e755f52587a,990236,2020-09-30 13:00:55 UTC,188199861,188197558,false,2303,990225
3a7ca7ee1136e09846047a5f61c0286ca07138db7c41b690404f93b856f1a103,990236,2020-09-30 13:00:55 UTC,10000,0,false,10000,0
8daebd4ebb0466e4b00e9b595ea7c408115dda07afa2e31ad811c432d1c69174,990235,2020-09-30 12:58:49 UTC,1525908190,1525892610,false,15580,0
63f760d05563f2d9dfe625e4342e8dee6e8d60b1d972b5ef6b7e9ba302c2cd7a,990235,2020-09-30 12:58:49 UTC,1338179809,1338164229,false,15580,0
a3da1612326eaf4dc07a90a937f63078e8b6a8b9aebd26107ee815be43e388d9,990235,2020-09-30 12:58:49 UTC,1338409744,1338406004,false,3740,0
fefbd99131438974492ad654d33c4bd6180d14a8f58e23b304ad6f319988e72c,990234,2020-09-30 12:58:21 UTC,2275393263,2275377683,false,15580,0
0b823b16fd639f194d6fe6796c89da67da312612af1dadb113466aa632186019,990234,2020-09-30 12:58:21 UTC,1792036626,1792021046,false,15580,0
d0cfe94783f260800bfe42062ebf21f92f22d00408c40c981fe1fa85d90e0da3,990234,2020-09-30 12:58:21 UTC,4813353117,4813337537,false,15580,0
d7e8bad9157a3d955a337ef4dafd5c351853b565f5e437980361b4183bca7749,990234,2020-09-30 12:58:21 UTC,3178799857,3178784277,false,15580,0
3b69f5fa2fe28d0f149e17c640879bc1020691191353eea5e97df10272607a25,990233,2020-09-30 12:57:38 UTC,53211120016,53211104436,false,15580,0
c7386d34eae96c163111f5ab96c0aff85b713f19230815bd8ce0407a5bb15fcb,990233,2020-09-30 12:57:38 UTC,9013844549,9013828969,false,15580,0
753401409d256ed9650116a62fcbf4dbfc837bcf0385d9567f005a2cfb70a618,990231,2020-09-30 12:57:07 UTC,39437496,39428094,false,9402,0
c7566b7cfa1b240d00d7b113049d2eca99c9b47c13c18727baa1726c11172a5d,990231,2020-09-30 12:57:07 UTC,53847903931,53847903831,false,100,990219
eb80ede5dff4f17a9b4ae083ad7acec607a905e322a56928fdca56a12eeb6469,990231,2020-09-30 12:57:07 UTC,999980000,999970000,false,10000,0
6b6d6b0ea402859704fd7b8ae7f5965742ffbb7ea50ed20691a9ee76f7f66b43,990231,2020-09-30 12:57:07 UTC,10000,0,false,10000,0
92d2db6873dfc486dd4ff5a92fc0c76bda328a8858f5133295bda7602aa5ec12,990231,2020-09-30 12:57:07 UTC,3366000,3359220,false,6780,0
7742efb0b1560eaa5d5be77279bec469261b8147ebbe50c5f506626702244250,990230,2020-09-30 12:55:14 UTC,132160059,132157099,false,2960,0
361579220d158c2dcb35b0775f6c3fd3e584560e329f61a3633aa60f5a19130f,990230,2020-09-30 12:55:14 UTC,106501908,106497794,false,4114,0
42bb2c003b7946e92d82e58b6b4061388111ee643058c08b00784c8fd9c0bc9c,990229,2020-09-30 12:55:04 UTC,160766269815,160766267512,false,2303,990217
c90958e44d083cb376282552219c531e8e1fccbcb3e1c36db36f058b2d720ecb,990228,2020-09-30 12:54:51 UTC,9099082,9096458,false,2624,990216
03019cd2e00634c3eea3498bf5abc32968f8491f4b7e510d25817ae9d7260746,990228,2020-09-30 12:54:51 UTC,10000,0,false,10000,0
fcdc46af584fb6bab6a01a9528141acb342ef77041eea48fc1ece8e053b57671,990227,2020-09-30 12:54:30 UTC,39532151,39522749,false,9402,0
12f5bcce7aef2ac9afde37fafc0d2a7d27d5a77cd4ae5429245bf17aa34de406,990227,2020-09-30 12:54:30 UTC,5132078,5129628,false,2450,0
736b2980b502947209bfb9596f5be36902193273fd7a3a0d1e2b874467c64eac,990227,2020-09-30 12:54:30 UTC,131555129,131455129,false,100000,0
dc9482cb57f2286fe9eb78d1d0d6af405d0f611b3e08bbee411a6ed7b765b4c0,990227,2020-09-30 12:54:30 UTC,10000,0,false,10000,0
d05b884082dfa1829db857e88657ec8150c135040c1ab333f633d007974c5940,990227,2020-09-30 12:54:30 UTC,20706239529,20706229529,false,10000,0
9ae6e4ffd681ee2a1520a492b316d8aeb44972319486db4249f657403858a60f,990227,2020-09-30 12:54:30 UTC,9918139,9912000,false,6139,990215
d24077315a3bafcaf3f47c99cb19a194ec4fcb6bb3db9e8b0d66140d5352a608,990227,2020-09-30 12:54:30 UTC,3860509,3859363,false,1146,0
c2e41f180eca1458f465c6f9db7ed1acf70e10f24447044b9cb1ea245704a768,990227,2020-09-30 12:54:30 UTC,84763167,84753167,false,10000,0
63ba26364bc17441325c66db60a07d9f18dbb60b2e96f30d9b742344613ce28f,990227,2020-09-30 12:54:30 UTC,39489826,39480424,false,9402,0
5686ec2dca6ccdae5b26d1ae1c531dd760833b0f8df5be61b475e3c8580ef107,990226,2020-09-30 12:51:52 UTC,500108587,500098587,false,10000,0
c6f3b0b2f6753eedf6efa4fc3990021eb248a3b621e5e13332241d571de1ac56,990226,2020-09-30 12:51:52 UTC,506175734,506146936,false,28798,990214
de0d1675424efe40d08631d0182e3b8928e4aad03180cfa961530e4f26a55a99,990226,2020-09-30 12:51:52 UTC,20432731386,20432721386,false,10000,0
3991d2136ed18c1673a5d54df0c236f272a051497e3d09076a89a2ac86924052,990226,2020-09-30 12:51:52 UTC,1630735480,1630730960,false,4520,0
1649991123684559eee0d1e802b3d47a8eecdacce4621d02058f468489b129f2,990226,2020-09-30 12:51:52 UTC,10000,0,false,10000,0
2bc26d4ab37b661bbfb9c3a5bc8951477d598b449efe19d030ce36c31996ad06,990226,2020-09-30 12:51:52 UTC,227764176,227742509,false,21667,0
cf52e844872be9c8bfdc2ae79cbad0089c62b38331156ccf1c426dca48c91bef,990226,2020-09-30 12:51:52 UTC,138525640,138522680,false,2960,0
b1c2a49f7a9679991edb15d76a2556f8082fa12e663a770b982a6543781add4d,990226,2020-09-30 12:51:52 UTC,1457520393,1457450433,false,69960,990214
f7f17520b20682257b988d66a316fbb013b636c2955632a9defdbfc556129321,990226,2020-09-30 12:51:52 UTC,89388785,89373205,false,15580,0
8673c76985dd9e4374957ae64d43b7d7fbbfb7d2d744bf24ec588afc392c6fac,990226,2020-09-30 12:51:52 UTC,43450581,43435783,false,14798,990214
a059b74003e26d252c49f188a79f988b284f31af4a188e429bb9a66af2f44620,990226,2020-09-30 12:51:52 UTC,180640673,180637713,false,2960,0
f87007dcdc213aa941bac7ba838d4e5ecc39f447a355db2a370f332b5566a247,990226,2020-09-30 12:51:52 UTC,656513570,656497990,false,15580,0
08d9088a70cac62f901a1ca327f4aa80b615209c14a00a8bd13889beb549263b,990225,2020-09-30 12:49:52 UTC,136268639,136253059,false,15580,0
7be0b306a960b3700ade1fdbf4ffdd42d62c902b566be66172805ebfbcc684e5,990225,2020-09-30 12:49:52 UTC,2420000000,2419997697,false,2303,990213
9eb21fd2837fc8d832a1132f1eb0c8d98ea7129d23c114bba1375db979d8c320,990224,2020-09-30 12:49:13 UTC,500118587,500108587,false,10000,0
20596a8669a8f291a37d389e7e756e8117fde27b70278e5949d94364dff8e782,990224,2020-09-30 12:49:13 UTC,20432741386,20432731386,false,10000,0
2077fd6d944d4eac14ccf680ba6192580f2203c5700bfc98163c625a32bc2aae,990224,2020-09-30 12:49:13 UTC,10000,0,false,10000,0
b12acc9dee9fecd1173efbde19a202c7d35ad0884f784093691ba6e7fe1ad624,990222,2020-09-30 12:46:58 UTC,1481396096,1481380516,false,15580,0
068cbc8eddf205b1bd1e9e1158992f664a0586ddf2903cdbf6e6c9c2f8895051,990222,2020-09-30 12:46:58 UTC,511374180,511358600,false,15580,0
81fcaa801830149a55fef5fa88f2b4b1a5e353f9bfbace01ba07b1745c8f8d37,990222,2020-09-30 12:46:58 UTC,31347842360,31347826780,false,15580,0
e06a1a58611498d906e0932eb295485b3508a724a04a7e51ff63383790aa9864,990222,2020-09-30 12:46:58 UTC,10918544067,10918542147,false,1920,0
21fe0a030fcf103242af3d1a6706897dccfe9ab5e4ede1e37e77c5e4337def57,990222,2020-09-30 12:46:58 UTC,1591223000,1591213000,false,10000,0
a2dc296fd63e1e2573a4debd843cde9ca886b752d938009fc62699cc54648627,990222,2020-09-30 12:46:58 UTC,39775120,39765718,false,9402,0
a00279d648f9aab22446d5ccbb46a77dd50174722076998c6f5faa835f49a565,990222,2020-09-30 12:46:58 UTC,39834295,39824893,false,9402,0
95e3429ab709c2c5dcb7832768b3eef0e5d2b9e41e35abd2498a68f63eab89c6,990222,2020-09-30 12:46:58 UTC,200064353,200048773,false,15580,0
9367a0ed270f6d6de8cd696efb4b49f3ed3744bba8935f49bbd2e5611670e042,990222,2020-09-30 12:46:58 UTC,10000,0,false,10000,0
2093c1b4fc4d8f8ceeb0c218efbf13a5ceaeb3174bd311497f4768844e47ab45,990222,2020-09-30 12:46:58 UTC,39805828,39796426,false,9402,0
9c15c675be4bd6445be879157dfde1706f97767e3e8eea3969d109514dd7009e,990222,2020-09-30 12:46:58 UTC,6989434,6988486,false,948,990211
a882eb1d84a4b48dbd980ca9f841d11ca969f6f3818e3a37952ccce2ea5e62a9,990221,2020-09-30 12:45:51 UTC,499980000,499970000,false,10000,0
ecc44ba5c0a6a6c04f8f0c99f9d8ce9f15c232c03d9159c4316cdf9a103c0275,990220,2020-09-30 12:45:21 UTC,132315594,132312634,false,2960,0
9b403c7383d2f7451c9749a53e56baa5bbe6914c967ef361f2731d78777d4bdd,990220,2020-09-30 12:45:21 UTC,10000,0,false,10000,0
155ec4a82bea421a21e56290efc7b428f601858525d24ea27b8b4fe1d967a135,990220,2020-09-30 12:45:21 UTC,624934872,624919292,false,15580,0
5904a8715b81875d58d6b5cac4e156772c6f992f295c125546449933d2445092,990218,2020-09-30 12:43:52 UTC,166665772118,166665769815,false,2303,990207
50e6e99bf824c4daaae6c5d602a61e8f03c51b3915d644ebf126467594e41829,990218,2020-09-30 12:43:52 UTC,539209260,539134044,false,75216,0
a86aee10f47236910abbb4c07617849fce035ec935c18dc82c514b2031fba008,990216,2020-09-30 12:43:16 UTC,130376,127926,false,2450,0
02ec3db04c3397f3bba2f60703cd7b8216d9b883c63e3b2503f99db30c4bee0d,990216,2020-09-30 12:43:16 UTC,10000,0,false,10000,0
cd36a4e64a7e04613688f2d41d1bfb37f5b96ab7934362f5709cfc4f3ca9d426,990216,2020-09-30 12:43:16 UTC,33259540,33257280,false,2260,0
514297892589e01b8667abe6fe035f369f084ea207c27f3e12cd73eddbf95792,990216,2020-09-30 12:43:16 UTC,39870077,39860674,false,9403,0
b57c4855a5d34400df9e1ef386e9e65f9036d0879df5c44fe721f74cc596d866,990215,2020-09-30 12:41:58 UTC,167153139042,167153136739,false,2303,990204
276bf7b1b0225027132468e4d108ed2e8539495491d4afeadcbb67788ebc3fb8,990214,2020-09-30 12:41:06 UTC,10000,0,false,10000,0
8b2f80d55a1611d476bec776f309e2f79d449870f18f55a69f2854a8ccb45b58,990214,2020-09-30 12:41:06 UTC,873066783,873064247,false,2536,0
2791a1167533ec1dee8540f2786cac3fc9d460b7fa240d93405966c78e90e85a,990214,2020-09-30 12:41:06 UTC,366623238,366620978,false,2260,0
f339c62cc47e03567282376607804fbaa38bc3aaced2fdde11175f504e918635,990214,2020-09-30 12:41:06 UTC,20459330,20453330,false,6000,0
99c04b4018cfc8111d870d52fa0f9f8a29f43a5bfc8d078d288ff157b81ae1e1,990213,2020-09-30 12:40:15 UTC,708957840,708955580,false,2260,0
38924794881153ef29e79306aaf34759170d4f62d215f0354984684b557e4601,990213,2020-09-30 12:40:15 UTC,10000,0,false,10000,0
21ee1dfed9f2630a601669b779421d7fba344f282e2b893fbd5fb3a8a8593cb2,990213,2020-09-30 12:40:15 UTC,138894911,138891951,false,2960,0
c42ad4e6e1cad4c96929cad36dc4a004716ffead94ef5583553cbf3fe64f152c,990213,2020-09-30 12:40:15 UTC,499990000,499980000,false,10000,0
c0122ad8d8b6f7a3d37204686318486edf7c6b4497b11c6bef51fc3cce166a9e,990213,2020-09-30 12:40:15 UTC,506796813,506768307,false,28506,990202
d192c42bb6db56f7cee6d5b14e55dcc57cc075a8d6a3118367a9768ee29d8768,990213,2020-09-30 12:40:15 UTC,500002960,499992960,false,10000,0
196ed3d7b25cbf24382e20bcd7ca5c7886136ea4860a47b4dabe5cce4c1bf29e,990213,2020-09-30 12:40:15 UTC,2194429753,2194399753,false,30000,0
b236d73b6bed55d0917fdc93813efe95f3782003c1390f2c42763ab62d6a682b,990213,2020-09-30 12:40:15 UTC,873072783,873066783,false,6000,0
0d8e199e847939166d77f681ef61adb5df0dc0380b9afbd3edda8813adde32f3,990213,2020-09-30 12:40:15 UTC,39905058,39895653,false,9405,0
fa2e62b8952b5b84a84e822b52a599ab20b7cb541d0f401366cb1b3f68f03652,990213,2020-09-30 12:40:15 UTC,1459299028,1459217139,false,81889,990202
3c509077b16a95efaabd687c326b905200248f1ff4aac1b5dee0c003751ab5fd,990212,2020-09-30 12:37:42 UTC,1385461224,1385458920,false,2304,990201
27496fcc92928b348ffd4784fe2d895bb9264951c54127cc10d8f95044f83fa7,990212,2020-09-30 12:37:42 UTC,10000,0,false,10000,0
54c4311c22aa65240c2a683ea793a95b53da95acb100d4deadb378f958df6e1d,990212,2020-09-30 12:37:42 UTC,980452726,980449326,false,3400,0
cf01c0aa7fdb2323df46e79678a8f993bcba36de720a67828f507c244f5884a0,990212,2020-09-30 12:37:42 UTC,719503074,719500770,false,2304,990164
ebc59c02fdff7c7a8b166835055f6b914d3b779e2b10981cdbd369551d036954,990212,2020-09-30 12:37:42 UTC,1462544469,1462542019,false,2450,0
f988c79af050c103019dcb8792a411311580acfe02bc5ab88b577506150c6ef5,990212,2020-09-30 12:37:42 UTC,40001422,39992017,false,9405,0
d62aeaa1d70b35465d83daf2cc7bfb98fbccb1cf497898b7704e269bb886fd1f,990212,2020-09-30 12:37:42 UTC,3005787077,3005767077,false,20000,0
237e1fb9c76a0c2bf025088a732f7cc2e0032b25ac06c3e1d122866b6e90d6e3,990212,2020-09-30 12:37:42 UTC,722971,712971,false,10000,0
bbce5cbb43deebaaf40ae0ed90e035a4b32e2bc59673249d14f60fee319b8ede,990212,2020-09-30 12:37:42 UTC,39933653,39924248,false,9405,0
44a7f4a1e2529db35b04ab5955e3a2465ce134c0509a4ff1e08d07cc0694267c,990212,2020-09-30 12:37:42 UTC,167486030336,167486028042,false,2294,990201
2e8b28cc2b6b119a8ccdc32af4a80762dc7515e93a5c744a13af7d86b58bcc3d,990212,2020-09-30 12:37:42 UTC,1009440,1006990,false,2450,0
470eacacc65c997cb80922c8faf8a4de9e7577fbf3ffef5e24f6e06c1e824867,990212,2020-09-30 12:37:42 UTC,500000000,499990000,false,10000,0
67478f671fb7b82c4a7e285f604c235a1bd3e86191ee6777ad6204946e7ccaac,990212,2020-09-30 12:37:42 UTC,10000,0,false,10000,0
2212f2e277e7d335c40aceaf81ffbef7b83fbf6129ed9de09d44053f36b06f29,990212,2020-09-30 12:37:42 UTC,1836049053,1836045653,false,3400,0
95b35ae727d1bdd9078e41c1ea7a36ed3cfd2032f2f685b8bf2f493350e1cc72,990212,2020-09-30 12:37:42 UTC,10000,0,false,10000,0
0ca7d78ca981be8e801882fcbdad092c2233b18abf08cb8df5cc6fcef008607e,990211,2020-09-30 12:30:42 UTC,1460472963,1460406423,false,66540,990200
388d7cd7a64b35f0b3b0869ae006f3968c5c693bbf6f69f9e3ac7b6ad6013fbd,990211,2020-09-30 12:30:42 UTC,507111376,507093723,false,17653,990200
624ebaf4a4e3b6efd6ba81ce761a63619f047e6fdd7f8fe205ae618b5b8a0bbb,990211,2020-09-30 12:30:42 UTC,499990000,499980000,false,10000,0
8cde057b3302db6c8c93f71044480839b4a6b6e6f31e832485488c481c1ea41e,990211,2020-09-30 12:30:42 UTC,10000,0,false,10000,0
fd8248f3c74a08999574d13f8885061f564026dd20364088868dc1bdf0879fae,990211,2020-09-30 12:30:42 UTC,319000000,318998080,false,1920,0
41dfaf3f4bc5f2476240b2d206dadf19701750a59e58a9fdfe8c5958a4839fb6,990209,2020-09-30 12:29:29 UTC,100000000,99997550,false,2450,0
c8541c295458c3217aa548d9febaad328287cd9155cc1218c8c9ef35eb79f6a5,990209,2020-09-30 12:29:29 UTC,180899242,180895975,false,3267,0
cb45a5107187978db027a8fa66f92f0845bde0ff1657e4ca8acd9c26d5167a07,990209,2020-09-30 12:29:29 UTC,488050749,488040749,false,10000,0
e0311f5a03e869c1049d959634eaa4da61240b4256e180bd60d4819b8a877ccb,990208,2020-09-30 12:28:54 UTC,82041000,82031000,false,10000,0
f9427c0abf9d62c02b742bfd578ae6c81e6c510259f6043584cbbdbc9156044b,990208,2020-09-30 12:28:54 UTC,10000,0,false,10000,0
7682bee35c64af49325aaf4ef3f641b6c693f53bb208e259f67b90f9bd2f551d,990208,2020-09-30 12:28:54 UTC,19875878001,19875868001,false,10000,0
aa46f04fd33ae1e020b5fa06d5c23c29d11a9e1142c787de585f632aeb62e13e,990208,2020-09-30 12:28:54 UTC,20884,10884,false,10000,0
89989434adf34d604d2b1cf64356a95c9cf04f1d184172051bfe1d9268a225a7,990207,2020-09-30 12:27:48 UTC,500000000,499990000,false,10000,0
fdbf3efd0a23ef1c5f5c688576903389fd0933c9ef78cbf777295d15babf22db,990206,2020-09-30 12:27:06 UTC,10000,0,false,10000,0
1c713eea001087bd021ba2744dff6113bf6a5e1db84dbb3d3ddbe1ca558eaa44,990206,2020-09-30 12:27:06 UTC,61952634,61942634,false,10000,0
837a7e8335b5eb29439e095e2eb95b0190a5ade7e481c10887d394abb05c2cd3,990206,2020-09-30 12:27:06 UTC,40058336,40048931,false,9405,0
8403a6468e70906d6a6a562754a7f9e0aa13a4eec2acf902bdbc0e080ecaa69d,990206,2020-09-30 12:27:06 UTC,499980000,499970000,false,10000,0
ae00079f0a61055f7eeb55d8bb788d259c054fb2bb2d214ee6f6d2d8aab03516,990206,2020-09-30 12:27:06 UTC,40029945,40020540,false,9405,0
8e2ac6fb23c282e5e982497c9eddb281b66533b17b2d9cff94f532b70e73af99,990206,2020-09-30 12:27:06 UTC,836197100,836194840,false,2260,0
1e3c1bf9e4af134ae87e363186efe34508a7654c0da435a1750fe34f56ed7b43,990205,2020-09-30 12:26:18 UTC,46942480,46937280,false,5200,0
d26c2dffc24e05feed62c2f381076f27a53e0ba34813daf0ac508295be580713,990205,2020-09-30 12:26:18 UTC,132463381,132460421,false,2960,0
8587bb9370745f1d1e0702a4459312ff35ed691527532f13aa7340914ff0fb89,990205,2020-09-30 12:26:18 UTC,162924867,162849635,false,75232,0
e64bd02457c3d5d689d83ed504efa06e83eda73bc30387e93b0bd44aead36041,990204,2020-09-30 12:26:03 UTC,10000,0,false,10000,0
7b4bb0796db16c7bd154a44455be057f047419e056b710b4200b56f4f96ac7ed,990203,2020-09-30 12:24:25 UTC,1401392411,1401388715,false,3696,990192
b745eadcf18718963ec5cd505e394be049dca85b20c6e97191e5e46dd47ee682,990203,2020-09-30 12:24:25 UTC,411706415,411704155,false,2260,0
f4dea2dec7010c57c1ee40f2a1e2aa2a2ff73af9ebdcdbc6d442e716f06e1732,990202,2020-09-30 12:23:44 UTC,1399970000,1399960000,false,10000,0
5def02377a9b4cc7c08a24e208510b88cd6cd5dc5acef6a71f35d5abbe4b8edb,990202,2020-09-30 12:23:44 UTC,10000,0,false,10000,0
a43347db8a9a26fb2f2b7fc6b1c257c900c04ef80b090bc7b6a21df3990a8a8c,990202,2020-09-30 12:23:44 UTC,3299942200,3295210000,false,4732200,990190
15a65a211a63102490345b028cb7ea16833a5ffd939628ee17796abe48a84e87,990202,2020-09-30 12:23:44 UTC,71807732,71805428,false,2304,990191
5ad43357fa3f68341a64b6541394f0819ce33e4df95a8b344cd20f0cfc3b6f75,990201,2020-09-30 12:22:15 UTC,10000,0,false,10000,0
800703faf3556424a5f6e5008a929687c188ebe3d0284076026fed86d06fb741,990200,2020-09-30 12:21:50 UTC,507690260,507668789,false,21471,990189
f13d2176a6d4f98afaf93801ebe3e248b5b6db4bcdb723a394f3139c124161ba,990200,2020-09-30 12:21:50 UTC,1461922111,1461849853,false,72258,990189
b433b784bf1bd4e6993ddb94393b08d46b579ab9d0417f65cd5d40c15922118b,990200,2020-09-30 12:21:50 UTC,279802507,279778664,false,23843,0
3294f884bd0c51feb52312afcb3fc8954484dbacb6a278f86098a86c340fbb79,990200,2020-09-30 12:21:50 UTC,88000000000,87999900000,false,100000,990189
0ef5519c67e6633786bf0ca15046ff904d71fd63d4386db389449817d5afd995,990200,2020-09-30 12:21:50 UTC,71447413,71445153,false,2260,0
e953872db63dc5dbda8e205d0bfc12a51b76f2b4c2b83c39d4615e6c61929fdb,990200,2020-09-30 12:21:50 UTC,10000,0,false,10000,0
1366bbf431e0a07fe20888e6b0a94d2f7156e13a4968835af3fc624abe331510,990200,2020-09-30 12:21:50 UTC,14586778,14580308,false,6470,990189
104b5014355cadb0f50aeea0fad4e46a86d1ddd274d6474e3a34a6b11722401e,990199,2020-09-30 12:19:12 UTC,23799500000,23799497696,false,2304,990137
9bd429fa9450a69a779c9258fcfccc8ca6c5617a9074afea660525581c768ad2,990199,2020-09-30 12:19:12 UTC,139038195,139035235,false,2960,0
ba9ad5201bdbde4e38986d75ee1afed9e30f36bf08e0c9ad427bffcc13851b22,990199,2020-09-30 12:19:12 UTC,999495392,999493088,false,2304,990187
7a93ced240f6734ad311f3a7a3cbbe9bdd082f47feb1d1746baa2ffadeb54069,990199,2020-09-30 12:19:12 UTC,4799497696,4799495392,false,2304,990187
6fb40147cd60b71557c0ac7faf05a75636ec8fa16270c9d68569ad545bf49fd0,990199,2020-09-30 12:19:12 UTC,500000000,499990000,false,10000,0
42dd2925fb72dd32c2df70197134b180bce0ed01ed2e150dc838f6a2abf969a0,990199,2020-09-30 12:19:12 UTC,199493088,199490784,false,2304,990187
4453d91b005527e2439fe4ae51819e09ce015504532f5847535c6ab4e0dec96f,990198,2020-09-30 12:18:23 UTC,5776107885,5776092305,false,15580,0
28f451004a1c0fcbbf6a57d508ff3c87400dfcd06fde41345b4ad15c3006f3ff,990198,2020-09-30 12:18:23 UTC,494152841,494137261,false,15580,0
b365c8d3453ef2c47a19664c57b906519e1e61298c39ab0f32748244049e3281,990198,2020-09-30 12:18:23 UTC,137864287,137861837,false,2450,0
e045b87605dd4e57182dc4d92a5fd149f5f3f047f98f2c34bf3a00fee912b4ee,990198,2020-09-30 12:18:23 UTC,1303327150,1303311570,false,15580,0
cae7dd2535cd9a8f1a6f78f3b56d48de9921003a5bad4be2170daffb216e75ed,990198,2020-09-30 12:18:23 UTC,3523255814,3523240234,false,15580,0
966c1342813264750dbecd5ffb9261446150ec697128b50c95222caf199c9278,990198,2020-09-30 12:18:23 UTC,599525923,599510343,false,15580,0
13ed64b34f17bf3e48676c60a4a7e29fa79225ff67020ec5f67d9a8be8d8ec1b,990197,2020-09-30 12:17:32 UTC,867573961,867558381,false,15580,0
621d4f6cbc6097f3f0fad13d63bbd5595cafdb062a43ded8a4feac5e8def266a,990197,2020-09-30 12:17:32 UTC,10000,0,false,10000,0
cd353c49eb83b88431223a7a17cc9e60402bdaff18b9d55bda854fba1f9fb5a9,990197,2020-09-30 12:17:32 UTC,1692855367,1692839787,false,15580,0
1643af14ced49861f520ab3f3b5990bc0aa413d20d0ab9fd6def559572d16281,990197,2020-09-30 12:17:32 UTC,3934521988,3934506408,false,15580,0
575fc831326c58a81997d6d95189fab9cc0e697169e378ac8230da3247110d2f,990197,2020-09-30 12:17:32 UTC,2101513377,2101497797,false,15580,0
59ccb8d289cabda457f819eaa738800389ac09d13d58392049fc457def74af3d,990197,2020-09-30 12:17:32 UTC,797601001,797585421,false,15580,0
f72f62444e30da848647495a6b6f67aabbca45f71a0ce270ae1222758093cdd3,990197,2020-09-30 12:17:32 UTC,2610992856,2610977276,false,15580,0
b51d358c5b5f2f18ec7515e259c80f55ccd039bf866803f3adbd59cb738198f5,990197,2020-09-30 12:17:32 UTC,1694933990,1694918410,false,15580,0
19cecc2f0c0a444f65c62e14317786d8fbda0c6e4d8c677b70212cdca367c7f3,990197,2020-09-30 12:17:32 UTC,2154293647,2154278067,false,15580,0
e94b0d8eb6230abedd6717e182ecf41a816b25026214968c6de6d882029b1117,990197,2020-09-30 12:17:32 UTC,1413179820,1413164240,false,15580,0
574b90e460f8212d5407c15394edaf45d4e4168481b8e2ac97ca0a0d50008ce0,990197,2020-09-30 12:17:32 UTC,10000,0,false,10000,0
8fd1a5fe196372ce7c51f34cc626f2b2e4ded1be9a2674cd20a17700d1ada04a,990197,2020-09-30 12:17:32 UTC,96406254097,96406238517,false,15580,0
d2b129b8f79a9c9ef7a1de06eef734b79a815a6a2e34ed23bcf4c0d08720fd22,990197,2020-09-30 12:17:32 UTC,894740563,894724983,false,15580,0
585e1e2f67941c43652c0240ed4dba4d9ce62b130822183c361394e44d92568a,990197,2020-09-30 12:17:32 UTC,490605201,490589621,false,15580,0
cee76684706bb7dc7d91c4d658753c2479da04fe3de9a9ea83d19acf0c0bdc07,990197,2020-09-30 12:17:32 UTC,91290026,91287732,false,2294,990185
1a81cba3f771a7e6add5f5ba34a19fb422587036fc1098ceb23de21fda55856a,990197,2020-09-30 12:17:32 UTC,7900096474,7899706943,false,389531,0
f24c0b9bfdeb89be8bccee3edf5577f1257f0e49ad6b48921fb3789f1e860ca2,990197,2020-09-30 12:17:32 UTC,1877193653,1877178073,false,15580,0
0a2993fc3ed67f0d4d2f363fa60b6b174bcc569133812c89505c1108cc3fc382,990197,2020-09-30 12:17:32 UTC,1063891666,1063876086,false,15580,0
5ea7172c4d4be1f1717208f02d2062250259a89ac4464c7616891f29bd937348,990195,2020-09-30 12:14:50 UTC,499990000,499980000,false,10000,0
849ae2230f0fe50700dbc359c1f1c2a65725bdaa6e040824119c04cf68635a3f,990193,2020-09-30 12:13:52 UTC,10000,0,false,10000,0
562dc7bee192a02eebf587c244e4d8f47d969c275d5808380eaf655d4581a081,990193,2020-09-30 12:13:52 UTC,19726985354,19726975354,false,10000,0
ea550664f38ac7cdbdd316b4b6aa9a36cbbd25b08db0182fbf74e5c0d86dedf8,990193,2020-09-30 12:13:52 UTC,1049847000,1049837000,false,10000,0
359ac3ed50a9b5129d96eaac1e3da56db18f99ce288fe36026cc1d2012c443f2,990193,2020-09-30 12:13:52 UTC,915084563,915080823,false,3740,0
6a46c1fb8890e0c4a6f4adac77b044f57014ce4bf7f94a75bf323888292e65a5,990192,2020-09-30 12:12:35 UTC,499980000,499970000,false,10000,0
11044d27e13a30c4ea07bf02057a4a6d9e2d425d044b0af8e696f2aac1e4ef7b,990192,2020-09-30 12:12:35 UTC,500000000,499990000,false,10000,0
c20292e3941d5fbbbad0438f4654bba4f5494e4363027cd2c7d12e85ba93b35c,990190,2020-09-30 12:11:29 UTC,1015831,1010753,false,5078,990179
6827bd35d7499abba2cc1ec7c7efa518231e17856888a287f8fa6c000ae3a8b2,990190,2020-09-30 12:11:29 UTC,10000,0,false,10000,0
064951a2c9a636c78a5f95713401069e27d7c35cf2b33a5885cc45a4e80a8908,990190,2020-09-30 12:11:29 UTC,102304,101158,false,1146,0
69896176febb3a3696b2d033d6f59debf4908fa0e55de90877a9ded228bea112,990189,2020-09-30 12:11:02 UTC,399710355,399635123,false,75232,0
7733cf7a03bf6e47cc3a364247e708c6761655e472cbb6d1191db906cf3dcfac,990189,2020-09-30 12:11:02 UTC,10000,0,false,10000,0
34beb7f4998acc47652eea752bbd8c369d0d35178078ee2a209d9b25da98fd9d,990189,2020-09-30 12:11:02 UTC,839979443,839977115,false,2328,0
9cff796139c4a65a08c914ca629eaec2f17c4b8f9bdc67b2c5df3165d637bf48,990189,2020-09-30 12:11:02 UTC,500010000,500000000,false,10000,0
0aa499ee26b4f7d3a98b380f6ecabe1932a37eb5a76ee6ed85ff03f23587695b,990189,2020-09-30 12:11:02 UTC,51488654,51461312,false,27342,0
5f296234149ffe87f9266ffd515255418b83988f5d1b74aa9718295d1241d8dd,990189,2020-09-30 12:11:02 UTC,20192515,20182515,false,10000,0
58bf9c5e7282bcae427d9847d0f7d1f8f9cdcf6634b544f89f9f477dd2ca2ffb,990189,2020-09-30 12:11:02 UTC,10000,0,false,10000,0
7769b8358921b0082d7b7a1f3cb179689a71e68f3e973fb7d6de4bfe202d1d99,990189,2020-09-30 12:11:02 UTC,17260122,17257212,false,2910,0
875b98e41a815aab76955fd83c1523a7c9ca86ab894035d078d5bf20fc5c35c6,990189,2020-09-30 12:11:02 UTC,186332519,186329559,false,2960,0
fff3dbf85d21fbe93a7db1cfdd29dc2aa18f5c3523aa68770eac223cc0f07abc,990189,2020-09-30 12:11:02 UTC,1479455800,1479452010,false,3790,0
a4f3299497ca9198b2909ff45725eede3b25198d96b640cd127ff12f33a5b07a,990189,2020-09-30 12:11:02 UTC,508247088,508220820,false,26268,990178
d33eeaa5e792e34c964f3468c11dd494679376a3b0d6962292720edf1608a751,990189,2020-09-30 12:11:02 UTC,40213308,40203903,false,9405,0
399b6c0b2ac91c5f55e905ab028d11dc0cea055b3673dfc96433f473f8e61dc2,990189,2020-09-30 12:11:02 UTC,10000,0,false,10000,0
fdf0599299272c32c1add065c0769a8ed90be7837a96d7e92984b29f965ae81b,990189,2020-09-30 12:11:02 UTC,515543954,515542808,false,1146,0
1904816b2d62a2a97d0b2cadbbd271ad73549e59d854257762bbef31e62aad67,990189,2020-09-30 12:11:02 UTC,1463288557,1463214023,false,74534,990178
3795bb66742286d7698639eccb2065d81f95b23af96d023f0a8d76179f98ba48,990189,2020-09-30 12:11:02 UTC,14501457940,14501447940,false,10000,0
436ea4a8b89af0df096420749c859acd2eed9b3de6299c916483e4c837f20678,990189,2020-09-30 12:11:02 UTC,499991485,499981485,false,10000,0
4e95413071904445ce32872c1e4aaf2563e89c12fb9f328c362b67c35802096b,990189,2020-09-30 12:11:02 UTC,40170045,40160640,false,9405,0
a0bfe008499544ae3bd41023da55accd5c8fd52771670e5ab3e8a10c8a04f0a8,990189,2020-09-30 12:11:02 UTC,10000,0,false,10000,0
797606ed2b3bbcae4f5ef2ccee52fbb15a94d3488f1e746176c98a6529c8577e,990187,2020-09-30 12:06:29 UTC,789559397,789556783,false,2614,990176
7d3d6ba9ae451def1c2280d77463c0dde3b20e59dec0a1741eb5c9125e66abd1,990187,2020-09-30 12:06:29 UTC,6095430839,6095414810,false,16029,0
e6de450d0d13abb195cc813f9c9ce69471feb3a3a741a63e731cb6bcc637f3f3,990187,2020-09-30 12:06:29 UTC,179941967,179940967,false,1000,0
12695a319b10078d1b29cfaadb148204f72be22bfdbc2c019099b66067701433,990187,2020-09-30 12:06:29 UTC,10000,0,false,10000,0
581745ef5e90aea536e3ec6cdd6a34890edd32b519e2932d844da9509cea27d8,990187,2020-09-30 12:06:29 UTC,40326155,40316751,false,9404,0
ece2078dac0d2670fb1224f2d9eb22ab89ce918bd29a806a6f429d12bd353f04,990187,2020-09-30 12:06:29 UTC,100916598,100914338,false,2260,0
ad3224a79fd2cb2b55a9b7db60371218bc955e9f8b39611344bf4cc9f322b9a3,990187,2020-09-30 12:06:29 UTC,139237994,139234727,false,3267,0
a2ac66f411887ca00c7892946988b1901d6853f54519829788dc11fe10edbdb6,990187,2020-09-30 12:06:29 UTC,3500733294,3500723294,false,10000,0
1de8cc7a8916bc0defb0b3505c9580309fa19777207e18f76145fcaa83a08857,990187,2020-09-30 12:06:29 UTC,112500000,112497464,false,2536,0
60594f7fab0008b2b8cf4ed4350edd3e5118041f3c8f60ac543c874bed9be6c9,990187,2020-09-30 12:06:29 UTC,245797844177,245797834177,false,10000,0
de8997cff2794a67f4616221262e9a4016c9c3db802ffe79197dccb0de09b564,990187,2020-09-30 12:06:29 UTC,23054493,23053347,false,1146,0
d867c89d0d1d2be310b1c7be7d2ce6e6ab867c030adadf0ff900cbc8b9d62680,990187,2020-09-30 12:06:29 UTC,112610000,112606260,false,3740,0
0b13aea9a01f3222c7ff08519db9bed2d9a612767757a6ad9554d07f612500e3,990187,2020-09-30 12:06:29 UTC,963436360,963434100,false,2260,0
b30ce1169c3f6b803cbcf7acf7f6f314d0e4873f5161164a15d4d8aef1e14bc7,990187,2020-09-30 12:06:29 UTC,2500455221,2500445221,false,10000,0
90edecaafb1347ab8c322b0515fd6ada6fbcc5823025a692e6f3bfec31360681,990187,2020-09-30 12:06:29 UTC,167586949237,167586946934,false,2303,990176
b21b7c829b4106bcc8e7d5673c7f98dac178342633dd025ec2625b40148888a0,990187,2020-09-30 12:06:29 UTC,132915100,132912140,false,2960,0
6922d71c562edd0fabf27e828d25e6dbba3d97753e22717f06bcb8b670fbb2d4,990187,2020-09-30 12:06:29 UTC,40408675,40399271,false,9404,0
caa803ddf15a510c4e340be7dc909837f8f9be3212f9522bdd251a3bea582fb7,990187,2020-09-30 12:06:29 UTC,70677195,70673795,false,3400,0
094733cdcf57d767e2e51d4658cba9e789ee1e0c7008684a7d4a8b93035a3fe4,990187,2020-09-30 12:06:29 UTC,10000,0,false,10000,0
e430602c329fbb1d90373001c1da40b034f32a5a803fe44be086191aace99878,990186,2020-09-30 12:01:53 UTC,10000,0,false,10000,0
4ad92b1bdb0789dc6b2a6dce5d452c1e5182032428c822866c7dafebe67ba64d,990186,2020-09-30 12:01:53 UTC,168083527868,168083525565,false,2303,990175
55d16de32f474e65c6725e26fc63fadc0e38467ba5d79a5436dfd5c6b612edb0,990186,2020-09-30 12:01:53 UTC,38720000,38710000,false,10000,0
3853f25c5155154c617876447d6fa0aa180d54c261ae952e3d3d9f28bb15f374,990186,2020-09-30 12:01:53 UTC,214179470,214176847,false,2623,990174
d0d9e501f4d20d41bf95a05a15b0ecc2a887dda13c50bcc2c0f0de15a947477c,990186,2020-09-30 12:01:53 UTC,3910665088,3910661515,false,3573,990175
5fc35c9c90c9cff0d655f56f6257b90eecf6f81cf6a16ead64319c24b8d13ffa,990186,2020-09-30 12:01:53 UTC,250,0,false,250,0
ba32a5c5438907946b1e41d5c406bf8bd86f0e10e7205708ef4003ea3ea0e996,990186,2020-09-30 12:01:53 UTC,456600985,456598725,false,2260,0
ba31a5ed98d3036fe7b7386eb0f2fc86b3c9b7abb3b57381c25e79b15ceeaf3b,990185,2020-09-30 12:00:11 UTC,186633159,186630199,false,2960,0
27e7f65c7bb1d38cbae2fcbbedd01c3ffbc9c3ff794b6cf96f5cb2f571678e75,990185,2020-09-30 12:00:11 UTC,508693407,508672248,false,21159,990152
6fdbcb87f98812dd406206f21e31f7fc26f36e1dee7941857683ad0bbba19eee,990185,2020-09-30 12:00:11 UTC,499990000,499980000,false,10000,0
9aeea0c7325111aabf917529da4fcb46d1fd8371afd3a245d21a3a845db8e97b,990185,2020-09-30 12:00:11 UTC,10000,0,false,10000,0
d8d594cd9b51db8ede2f59716a968845ff30d1df4eb0178b42325bbf5c888a77,990185,2020-09-30 12:00:11 UTC,1465051985,1464977101,false,74884,990174
9717ed66e1a7371538b49f43b71f7f2c0734e7191850b1f9e78d8dce8e96910f,990185,2020-09-30 12:00:11 UTC,6245272,6234956,false,10316,990174
28331f76ac4bc005e21bdb9749f5ec5ccd592960459a7d87b69d62d829a1f156,990184,2020-09-30 11:59:08 UTC,10000,0,false,10000,0
86a4baeec3f094d31e375ab1b1e0063345b84427411fabc5ee68b9a85bf0a766,990184,2020-09-30 11:59:08 UTC,250,0,false,250,0
88ddbf9bb1d5955fcb604171d17a59f6a56913e0b6f695fe106c415ab39f6b2e,990184,2020-09-30 11:59:08 UTC,205155486,205132506,false,22980,0
9483a31c3b739a622fc91a3e41c18d318a61f72c99f65928ae070ba048018a26,990183,2020-09-30 11:57:48 UTC,500000000,499990000,false,10000,0
2194e2f4849154b9ed6239d7ae1afaa032c80f4a004a38dd98ac01bf2d1800eb,990183,2020-09-30 11:57:48 UTC,108806776,108794776,false,12000,0
2922a13b66d688c4b3721d7733d8cc8ce6d29034444550b071d27f115019935f,990183,2020-09-30 11:57:48 UTC,52317070,52289728,false,27342,0
fbe8a62e7857624a5a6e661b2096e7a2fceaef39eab8199a6f657b4f3e6336f0,990180,2020-09-30 11:56:43 UTC,19717166183,19717156183,false,10000,0
2b5126187b6c4cf439bcf6f4487614372ae615673fcb49e1a0edfcc901f43b3a,990179,2020-09-30 11:56:25 UTC,10000,0,false,10000,0
6e61635217735611333ccf36f2bf0378b460bfa2a4ecb97b18f5c235e4cfead1,990178,2020-09-30 11:55:42 UTC,1466355757,1466283469,false,72288,990167
959082ec088b8635dcef599b9fdab23921e814677e38198e72f9958cb98fa2a6,990178,2020-09-30 11:55:42 UTC,25182827,25172521,false,10306,990167
76c998fe832879e6c3720e5af242c197c2adf68f70befb75bf543c5cf213cf3a,990178,2020-09-30 11:55:42 UTC,20543949410,20543939410,false,10000,0
1dc69a888d6614597d73992dc540725e0900ed4287702b450aa144ecedbc810b,990178,2020-09-30 11:55:42 UTC,10000,0,false,10000,0
ded99fc013fccf7889c15ec1677168b5eaf4ecefa0280f3c5d99893e249346e2,990178,2020-09-30 11:55:42 UTC,139503011,139499132,false,3879,0
b7a5504676cbe57552be4e8ba873470df71025f0e53aed8e5f5dac09113a0eb6,990178,2020-09-30 11:55:42 UTC,47104008,47094008,false,10000,0
57be28fd9a7460d62e8e284eb03acec7fed297374c6a048ac3ec893811ca70d1,990178,2020-09-30 11:55:42 UTC,10000,0,false,10000,0
bae276caa5d382254020b2b1aeef0eba2861571c73ec54b8a988ee1c610cdf5f,990178,2020-09-30 11:55:42 UTC,250,0,false,250,0
4c2ae09ebbb0d87693022c8691248fb3aa2480ebaaf242f71b06056e5822c64d,990178,2020-09-30 11:55:42 UTC,40653514,40644110,false,9404,0
ab63b34b13593e662a40bdaaed8a291cf67f3115d23b60fa334307ca1aaa8741,990178,2020-09-30 11:55:42 UTC,7271091,7246131,false,24960,0
d6ecbdbaf1e8dc5b3538b230606dbf67f3c0218968aa1e9b54d1bf6bc4b23b69,990178,2020-09-30 11:55:42 UTC,10000,0,false,10000,0
4a37429bb8413b97393dbba3317b591959ef9aaf6436da7bc9a912c9dd78c92d,990178,2020-09-30 11:55:42 UTC,178292329,178290026,false,2303,990167
41b0bfd9fbbc95d5abb644a8963126079f6348b8f1c208316b2a6002993309d6,990178,2020-09-30 11:55:42 UTC,156279966,156249966,false,30000,0
f5dbfa7a74581f405b076ec93ae2c1ce41834f4b8e7d43cdb9e830240a750a75,990178,2020-09-30 11:55:42 UTC,133509742,133505251,false,4491,0
2bad1b0300fd2a6b9f88f084ab3480afe7ca09a3f9ef4fbceb30f262a3b2551a,990178,2020-09-30 11:55:42 UTC,509283621,509257676,false,25945,990167
75c1540dde36c0a4d65b60562fb6d7332be9467e1a0285cd6d51374c07744f92,990178,2020-09-30 11:55:42 UTC,1838962930,1838887706,false,75224,0
820f0b40cbda6ac40729980e81c43dffd999b4a027ddfeec7bd7a1b2815538e8,990178,2020-09-30 11:55:42 UTC,318528193,318505127,false,23066,0
1afd1a91688622f1508b122992c72d69e64275c9e1292f5c3f10effac9ed512c,990177,2020-09-30 11:49:44 UTC,9427344952,9427334316,false,10636,0
9dd3b6a684a02e270a752d03084998ec92ce7399ecd99d9a5cd02180d41f1467,990177,2020-09-30 11:49:44 UTC,250,0,false,250,0
a6b08250b3ddbe61ec1c0402247cc4c3bb1f2fee8106d006e37be8933ececd26,990177,2020-09-30 11:49:44 UTC,170354019582,170354016968,false,2614,990166
7c55068cb198044e9f7cc394264b01265886e013a856fff0a29179f53a6e4e1d,990177,2020-09-30 11:49:44 UTC,40702294,40692890,false,9404,0
639be1c858d935d5694844e057d959f5691ca1a257a59e051ff083deaf156b6d,990177,2020-09-30 11:49:44 UTC,59820084,59814084,false,6000,0
fce208eade616303f8dd676a6b70a99f84792800ef1c87ba6b91b6b9d418e2a1,990177,2020-09-30 11:49:44 UTC,10000,0,false,10000,0
bece8e688b4d51fc95b66bdd38fa4512fb305de2f5da4b3dc14631e5416d3dc2,990177,2020-09-30 11:49:44 UTC,53961224031,53961223931,false,100,990166
abbfba4e8300b0041fb4ae2cb35ab6d680c3b3455beae7d901cdecc34cb555b7,990176,2020-09-30 11:48:25 UTC,45116723,45114463,false,2260,0
bf0b15515338c8f4e22c5e178d32662fd7cb252ab06694e768b746398c5aa653,990176,2020-09-30 11:48:25 UTC,10000,0,false,10000,0
b01cd0e35dd1b30330877553c100ca0c46b5b7b6cd8da025e1908ead60defa8c,990176,2020-09-30 11:48:25 UTC,24999995820,24999993517,false,2303,990165
c88032bf95410dca8885b509c45cf6bf4c31e656dcaaaa0a958fbe6ce0b67df8,990176,2020-09-30 11:48:25 UTC,22263032,22260122,false,2910,0
70ce3d5fb11eabd9f191a4802d67e5200fefb699506fa78d4e6aa2879d312ac0,990176,2020-09-30 11:48:25 UTC,250,0,false,250,0
953ae210ebd77ceea4a7d01f3b74fa816119761174209376a2aa1a570e7bdc24,990176,2020-09-30 11:48:25 UTC,40773756,40764352,false,9404,0
3eb9cef334f05abd34950aa0b976cf7a3e2dfdc000da4adb4fd654d7e4809cac,990176,2020-09-30 11:48:25 UTC,20543959410,20543949410,false,10000,0
2247a255c28cb3488a64f9a28e0971f23c47cb1846ae0f24fd502179aa9f5204,990176,2020-09-30 11:48:25 UTC,4200000000,4199997550,false,2450,0
e062aad6f68273ec3c98fb5c8b2ca5af2c2bf5125a30dce2415b3292a7197b62,990176,2020-09-30 11:48:25 UTC,51112130,51086120,false,26010,0
f89af839813440fc4a6835df74f962d5b812544df14710ab2f74b5943f04fd50,990176,2020-09-30 11:48:25 UTC,912690000,912680000,false,10000,0
c7b3efc2f34f2d92db90aa4ec8bde2004503de53b48c09afb286a0bfb818cf2c,990174,2020-09-30 11:45:39 UTC,20555559051,20555549051,false,10000,0
725a552d525f00700c970037dce0060f9eb90b7f1b34729ea6eb5a40e2f7e77f,990174,2020-09-30 11:45:39 UTC,40806411,40797007,false,9404,0
47033e935fd4143a60dbbda6385339a6d5a5bb25d0ff9d94b498b555f98239d7,990174,2020-09-30 11:45:39 UTC,186792945,186789985,false,2960,0
2ed8115a6052dceba763b0df5c61c9d726f59e466bc25b3afaa9c37c0b51df73,990174,2020-09-30 11:45:39 UTC,13939800000,13939798418,false,1582,0
462481e73bd57b4df47345d352d897f542aa9aea47727ee6d119436b6b340a3b,990174,2020-09-30 11:45:39 UTC,10000,0,false,10000,0
20cb13239e19678012b39f43479379e39d1367ef2add9b9bb6cc521c0816a734,990174,2020-09-30 11:45:39 UTC,1090613620,1090611360,false,2260,0
562cb785b6fd44ae824cf75dd6ffe157860f76a743c6aa72d86bdb37f108ec27,990173,2020-09-30 11:43:15 UTC,40845204,40835800,false,9404,0
232e870a0857ace24ad1269a0cb99483e08586d63044ec1d07db6dfde2216b9d,990173,2020-09-30 11:43:15 UTC,40885782,40876378,false,9404,0
c84b306b5a9b3aa12669e9919a98b77066adb2a140e8981f2a3240daa30fe9a6,990173,2020-09-30 11:43:15 UTC,10000,0,false,10000,0
a9ad12ab77aa07275a5f47725f11a5daef2fda6a380278d0acf4e0878ed2e586,990173,2020-09-30 11:43:15 UTC,24534237,24505574,false,28663,990160
ccf5643661056b991ba42735a4290376c6d8ee6d84d7940fcbac297d2cf18a44,990173,2020-09-30 11:43:15 UTC,8486961734,8486946154,false,15580,0
e01f8f208b27193f9148287e8836e3f9812a1a8d99e0cc66206b40687992413e,990173,2020-09-30 11:43:15 UTC,73910000,73900000,false,10000,0
ceb273876073ce7e1921625a6adcb8136cdcd59026826693191fab1b13dba0ff,990172,2020-09-30 11:42:21 UTC,20555569051,20555559051,false,10000,0
c14644016b1c4fe5f7f05c0f42c11be9b2feabf41c927bea3664f67b357387c1,990172,2020-09-30 11:42:21 UTC,6291963527,6291961224,false,2303,990160
2ef36e50d6fd9e7c435d1c5d468f968b03e3b3238cbc92616b160fa4c51571b2,990171,2020-09-30 11:41:55 UTC,40965401,40955997,false,9404,0
8618c8516ed215cf18251b1438f6c8073366f86407ceec44860f457b4eb1b00d,990171,2020-09-30 11:41:55 UTC,10000,0,false,10000,0
63bb8efd52d71bbd588f2ccf963c9a28bd6abeefbebba8001043da5542a0448a,990171,2020-09-30 11:41:55 UTC,50470896,50446218,false,24678,0
947cce5e87d1d24c11cba4073c46bb5656f0e8393e83ed4679663e4c05c14e66,990171,2020-09-30 11:41:55 UTC,100000000,99997550,false,2450,0
914368b8d42228a0e9b3c9d447c8b3846f88d594f8f0b01e344601549cb55e0f,990170,2020-09-30 11:40:30 UTC,20918345720,20918335720,false,10000,0
42fd7ca8aaaf4267ec165f0d741727c3b8c9f9a0d6c8894495215e2769178a3b,990170,2020-09-30 11:40:30 UTC,1467549764,1467478445,false,71319,990159
ecc77504daccb37de97fd9f8cb076db34c456adb1d23c49f387fedfc0a546b88,990170,2020-09-30 11:40:30 UTC,509649233,509629043,false,20190,990159
9ca4325ea797c19ae7a9ea50a9ed4d9deb57a4027bcf35b9167ab4e325a018f7,990169,2020-09-30 11:39:26 UTC,10000,0,false,10000,0
1b428aa15d44327a46d700c9cc1fd283a02106977b4d0361a385f62ce8aa559a,990169,2020-09-30 11:39:26 UTC,2420010000,2420000000,false,10000,0
d20d71267ca66388014a78cc3241b899a3a910b948567ba9a2db822d3ef81b2f,990169,2020-09-30 11:39:26 UTC,139707515,139704555,false,2960,0
88a2b3afe23047c44501d6e3767a7b9a3e411710214ed09dd779cf6726696449,990168,2020-09-30 11:38:54 UTC,501557876,501554136,false,3740,0
50b07f38d10d5b74e459c0e2d42e943f583679b6dfa7937fbaabab0a93920bf9,990168,2020-09-30 11:38:54 UTC,2916671276,2916663433,false,7843,0
ef9b4139ddbbaea18e588378c5a9e06e655b77d40558bc0f46c6d8b008518c57,990168,2020-09-30 11:38:54 UTC,133686241,133683281,false,2960,0
bbc03c3449cb2d1126092991fa71235026744b6e701726a7cbb9b136be0a19bb,990168,2020-09-30 11:38:54 UTC,20918355720,20918345720,false,10000,0
ddd1b053e2e4a1fb8f1f23be08c9a986b2971fd069433e116042782304488f1e,990168,2020-09-30 11:38:54 UTC,250,0,false,250,0
e1ee96fb0318261a1e597ed520a28441c5885821b48a4607a92e63a6e2c5824f,990168,2020-09-30 11:38:54 UTC,10000,0,false,10000,0
0c62d2822d565d38bd245c235b224c809a4fc4ba94e5997d6fc5910a8a655742,990168,2020-09-30 11:38:54 UTC,5245346895,5245344635,false,2260,0
b2bbb7b6e9570c515b9de25d1a28c1352fa56e5351958a0455f19496553ddbc8,990168,2020-09-30 11:38:54 UTC,10000,0,false,10000,0
ad205debe288b7eb7171391bd16608737e7abbabfdca9672894b6a058343bd42,990168,2020-09-30 11:38:54 UTC,41000850,40991446,false,9404,0
a05d13bfde5eff8fc4175d2a6cbeb4fadb8cf682502da9b24d9494808144a85f,990168,2020-09-30 11:38:54 UTC,10000,0,false,10000,0
4a28700d001606f95c7e23ccdda61d72d7668c94fcb7c5907be7251de906bbfc,990168,2020-09-30 11:38:54 UTC,10000,0,false,10000,0
98694fca914971540de5e3ae4e32f319053f165435156c171ea1059a070cec55,990168,2020-09-30 11:38:54 UTC,250143602,249930676,false,212926,0
6ff86e1717822746b4f7ffd881b8df5d9ef10192205782eb756278af217c7c1b,990168,2020-09-30 11:38:54 UTC,100000000000,99999900000,false,100000,990157
e22be203b0f53b7df33d2f08181b62f88157fa9fc3a7af276fce63b98f27c749,990166,2020-09-30 11:31:46 UTC,1745467000,1745457000,false,10000,0
1864cc6899a7510aa3de9a26121127cfbdb4ef3ca1155c06da6ebbd45559f629,990166,2020-09-30 11:31:46 UTC,2195219861,2195219790,false,71,0
bfaaf6008ddb5e7e6d2f5ad943c27fd7c135f577e46707964c4fd9aaf538518c,990166,2020-09-30 11:31:46 UTC,499980000,499970000,false,10000,0
a271de4aab76e5d77efe0fe69921dc2327b9f93646d78184ab598d77be318de5,990166,2020-09-30 11:31:46 UTC,1026231851,1026131851,false,100000,0
697ef390fef91f507d7dd047004102ae76ba739d3f6ccee44f53a1548b41f6c9,990166,2020-09-30 11:31:46 UTC,11849228,11844141,false,5087,990155
be82f5e2022df5f8c1f41fc2916937ec910698c1dfacec91ac2687266a7419fb,990166,2020-09-30 11:31:46 UTC,10000,0,false,10000,0
3214589d7c720d79f8de88d1b6f5e4ef440ad3cc6a26724b166b2abd976a6954,990166,2020-09-30 11:31:46 UTC,500002260,499992260,false,10000,0
2561109fda10d7c78fec5d4974a7fd12f14ff37ee17612a1e47f978a0a0fde82,990166,2020-09-30 11:31:46 UTC,510133608,510111483,false,22125,990155
30c830497e8f8cde2ab4e7110deae81141afe22130239ec63090b1a10768702a,990166,2020-09-30 11:31:46 UTC,1469256391,1469185371,false,71020,990155
43a6eda9c27a85862920f80663fc2b5c37e852727343568274e7976bc85adf66,990166,2020-09-30 11:31:46 UTC,121527786,121526826,false,960,0
35c8053e6eaa482a6ab232b124608ffb665c1f5d98735806cf010ebdf7e634d8,990166,2020-09-30 11:31:46 UTC,3142825171,3142815171,false,10000,0
8a885223372e4b390ae1826c80fd6931f54acacd98c77b2432d2e6f276fbfea8,990166,2020-09-30 11:31:46 UTC,186978165,186974898,false,3267,0
9be8c621bb86719b9a54016774b9ee621d5210d42a4efc2866c5d47627ae5fd0,990166,2020-09-30 11:31:46 UTC,555929,545929,false,10000,0
fe3666fbc24043c6082e4607aeaec6a153baa7b3dc54b8cb84d66dafb3e7b38b,990166,2020-09-30 11:31:46 UTC,142471644,142396428,false,75216,0
e968b27341ea20050e1d0feb0d3ea51efc9ba761564213b7b0f886650f1205c1,990165,2020-09-30 11:29:05 UTC,500012260,500002260,false,10000,0
1c3a5da27ac7b0daa8e0543b2351c5edbbebec413c7c7166756a1b46c65a6c5e,990165,2020-09-30 11:29:05 UTC,41049725,41040322,false,9403,0
4fbaf2caafb8457c25ce0d095326839b4f01a3cfec083af7997f318b0a6f5ebc,990165,2020-09-30 11:29:05 UTC,10000,0,false,10000,0
f2d32d35b39ee9a6dc888087a070310bb0270b577891f46afe5ab7dcb20c4562,990164,2020-09-30 11:27:30 UTC,106501854,106491854,false,10000,0
7c9740b23398a8616ae3915849216ab42b2641d04f4aa016c53ee341295a4c3c,990164,2020-09-30 11:27:30 UTC,10000,0,false,10000,0
42866bd72417c923af409a54e29c050eb2b4e99a8d64d9a20fb79a885db62de7,990161,2020-09-30 11:25:38 UTC,10000,0,false,10000,0
56917dccdfbf720c5b710542d92fc551478e56059721219f72b2f1bb1aa6a974,990161,2020-09-30 11:25:38 UTC,2000711,1997026,false,3685,990150
651e4a32786ae22736f84d56a4293f4e085d187f45ac68f9fa520fd54aff4f10,990161,2020-09-30 11:25:38 UTC,1399980000,1399970000,false,10000,0
bcd3009e3766f87254c422ee918428b9aadf16ca8968a84532129127e428bc01,990161,2020-09-30 11:25:38 UTC,54842919,54840999,false,1920,0
c7b7a86c1cc952ad1d080a4f97076c90c3bddd26cfe300a7148d0a7fa72ca9dc,990160,2020-09-30 11:23:45 UTC,10000,0,false,10000,0
1030bb92dd8876540ea901a4db3c0c318456bd29acb911123aa8194196cce61d,990159,2020-09-30 11:23:30 UTC,99848781,99847781,false,1000,0
d42d215394e75746478c0aa10480284b929473c1c4039000362bbb8679994dd2,990159,2020-09-30 11:23:30 UTC,816306680,816305098,false,1582,0
2af02750995d3682ccae8f4d5f2f3d4b7eb8382a0ed5d3dbe20a84de01f5e0f4,990158,2020-09-30 11:22:18 UTC,173447679806,173447676882,false,2924,990146
1bac33eaca6bea9165ea96ab72c1f8f4c564ea140a7d121f1713c2a8c0b1b777,990158,2020-09-30 11:22:18 UTC,500017883,500007883,false,10000,0
a097a1fc9c783e9aa611b5abdfed602a6995cde9e607bc0d196436eebfb37312,990157,2020-09-30 11:21:51 UTC,19672923951,19672913951,false,10000,0
4f1078d6d5bc99486560187125241c352a32d47b3d3e3b1a4d5d6ba16b437a50,990157,2020-09-30 11:21:51 UTC,20855584,20849106,false,6478,990145
3c5dfc36145d7817ca4a34af725e9ec90f9e7600557a7ae9e29b95a4245b210a,990157,2020-09-30 11:21:51 UTC,10000,0,false,10000,0
ff9804c9d8718d709d5ef5a0397af2b8f4a7bd7fc5f3ab0d4545e32fa986895e,990156,2020-09-30 11:20:32 UTC,825134232,825131929,false,2303,990145
15d9577cb1b01d9b2cf2f95b95d848604fd6b5407a805d341d7a828c4492d4b9,990156,2020-09-30 11:20:32 UTC,126986493,126952860,false,33633,0
f48b36db8a5aa2ccd04bee3372d956d449a7583836ca7d80497a81ff769cb6e2,990156,2020-09-30 11:20:32 UTC,510781920,510756965,false,24955,990145
e4867f0b5bbdbb7df187fd2a74b0374f621d0a477f3f089e27a4f3d0fb5f5a0c,990156,2020-09-30 11:20:32 UTC,139952518,139949558,false,2960,0
36b2b3c88eae46c6fae186b001bb131d507d68bf4e02dcb0b420ee137f157826,990156,2020-09-30 11:20:32 UTC,1470882877,1470805463,false,77414,990145
1efaccecf1b979868a9cdf41478976be6c8f68a8aa33c76712c33dd8db71e7de,990156,2020-09-30 11:20:32 UTC,499990000,499980000,false,10000,0
1498f56ce686e83fa46a8911a80d1676838865e1848f38c907be0ca5c6f5e9e2,990156,2020-09-30 11:20:32 UTC,74648263068,74648260718,false,2350,0
0c2d8cc1c36e2cc35250de41dacb1a5affe2a7d23154f35bdf36726bd23fa7eb,990156,2020-09-30 11:20:32 UTC,710052226,710042226,false,10000,0
053c4569750afe3a242ecfc6f7b369410254b91e4cdc437beb2f1cf3d9e9b881,990156,2020-09-30 11:20:32 UTC,53875488,53873568,false,1920,0
f4f42aa87ad5d88580ad168edd4e431abf189eaa0f1fea18aa0ff5bd27504674,990156,2020-09-30 11:20:32 UTC,7662,5934,false,1728,0
bb8f723bc4666f1ab5e7d168d774f0e1c44c5ee8eddc76463fb2fd85973f359b,990156,2020-09-30 11:20:32 UTC,10000,0,false,10000,0
f51e501a67e990b8a152af314be0688a0b5b9843ef629c1fd7f94c00df008a43,990156,2020-09-30 11:20:32 UTC,500027883,500017883,false,10000,0
898a34bef26fcaee4e5a57933aacce912f5ae992053c9c58427fac01c6a009ae,990155,2020-09-30 11:18:16 UTC,500000000,499990000,false,10000,0
f7a8ecf97fb1f8f5dac83735c4699773d5d8a684188e8b5d9856d2c0eb0b52a3,990155,2020-09-30 11:18:16 UTC,162026066,161926066,false,100000,0
e7358583a20cd502069fccd2a11f95d4c3ba3910e3e1de4b4c2442a26b7ae937,990155,2020-09-30 11:18:16 UTC,20280996305,20280986305,false,10000,0
589cb4dd8ff8abbc87f39707b6ba9be9a6efe596f583efb65b65b150502eab5d,990155,2020-09-30 11:18:16 UTC,3338552143,3338545143,false,7000,0
fffb9f51ae40adeb1d54bd146ecf2bdad1dd8d3e11682ee0f4589a16317bea90,990155,2020-09-30 11:18:16 UTC,126000000,125999000,false,1000,0
67a563298df73ca615fd2f69a8f555054be35a0f934944038711bdc429c5cbe7,990155,2020-09-30 11:18:16 UTC,10000,0,false,10000,0
0d5c9e30c77d06a2aaae038d1fe35c52f26837be8c0d805a989549d5ea94ce75,990155,2020-09-30 11:18:16 UTC,20086153,20077249,false,8904,990144
8cc46d23dbf0f30d88fbeb6ad26e125bcfdeb82cc988bbfdfea76e137018702e,990154,2020-09-30 11:16:17 UTC,36922198,36906618,false,15580,0
6ca777fcae74f2de38d19827a6f2a97de2eac1bced855d9a617fa4332fbbf862,990154,2020-09-30 11:16:17 UTC,60000000,59997972,false,2028,0
c25629c135115c5e1cd2b554d401fc205e735ed4a9084508fef4b5a82d66ff01,990153,2020-09-30 11:15:53 UTC,680082070,680066490,false,15580,0
a7f85c4a9ff1222b55a1bdc523757ba22655ad869b6dcc6b02d0b763d7490794,990153,2020-09-30 11:15:53 UTC,20281006305,20280996305,false,10000,0
169a0b40a459fc71d3ce7a94e0b1903aaf65203a0df5a8f52f8227e75cd2bef9,990153,2020-09-30 11:15:53 UTC,1163916994,1163901414,false,15580,0
ec974258dd57bc27761990b16958296595869c0365265fe1ef8a86d40fe0505d,990153,2020-09-30 11:15:53 UTC,36912240,36896660,false,15580,0
e18519c6a79791ed1f92b812f3507ff4bdf2db90643f9ab3cf99027132ed336e,990153,2020-09-30 11:15:53 UTC,6829983519,6829967939,false,15580,0
dbc9c64ef3c5d2e1dc784ba6961aa03031e55a19cdf7a2e1e9b606eec97da79f,990153,2020-09-30 11:15:53 UTC,1387250738,1387235158,false,15580,0
d5e8496ccbc3e8ecc7f53442a2767b9a919b17f18f291ff7686369052120d296,990153,2020-09-30 11:15:53 UTC,10000,0,false,10000,0
7c2583e1e0be1e70b8f6e53c50e07d03baf5c9ed63a61572951b5a4dc8784558,990153,2020-09-30 11:15:53 UTC,1499599993,1499584413,false,15580,0
a5029f3ef69bbece5cb405744d3582752686b30aaf1b27b02ce084e4f9268f8f,990153,2020-09-30 11:15:53 UTC,506422529,506406949,false,15580,0
e4862d21642e611b3bbbc797b20798d0ca3d38033a1312d800470fc9a99982bd,990153,2020-09-30 11:15:53 UTC,231123426,231092938,false,30488,0
f5a2968e21745a051839d450620fb9dd087378b592fbefa740fa345793cd703c,990153,2020-09-30 11:15:53 UTC,248731739,248716159,false,15580,0
b4ce527844771a3abc521c0add737b6c8403db6e39d6382785860639f5d474ef,990153,2020-09-30 11:15:53 UTC,1875940319,1875924739,false,15580,0
5c9f3b1443dabfac8f1605d88f2b62fb592b2b233b8198047ecef219d4b0c500,990152,2020-09-30 11:14:23 UTC,500000000,499990000,false,10000,0
a4136681f2424efde705caf7a12ef2d95243330fa32577a99cc2e9857a100374,990152,2020-09-30 11:14:23 UTC,921982938,921967358,false,15580,0
7a1cbc65fa2c00cec6e6856b4f8048caca0c32146974535d38cdb99d4170b96f,990152,2020-09-30 11:14:23 UTC,435714793,435699213,false,15580,0
946829d1c70655e5729fb06420baa81f8bd8563cd8b17e81eae288879c57b025,990152,2020-09-30 11:14:23 UTC,133869622,133866355,false,3267,0
97cd83a42f6dc81c2b7b6a4987022d0600bc7d663390944f1c5c78c31247cd2c,990151,2020-09-30 11:14:00 UTC,678294632,678292329,false,2303,990139
f968e4a105af71283f02087fe7cd4a781dc2eee8a8442133d3c14609a9b56b21,990150,2020-09-30 11:13:45 UTC,47436614,47434354,false,2260,0
4032dc623417dd4f1c24cdcc8fc487dda17ac40de12d077907c9d61e80960843,990150,2020-09-30 11:13:45 UTC,840362328,840287104,false,75224,0
a9a153fcc4f883357a589cb4d56c7395e366d61198c2583b4ad230af837f29dd,990150,2020-09-30 11:13:45 UTC,250,0,false,250,0
0793907479344124e2b9084a7e0fdde6df658db23290dab169f6f14c5160df71,990150,2020-09-30 11:13:45 UTC,10000,0,false,10000,0
4845cc68a6df496619af48fbc95e819fc084c2f98b976a5794479ffff4a18365,990150,2020-09-30 11:13:45 UTC,1000010000,1000000000,false,10000,0
d55ccb6b719a8143b57dd83355aca2e0044e9c256d82c3a522102cbdd1b0d97f,990149,2020-09-30 11:13:12 UTC,499980000,499970000,false,10000,0
843c59225574e6853aa2fe228c7f06c00559fa1539dfc956eeea685e59a93439,990149,2020-09-30 11:13:12 UTC,6359590903,6359590903,false,0,0
2ee09df6eb79d137ae25348dbbd63bcfb5b62a975c8d3fe5e527ca2bf2856d48,990149,2020-09-30 11:13:12 UTC,5294469873,5294468824,false,1049,0
257bb77c437e21b947f4f132cd6ded14cc4bbf27e91065db907f6e9ab11a1475,990149,2020-09-30 11:13:12 UTC,10000,0,false,10000,0
33cf7662639e9e488f7b216646734e2f8e3ec8a542d09cf5e8a36c0431a9fc8e,990149,2020-09-30 11:13:12 UTC,10000,0,false,10000,0
55a7fe7d1730d8c1ca5b632b568e6c886532262fe473e7573d59db5ae2f9d17e,990148,2020-09-30 11:10:56 UTC,250,0,false,250,0
dbda0c6a6766adee603c0b36277d259ab754e7867d0ca27aae5e2d867af9d59f,990147,2020-09-30 11:10:20 UTC,1472435031,1472353216,false,81815,990135
c82e4e8a5b76a45ba92e4d3bbf7c4af0c7f87d3799d8862a02319d4c9536c583,990147,2020-09-30 11:10:20 UTC,512382375,512359630,false,22745,990135
56756e5ab4ced9f94887b831a9f29ae4c0ddf1e34fa72a38e20e299c59b4302e,990145,2020-09-30 11:09:43 UTC,10000,0,false,10000,0
1c9c5ec0e980c04155613ce0eb8d7d28a2e4a28bbd223e18a18b7f8b1a5dc996,990145,2020-09-30 11:09:43 UTC,141633189291,141633173711,false,15580,0
2cec21b397900e2f6c87616d8e9631422ee845ceec6abcea56bca24db44ac148,990145,2020-09-30 11:09:43 UTC,8936072187,8936055187,false,17000,0
4703d82be577e8bcc348f42ec17a849f3bac4ee34af28b5e32bc199b43861b8f,990144,2020-09-30 11:09:07 UTC,10000,0,false,10000,0
e5e57612429d49ac71ccc6015cd3e258de077289d6355d838fe4ffa660598eeb,990144,2020-09-30 11:09:07 UTC,500138502,500128502,false,10000,0
e939d642ef013c236fe04d8c56d67b02ab4dd15c779633a5664054f4b0bd9feb,990144,2020-09-30 11:09:07 UTC,1023969,1021519,false,2450,0
434e09607b2886ca57d3e242c536035a582b579941d92423f8f67892f05a99f4,990144,2020-09-30 11:09:07 UTC,500000000,499990000,false,10000,0
33d9417128a77ad6b41792239a6d7118f19d5cd539873525393e38d60fa8123f,990144,2020-09-30 11:09:07 UTC,1000127173,1000117173,false,10000,0
7a6aefe2d0db42c53c71a113af92b6f2deaf2516f19849e67d76383056be98d5,990143,2020-09-30 11:07:04 UTC,3000226166,3000216166,false,10000,0
620c55179e1e9701012cf5078620ea655720ce8d3c8f3f7a735a5d0ebb22932e,990143,2020-09-30 11:07:04 UTC,447377100,447374840,false,2260,0
4428b5a7be2124da5cac1cd4cb2c14eeb241d27242dcb1a79d673c008cf79c22,990143,2020-09-30 11:07:04 UTC,500002303,499992303,false,10000,0
c15e793827695cc5dd69cdb0e877c560d6db7fdd5da68718b6314e767b41fe4d,990143,2020-09-30 11:07:04 UTC,10000,0,false,10000,0
aa6d0d04cb455d0d9ad93396e21305698d9ee4fb611b8f3bbd781bc7a95d7356,990143,2020-09-30 11:07:04 UTC,12944,8064,false,4880,0
157fefd30d5359ca5e72785164faba2abb7435ac965c44b7ee09339cbce46108,990143,2020-09-30 11:07:04 UTC,692796935,692794632,false,2303,990132
5500a4fdd4418662f44fe1bf82a2193dee2f1c6710cf9213b730119dcd12b73b,990143,2020-09-30 11:07:04 UTC,10000,0,false,10000,0
1c3ddc90b1addfb3524f6303f9593ab31d4c3e20e4ca5d703c2a8ffd629ce3f0,990143,2020-09-30 11:07:04 UTC,187165645,187162685,false,2960,0
80dd5f45381694dea7394266260c817e743d9e4fc6f6472563ac89a7d37a445f,990143,2020-09-30 11:07:04 UTC,243224295352,243224285352,false,10000,0
8509629cba0facd50152c4ebdb82adb51916b5f3a7e54b0ad663c505fe5074d2,990143,2020-09-30 11:07:04 UTC,3885049593,3885037875,false,11718,0
ce81a64f8c8004b6d1c94be719e80d208a7e61981ade4bd27b28451f6e53a54c,990143,2020-09-30 11:07:04 UTC,10000,0,false,10000,0
ba0fc1f954a6bf646864376ec414e354f5c0823197875cafa94b9226e0b2b2bd,990143,2020-09-30 11:07:04 UTC,2500465221,2500455221,false,10000,0
a52ba339a6e03821618a5b96e3766f5bfad907002acec149190e8b4a55c88f45,990143,2020-09-30 11:07:04 UTC,576805412300,576805409950,false,2350,0
8f6f3b8a8b987ce09dad87fac4324e27a385e004ffe2d3c44b36e048c836051c,990143,2020-09-30 11:07:04 UTC,500010000,500000000,false,10000,0
5a4016eec17efa21f945c50433c718230f005ced2fa9be2127dcd0c33d38223c,990141,2020-09-30 11:03:24 UTC,500020000,500010000,false,10000,0
919e3e0a135572f17051e01c962d2081cb9bfac05a100d21d1269c164cfbf8c8,990141,2020-09-30 11:03:24 UTC,51304895,51301155,false,3740,0
7da51c6891152bd5d42a355532c93c4f859faa5b0813ea21c33b307e79bf148d,990140,2020-09-30 11:02:52 UTC,114406,111956,false,2450,0
cfb56cab43b1dd8f72229f1516430de7e5acf7ce060a8ff5c1ec219fcb832c3c,990140,2020-09-30 11:02:52 UTC,6448712302,6448708617,false,3685,990129
3005845d9a89360ba6bde5c0d5fbe6ce6b906170e150e88ffedee5ca78c40137,990140,2020-09-30 11:02:52 UTC,9895925040,9895920520,false,4520,0
7a54c40d195e296a5de1b4d5dd30876fc708442de12b937516be969b373294a6,990140,2020-09-30 11:02:52 UTC,7769582114,7769575113,false,7001,0
fdf119c320cb74169ced896a0b75a0bcfb31980983de35f5739a44020dd06187,990140,2020-09-30 11:02:52 UTC,26873417,26869741,false,3676,990129
025de6356dff864a9f74201f133580e35711794799a21f0dc1d4fa424e66f6de,990140,2020-09-30 11:02:52 UTC,21070,11070,false,10000,0
c67ef790e2a6ad4cd9f2c4782e0dc570f39c5ec23ca1dfff999140577f716218,990139,2020-09-30 11:01:56 UTC,10000,0,false,10000,0
20d3c1bbd9d8e8ca00e2e14d11ec29ab72bdc27fc68f5702dea9a5640d153afc,990138,2020-09-30 11:01:42 UTC,4461035976,4461029976,false,6000,0
580c8793281f56e03df499f5b1bd4120af70453e34221c51634f814d75d27295,990138,2020-09-30 11:01:42 UTC,58800,56350,false,2450,0
2e150ed87e576b9f0fb9be5cc1c36bdb19f4153584b8f022eb1831ac976f33a0,990138,2020-09-30 11:01:42 UTC,74697749295,74697746265,false,3030,0
132a6c7d36b9fc1ddd91d8e9c7ec4ca5ae406826971c7f9375a9702dc5398ac9,990138,2020-09-30 11:01:42 UTC,723270175,723267872,false,2303,990127
b2f287eb298bea3b97e23d760cbeb25c48b725a075f06240411c47637e9f6061,990138,2020-09-30 11:01:42 UTC,44139593,44137290,false,2303,990127
15ddea8fc70daa0b62ad8fa9c371db3b263b6623dd94642d078c46c281f5ea2e,990138,2020-09-30 11:01:42 UTC,140109440,140106480,false,2960,0
3a86b2941eca8eb6ad3fdd4cece991a24fd72398d862280c2804980de4efed7d,990137,2020-09-30 11:00:33 UTC,499990000,499980000,false,10000,0
66d8104885d22b739e2ba1a25984dace64a9c569b83b9570ed8b52dfdd649e1d,990137,2020-09-30 11:00:33 UTC,1474018743,1473946828,false,71915,990126
ecbbe233acc6cdcc883948c42da252f8d455fd0cf613e7f375930a4ee221e4ea,990137,2020-09-30 11:00:33 UTC,512901401,512879645,false,21756,990126
17f1975a1ab7df5693821d20a933ecaf79b9b631aadbc0056e5dc11c69200150,990137,2020-09-30 11:00:33 UTC,10000,0,false,10000,0
9b3163555a8916975b09d709050af6e4691241d274a6688d3c7989b1023f7298,990137,2020-09-30 11:00:33 UTC,10000,0,false,10000,0
a4e95ef350c86bb9a9458fe0171d0fc4d36357d23f9f9080e66f4c0ddbf5a507,990137,2020-09-30 11:00:33 UTC,7219803,7214583,false,5220,0
f9b3726f16c729e2e29676c576b852aad35cfd75266a1192640affd345ab3794,990137,2020-09-30 11:00:33 UTC,74970762438,74970758728,false,3710,0
f9ee344b978999d899e8a6bacf73f952fdf7983dcb0d8c750cefc93dd97c9e23,990137,2020-09-30 11:00:33 UTC,175248466556,175248463933,false,2623,990047
e65a03b268a2dbee74f41c66137b1891da3df715ba568c0669931c1fce810d07,990137,2020-09-30 11:00:33 UTC,10000,0,false,10000,0
b11c135189185d03f2666a77b7906d41d24d19092351e026f58c684418c2b285,990136,2020-09-30 10:57:01 UTC,75462683462,75462678052,false,5410,0
34b8efab2ab10630d87f011d5d21bbc56defe9ad6c101c049772253ee60b37d8,990136,2020-09-30 10:57:01 UTC,134017668,134014708,false,2960,0
703f30e961fba776689955077c9d6fe8525f2d83a7c398ba344dedec1ff538ed,990136,2020-09-30 10:57:01 UTC,41086156,41076754,false,9402,0
10e39f5fa23106ea3006c3818b54275669be21a98084a58efe5c6de3f2aab8c3,990136,2020-09-30 10:57:01 UTC,500000000,499990000,false,10000,0
ef55d93e81f85baf10208d369d95a664a1ea9002dac1b4a8618140164f90b55e,990136,2020-09-30 10:57:01 UTC,1328244,1297110,false,31134,0
aef39bffa6f74b018e7e6a2715f14226c68b4cc1afb2540145005975909e2d57,990136,2020-09-30 10:57:01 UTC,10000,0,false,10000,0
4fbbe1e1537aedc623e0220cbf3a4186c77809cd62cb8105be8af448e8c28711,990134,2020-09-30 10:55:05 UTC,21271373,21265373,false,6000,0
d773c59e5ee8597187562dd25cb72bf4f1d7016e7b7ba0d517a48b7d3b786424,990134,2020-09-30 10:55:05 UTC,76603602371,76603596961,false,5410,0
3d4f1263574bbc9054719e24f4284f1f04a4a39f5319dcb15b1730bd15cd4198,990134,2020-09-30 10:55:05 UTC,4142855170,4142845170,false,10000,0
1bcfee0cab16cf8c75f1563449eb5ed847c85345b0b2d07919d30db10b12fd5c,990134,2020-09-30 10:55:05 UTC,700798868,700723660,false,75208,0
4ced0751089d32e0ea13460a5f065d0dcd5818243079dd7d69918cecc7a07a7b,990134,2020-09-30 10:55:05 UTC,10000,0,false,10000,0
37468c24988f5bd4263329b8359d46666723b3c3fa1039243ab7ec2da18b34d6,990134,2020-09-30 10:55:05 UTC,76351845885,76351840475,false,5410,0
3c7ebdf39dd56df695377e4647a8970a6dcebf2df14c45eb483c3ba7ba5cb183,990134,2020-09-30 10:55:05 UTC,402743,392743,false,10000,0
fbd42a8e0d031d9e14f188eb23b638391a29002d0761c8016edec1f2767d15ad,990133,2020-09-30 10:52:26 UTC,1166409205,1166406272,false,2933,990122
f046b03c43971945d27e28bc7694de7eaeaf6da3ef75259cbce4adf9752810b4,990133,2020-09-30 10:52:26 UTC,10000,0,false,10000,0
7b1f3a0e36f65abdf141586da06ba44153b73cd03b8f27ed31566c167ea723ef,990133,2020-09-30 10:52:26 UTC,1475821831,1475749840,false,71991,990087
3ca5764b221cab36f8d18681f469a8674457f62e032cdf0404c83293b66662f3,990133,2020-09-30 10:52:26 UTC,513355820,513337881,false,17939,990122
7bc234dc498d559b39e472f4a23a669b5e40af7acc3dc3d752336901dd808e87,990133,2020-09-30 10:52:26 UTC,89477399544,89477394134,false,5410,0
a459d3d708fdb0a5b3e00e83392b42c868e8c2709cf2be2a3a2685cc682f3a76,990133,2020-09-30 10:52:26 UTC,10000,0,false,10000,0
d644df17951e4ec14b197738a901f010da864bdbcb1233efeb15f640dc1a68cc,990133,2020-09-30 10:52:26 UTC,260603144,260593144,false,10000,0
c41d71023c1c00718a622f336cd32a9d5649aec77c7b6d5e885dbcee3ac53b68,990133,2020-09-30 10:52:26 UTC,96069497310,96069492580,false,4730,0
f453315effc15c32d9903f168880650f7e077470c3afd30ec65afbdec6e28a08,990132,2020-09-30 10:49:36 UTC,1037086,1032000,false,5086,990120
28287dcc9f8bf2052a05b3211b1e546d7337368d687fe2bd015ddeea77501145,990132,2020-09-30 10:49:36 UTC,54554,44554,false,10000,0
e51ab0997c89446a2321e9a695cad2072b2378d6539ede344f49ac672ce551d0,990132,2020-09-30 10:49:36 UTC,2609884078,2609877077,false,7001,0
9dcba25d31db67b655b22a139b51087b4357ec1e9e3a0a6ac9c9a4fe5a8bd518,990131,2020-09-30 10:49:12 UTC,10000,0,false,10000,0
7f32bf4f1ce4cfefab0be148096308de07cca1d2daaa2412eb2619d7782f78b4,990130,2020-09-30 10:48:57 UTC,27425381,27423431,false,1950,0
90a42a4ded2fefd7702a072f9124b6dfb203811479e05a57444581b981231386,990129,2020-09-30 10:48:30 UTC,118343038504,118343034794,false,3710,0
d25da5476b0232b149c7a6619711d8a7ebfcc19ab87fe3377947b02ca9306f4b,990128,2020-09-30 10:47:27 UTC,10000,0,false,10000,0
634e63eb9f108d25d97dd05d47aa17ab39661f1915ba3f7f358b3ea22b6feda9,990128,2020-09-30 10:47:27 UTC,187319252,187316292,false,2960,0
17ecb875fb10e02c420a8b5187f1b3b9edeedebc5d31f43a0b77d9348ab33874,990128,2020-09-30 10:47:27 UTC,112896003,112883383,false,12620,0
0e62a1c970bad61c8ccfe3c04a5883843e4aeb9de57a5fa6dacda7b27aad180a,990127,2020-09-30 10:46:03 UTC,10000,0,false,10000,0
aecdefd0123d2b8ca2c056c1d363faeddf0052b3190bfd355acaeeeefe803d76,990126,2020-09-30 10:45:44 UTC,10075556,10068776,false,6780,0
dd49b05502cf204ef486020e2851d23d0a51a48a515511834348097a89001f14,990126,2020-09-30 10:45:44 UTC,11024399351,11024394131,false,5220,0
5762763da1e228ea8f4805d84bbef0f9b450a897a3d867a0c377f7bd8b6e48f7,990126,2020-09-30 10:45:44 UTC,19716306578,19716296578,false,10000,0
c0fdba869b8b139b3a0e916380970581d7a16198be285f735339ec016749a4ea,990126,2020-09-30 10:45:44 UTC,2510652095,2510648355,false,3740,0
632c4d2d6216e874047e13dbf8e000dd6c0e2726a54d57c925fd5c895c75c0df,990126,2020-09-30 10:45:44 UTC,150864161269,150864156539,false,4730,0
57ae6aba1a60ae634b5ba66ebbc84adc59b3e918f4771bc81f864ec4424eeccb,990125,2020-09-30 10:44:27 UTC,500064619,500054619,false,10000,0
b022ac85e692fec410f0da15d8e66f7a8452eb7adfb32b07f07160fa08b8b19e,990125,2020-09-30 10:44:27 UTC,671022,664662,false,6360,0
69a005087f834fe467b3aca50d8822ca8a101d92c365377bc52da240429b5b48,990125,2020-09-30 10:44:27 UTC,10000,0,false,10000,0
f55ce602ac2cdfc0e25273b98faeef1f7b1bd6e4ba214ff8f61afdcd759ab6f8,990125,2020-09-30 10:44:27 UTC,267178,243178,false,24000,0
230330f58a6d61c1899d9fb817d3887733e4962e0aee621cc57ebf754fcdee49,990124,2020-09-30 10:42:22 UTC,10000,0,false,10000,0
25abc955b3a2f5d0033857a4b17155efabb047f3670c0484ea7fed01cb9cfbd8,990123,2020-09-30 10:42:01 UTC,10000,0,false,10000,0
bf1d88b931991e6bb1a936a4cec57184e9ad7f177954d64ae8cea506b9a21716,990122,2020-09-30 10:41:08 UTC,745535510,745533207,false,2303,990111
1b748b47b6361d1bc33c8f81e6069fad795522d8d0c9127267728084ad059e24,990122,2020-09-30 10:41:08 UTC,513838407,513815344,false,23063,990023
a9e01ff133276d79146ccd01ff7fef9bccd3bf88ea12808f6f3abf4a62ad33dd,990122,2020-09-30 10:41:08 UTC,10000,0,false,10000,0
d8857e8763d2d7bb06c6f619601b0ec4b51f82cb2600c8ed1ab431aeb2f61ed4,990122,2020-09-30 10:41:08 UTC,1477975163,1477895209,false,79954,990070
28c84c5bd233797b0500591bf93ae4ea69296311aeea1521d60b5c493ad6322f,990122,2020-09-30 10:41:08 UTC,140393727,140390460,false,3267,0
ceadbde1773bf461ba69c716c3fae109b70aaf65524f664b4e8657831e033702,990120,2020-09-30 10:38:56 UTC,1500044638,1500034638,false,10000,0
83e2e1b95bf88b1552b74baf9ab927b939a971e3c1935ce2acfd0669015e6090,990120,2020-09-30 10:38:56 UTC,4030051,4024051,false,6000,0
f906d4995337da3dced80be5d17f6c08b8bd2e89194c7681a8cf513b19b1a13a,990119,2020-09-30 10:38:13 UTC,1026929207,1026854007,false,75200,0
74ce033d1c86c6281f71be0f5ec0550f7790a258725d28fb5b916d7b712494c9,990119,2020-09-30 10:38:13 UTC,211496,201496,false,10000,0
4199788dfb8357b853271c740cb070c025203182105f9f960df27733b560b024,990119,2020-09-30 10:38:13 UTC,10000,0,false,10000,0
20fbec86d170bd9f13c03dfd7e9bc93e40b8eee70568cae65730d382d5385363,990118,2020-09-30 10:37:25 UTC,249990000,249987740,false,2260,0
8d4a2ed02221f3e6671e7936894879c7bbf592e0c820f83fb349636a54d0e458,990118,2020-09-30 10:37:25 UTC,54628734,54625284,false,3450,0
b463d445fd671d80a6eb9be20f846a8147810ed66d549b209ce01b2237da0f59,990118,2020-09-30 10:37:25 UTC,38131,28131,false,10000,0
4e978cf5f3d6cdbed81ed96341f84ef09dd2d04be7b79fcdd0430cc1fe71ae4e,990118,2020-09-30 10:37:25 UTC,10000,0,false,10000,0
3160572e59947b2e37c13e13d05293c80670e786b0c7cb1f0319d15b8c45159a,990118,2020-09-30 10:37:25 UTC,10000,0,false,10000,0
ebc0d733bb2f17eacbdddf19e3a741b43b2b01636f8f4d3c4eb2a80b6b8032a6,990117,2020-09-30 10:35:26 UTC,54024294521,54024294421,false,100,990105
75f7a2c16f06c76d9383e1dc98629adc033ee47822bdf3c3384e267e26d490b3,990117,2020-09-30 10:35:26 UTC,32666961,32665961,false,1000,0
a9be3f1e4ff4125ab377e2b64c7e456d7094c29d6ea3f41aadf36204f62acd49,990115,2020-09-30 10:35:01 UTC,276090004,276086310,false,3694,990102
d9f09a5bb0b863ed5fdd402efc58e8640d814aebea3583d55abc2616b6e04c53,990115,2020-09-30 10:35:01 UTC,178736988059,178736985756,false,2303,990104
f8d034ffdf16280e4a8365743c902e3e0886a4a4562a83b8decf22e66f382297,990115,2020-09-30 10:35:01 UTC,54135839528,54135839428,false,100,990104
6c16961fa694ba222ad699ad8afa455f5d05c1c240315b5092a03e7c584fdf61,990115,2020-09-30 10:35:01 UTC,10000,0,false,10000,0
cd2f8d338c838c158e06a6112c14519bfdf6fa74c5a85418432c531c5e20c858,990115,2020-09-30 10:35:01 UTC,5534215858,5534208858,false,7000,0
a94a37e74a9d4590286d5a01daed491001e1f0467458b7a84a872b11bc1d12cc,990115,2020-09-30 10:35:01 UTC,500074619,500064619,false,10000,0
475f0ba38ea9a83bc30d8c25d7626470382b8f1bac3945405a65cbd2d57f4e9c,990115,2020-09-30 10:35:01 UTC,282881507,282879247,false,2260,0
da61a3e6e342e4b44151cfd5917e7af95e26a23ca32fcfc77751ee7cb3e97adb,990113,2020-09-30 10:32:44 UTC,2999980000,2999970000,false,10000,0
7a004d86af4634e16c062198eb7bada3a9b449b8fac3cae8562eac9559777ef6,990113,2020-09-30 10:32:44 UTC,10000,0,false,10000,0
b6e4aa98ba71f7d202effa0a4953ef8de708b53508a5ebeec7ce55e4bbde27d3,990113,2020-09-30 10:32:44 UTC,1301662478,1301660175,false,2303,990101
181e56eea62713b5b7102fc862f34fa5dbbc99f840bc3a2aaac0391b54154a71,990112,2020-09-30 10:32:01 UTC,7570385149,7570376779,false,8370,0
2de06a99011042981cdd6369bf65ec4262cc1db3e05811b36bd008b23e91d471,990112,2020-09-30 10:32:01 UTC,10000,0,false,10000,0
25ac49946fa219963785260a550e4c02d2e6dd82d7cb2622fcf4f7592ecd5e83,990112,2020-09-30 10:32:01 UTC,276143660,276090071,false,53589,990101
4eb2bbe4a59b7402790d71959d5b25daa17dcf53eabfa7decd204d069b13f2e2,990112,2020-09-30 10:32:01 UTC,10000,0,false,10000,0
11f0dd5aec9e4ac5db0c81d382168d4370d6766ef43d69a5636755f445bb3438,990112,2020-09-30 10:32:01 UTC,2924334500,2924331780,false,2720,0
dc48b66debdd2795d0701e34ff1aaa38d9ed08c0c375069f3a28b61ba286a982,990112,2020-09-30 10:32:01 UTC,500084619,500074619,false,10000,0
3ec32a0faf2cc6796aa05e10bfd4c1a886bc423ee1664df4295cf6d324b25e4c,990112,2020-09-30 10:32:01 UTC,134250780,134247820,false,2960,0
51e02655979167cdc9450cc953b1fce75af16591be0587fd5e540980f9b246ad,990112,2020-09-30 10:32:01 UTC,20118954,20118396,false,558,0
bcf7539f630639dcdf71e6856ef2a741b6a77747af3f2c4f31bbd2540aeadbb3,990112,2020-09-30 10:32:01 UTC,41294332,41284932,false,9400,0
eb9780a5c691bde81636f974419adc4515b274d7326d37c3633be36762efc666,990112,2020-09-30 10:32:01 UTC,184189726,184171322,false,18404,0
4cca3971ab5cd07b475c8811bd8f7c906700c533098aeafc38d40a6dc314085b,990112,2020-09-30 10:32:01 UTC,54373765,54371462,false,2303,990101
db609bad298050d8840bea32fa3f56bfcb02813a5b3ecfd811207bbe87ab7bba,990112,2020-09-30 10:32:01 UTC,514176932,514160887,false,16045,990101
51993cbcd7de41f9861c52bf28809b5379698e0c59e514fbdf921eb099ad84ff,990112,2020-09-30 10:32:01 UTC,105520,95520,false,10000,0
93a2784cf658720d67f749fc1e126935ff72dbc5170c13a27ff801e106016966,990112,2020-09-30 10:32:01 UTC,1479583707,1479511421,false,72286,990101
240289f4f6f14a58de67b718069a1b9bf7d2a312a7b6431e49fdba3dc83edaae,990112,2020-09-30 10:32:01 UTC,250,0,false,250,0
d6bf0e3c96d7c444105aa11875ce4aa1aabf5f333a979f73dd4645659f5a091c,990111,2020-09-30 10:28:55 UTC,1395030000,1395020000,false,10000,0
36ba1734fd19b768f8241ffd8791fd0a559d6ff265753dcdd1f4b2c9c812a95f,990109,2020-09-30 10:28:20 UTC,1477496574,1477396574,false,100000,990097
bf8a0149bc83bc787be4a0070069d2776db3949453bf7c8fe4a558bd426ae6ef,990109,2020-09-30 10:28:20 UTC,187473181,187470221,false,2960,0
7c5aff808e4e80d1d239c911e59c82876a83ca89ebce96abac62b783f44f63f3,990108,2020-09-30 10:26:36 UTC,25963068746,25963066443,false,2303,990097
47fa5a8d6902ab8ce48f78bfe79d1d56bb06dd226a3adfcad49398c974566573,990108,2020-09-30 10:26:36 UTC,10000,0,false,10000,0
caceec7aab8cbd81b705bdf110f56b0056f9ff1c09d0fdc95a4a261c5523765c,990108,2020-09-30 10:26:36 UTC,10000,0,false,10000,0
395df57f7c79788a6d20f123aa1f627116365647f33b1734853e1c93ca053cd2,990108,2020-09-30 10:26:36 UTC,140551204,140548244,false,2960,0
5c18aad662a3ce47efa880679433f409724449dfd2cab2357ab95a531f9926e1,990108,2020-09-30 10:26:36 UTC,92216977,92214717,false,2260,0
84624cbdf7d76f78afe0481ec211a8cd5940d195a79bec9a5fcd533dc94318e1,990108,2020-09-30 10:26:36 UTC,136974030,136971770,false,2260,0
2b16b19ab5bfb5fd09481f7b23e8ddd97da7f88d1361b7942f537d7731dd8cc5,990108,2020-09-30 10:26:36 UTC,10290400,10288107,false,2293,990097
e00d071baa3872d01caaef68eff1b385dd6a62ef9749102014d64e6c8132940f,990108,2020-09-30 10:26:36 UTC,278723761281,278723758659,false,2622,990097
e39e48724c502fb1346ae2f4bc1cb0725b6714b6d09e8d6ad8654a60d11f8cf7,990108,2020-09-30 10:26:36 UTC,11562029,11560883,false,1146,0
cbe3f8f17fdc6248388c8a2c9eaa6c3194ea7d2bbfe1d61504ef06fb189f76f8,990108,2020-09-30 10:26:36 UTC,41463999,41454598,false,9401,0
21b9c1adf6e11d76ee7067e0da58cc5a07a150db38e36663ebb21bd1325d094e,990108,2020-09-30 10:26:36 UTC,10000,0,false,10000,0
c17643c8524dd9dc25314e7da49e5dd11350aa859711a0f039a0b117254b241f,990107,2020-09-30 10:22:55 UTC,10000,0,false,10000,0
f78af3a655d10e868c64ba5eae6e6232a94eb6648ac29ec69638380e37cd8c0a,990107,2020-09-30 10:22:55 UTC,41584666,41575265,false,9401,0
51400339e3c942e6bd16856bb0d704da767fe9e99ee96d9b15586fcc56479966,990103,2020-09-30 10:21:30 UTC,83800609517,83800593937,false,15580,0
dcaa4ea876c45110d21a4c2d9297c8b57d223c18d400355cfa7cfb8247f1dcd7,990103,2020-09-30 10:21:30 UTC,10000,0,false,10000,0
f20289a4606d0b0aac5ee0b00cc5db065803bd747cb2744fe71cc2beb9859829,990102,2020-09-30 10:21:06 UTC,134412652,134409692,false,2960,0
11440a7e6b13fe7a8a17ad92bcb598ee66fdcf15e6dcb5a6ccd57d1a61b84772,990102,2020-09-30 10:21:06 UTC,60499500000,60499487915,false,12085,0
bb95e61043bb619c98b16e25341bb4a4c78e993a1ba9aa47b84d195eec857f8e,990101,2020-09-30 10:20:35 UTC,10000,0,false,10000,0
9f010484bf530dcd041ee427e094b4ff5abddcfc2e387f00c14e0fbfdcbab6b1,990101,2020-09-30 10:20:35 UTC,561224392,561149192,false,75200,0
1a4e1db53f18fc0f8fb2734506f2d5a20b4586acfa2a14cf28e9df146acb2dea,990101,2020-09-30 10:20:35 UTC,1481176257,1481098596,false,77661,990090
8f685532bc24f8a830a338641b3f2329d1d0824482e09421b6a0fa8a7c15ed21,990101,2020-09-30 10:20:35 UTC,514593485,514574260,false,19225,990090
09fa99a9caf3c4cf011e57b01dcb21e48e33207d5c65fe664ec606fa1128d792,990101,2020-09-30 10:20:35 UTC,100000000,99997464,false,2536,0
384be3fdb37e0055826389983b757379c3744fdd6418e98f63c268aeafc9e272,990100,2020-09-30 10:18:39 UTC,10000,0,false,10000,0
79b94864333ba8f3a1f9ccaf044c422935db211f34d41f06288e435fe3b5d34e,990099,2020-09-30 10:17:47 UTC,292663563584,292663561281,false,2303,990088
bb3024a486c1c9a4a6beebe1dd9e14d62daee9526b879dad2806e8f50c24e97b,990099,2020-09-30 10:17:47 UTC,1497496574,1497396574,false,100000,990088
dd86cfc692007d8792a88b887bb05818a6fad0c11a412420d371c75504ab01e6,990099,2020-09-30 10:17:47 UTC,10000,0,false,10000,0
5d5ac69a7e31128cb21f9dd97050d4d064a07cf84763e694d63710bf7256332e,990099,2020-09-30 10:17:47 UTC,2599990000,2599980000,false,10000,0
c80806fcf9a669548ed215b618bf2bac628b00647bef030871cd0cdac142c6d7,990099,2020-09-30 10:17:47 UTC,181769987,181767727,false,2260,0
8fcbdf0ffa1583cc436c0e12d25f5b0325cf0a08827e58cea6a6acdfb08c1c49,990099,2020-09-30 10:17:47 UTC,19517387986,19517377986,false,10000,0
278b4033df82ef7e78f0eaef8a2ffcfe9bc563ab10299e3a56afd28d992ea041,990099,2020-09-30 10:17:47 UTC,69740000,69730000,false,10000,0
58d6a7e2e541ad3c07b7b14d3d966c5c320f6ae327a8a7ec594c8f2e112f171e,990099,2020-09-30 10:17:47 UTC,111780216,111776476,false,3740,0
de49c554ba1f4d387d3e03d4d527db63e6d21c0586d25f47cf3590d3f759d58b,990098,2020-09-30 10:16:08 UTC,10000,0,false,10000,0
d2b899a04c94efdc69916722591edb1373f4e775fb0ce6d58cf8cad531403bfc,990097,2020-09-30 10:14:31 UTC,10000,0,false,10000,0
cbd51d8adf9283e000c2eda282a9f08f9a75631c730579a95137893d52fdf171,990097,2020-09-30 10:14:31 UTC,6141141,6134692,false,6449,990085
3a900a23c2afa4963cbcd0783c037f188c70d515e6241563f23358de9234031c,990097,2020-09-30 10:14:31 UTC,534274485,534272903,false,1582,0
1044b61c46dd75e8b537ba4ecad43a95191fa8825f74caead64e58738235da7b,990097,2020-09-30 10:14:31 UTC,499980100,499970100,false,10000,0
83d80a543fa5676afb0dcc5658009b19a0d5a5dd8ceeca03adbe7920a823e46c,990096,2020-09-30 10:13:07 UTC,187687781,187684821,false,2960,0
463b3413357939130fcbc298eb954b82e30861ef01c41fe77fb6d904b52eff55,990095,2020-09-30 10:12:35 UTC,1731910943,1731908683,false,2260,0
ae5a35923b33242c8e1fedb1e333b4dd74d46f4c9626b41f5a229fea5d77813a,990095,2020-09-30 10:12:35 UTC,41622399,41612998,false,9401,0
92a356119998a41583794ac14e8d3234a0a9e7057cf3e67a916886b3f5a0a167,990095,2020-09-30 10:12:35 UTC,10000,0,false,10000,0
a580c9ecc247673b86deaa92444cae548924c6da65dca45bf6a19cb5923cef55,990095,2020-09-30 10:12:35 UTC,1217270880,1217268620,false,2260,0
1f1a2f9ca98fa76caea410a26113eb9eaae2bf39f67e5118cf9542c261259531,990095,2020-09-30 10:12:35 UTC,515203376,515183493,false,19883,990084
810e27e09bef524eec6ac72a6b914779b071533c6a5b7fd0b7ff70eeab60b479,990095,2020-09-30 10:12:35 UTC,1482153107,1482100988,false,52119,990084
93291ab205f66fe9b97d96cf318ef4e0b221bf1a131a66e953d2a102c4b56ba9,990095,2020-09-30 10:12:35 UTC,51028218700,51028217118,false,1582,0
f75531109412d25e6987a1b765f475d55198382b9f9e6358f95d93bf61c2c187,990095,2020-09-30 10:12:35 UTC,1000000019977,1000000000000,false,19977,990081
26650efa61a62ea168e017a15112095a271525ca02ca0426183f7e9081cb6ca5,990095,2020-09-30 10:12:35 UTC,54193086992,54193086892,false,100,990084
190c3ff85b8412a1c9b3bc6ce26f09b3491dd8db690be3e181ca2b4d33fdc7f2,990095,2020-09-30 10:12:35 UTC,10000,0,false,10000,0
7c3d200fe56be85af186b3bb296e0fec798037f3f610067d05383f9a5f3e87f7,990094,2020-09-30 10:09:06 UTC,1000607836,1000597836,false,10000,0
db758532579fbe0ea4adf4bf0cf1d38326d474f28bdee20747d9f90447b440d8,990094,2020-09-30 10:09:06 UTC,1000148181,1000138181,false,10000,0
39227aee3bb27b92fb427813a21a0b57f2b25a990f22ef45e583d3e2b143dd6c,990094,2020-09-30 10:09:06 UTC,500000000,499990000,false,10000,0
bdd335bc5fb81274cf0abfaff5639f4913329b3386b41ff06de9a715cffaa859,990094,2020-09-30 10:09:06 UTC,1101595732,1101593110,false,2622,990083
3ace3bb01bbaed36e13a298aee6843b78a1f36d0015fc86ecda3b08dee00d17a,990094,2020-09-30 10:09:06 UTC,169990000,169980000,false,10000,0
a0d37e333ff9eff17fe26506a0e7e1a950a7cc0308e549ff42e7e81b65bedb16,990094,2020-09-30 10:09:06 UTC,10000,0,false,10000,0
a90d1070227a7af727db12b4cdd2cbbd234ab50410d47473bc4e5f1962812e4f,990094,2020-09-30 10:09:06 UTC,517590349,517540349,false,50000,990082
55970d33eb5137ce098d993fbe91815935d7db9400ab63ad679f8ec4587eec4c,990094,2020-09-30 10:09:06 UTC,20599500000,20599498418,false,1582,0
17bd9ab47fa78fc2ff70c70cadfb844c5a782084710497d6af18eb66e7c01af4,990094,2020-09-30 10:09:06 UTC,38853310000,38853280000,false,30000,0
c2dbb7192ad1bfef74a1798a64b62b9be8badfeb83ee4a1aefe54ba192afa9e8,990094,2020-09-30 10:09:06 UTC,10000,0,false,10000,0
73b740471c1302269556a6c16f4bfb8e59f90466bf709b29ab21c411f0bee48e,990094,2020-09-30 10:09:06 UTC,1000000017213,1000000000000,false,17213,990082
14feda1a95f3cb03e026c2c4cd96a161c910ace066eca5c50dfb27ffab1a7ccb,990094,2020-09-30 10:09:06 UTC,514840213,514830213,false,10000,0
67016de04b7ea10ec2e19c16128157eea807b81e43e7058f2aa40cf3245d4f00,990092,2020-09-30 10:06:04 UTC,3000236166,3000226166,false,10000,0
11051acffc502871cc18af35809a76c43656f92b09d640b65896f52aa11ed759,990092,2020-09-30 10:06:04 UTC,10000,0,false,10000,0
3a4eaf3805bc7e8cd54ce5908414ff83b6f3b09a4786fb1cf0be876917fe64d6,990092,2020-09-30 10:06:04 UTC,1000109074,1000099074,false,10000,0
aee33c7fe4fbf22ae226b6a0ca459911a1fcb5882f57a5424e81f96a9377d8bd,990092,2020-09-30 10:06:04 UTC,242842098099,242842088099,false,10000,0
e455b203d4eb8bcc7c26447d9f3dfc7df58758028db91f4dc60bc91562f2cb59,990092,2020-09-30 10:06:04 UTC,140693551,140690591,false,2960,0
2f9e1b5625a3b237944b0d26b810a87f13f893bb65043d44a45020e8708e08af,990090,2020-09-30 10:03:55 UTC,5520402520,5520400217,false,2303,990078
672f310592066874a8032ca0bf841e994f64e217c6ef37fddf302ad9ac008d47,990089,2020-09-30 10:03:34 UTC,4000657383,4000653162,false,4221,990051
c24effb0b5666160461597050896d7fbeffe3d1ede0e8908b49f1cdd079b31ca,990089,2020-09-30 10:03:34 UTC,134590734,134587774,false,2960,0
a393362787310630431d3ac38d1d63acd69b6e4cc6fc6602dae89e309430e25b,990089,2020-09-30 10:03:34 UTC,10000,0,false,10000,0
b7c85207c74d39e34b900481687ae89c046c58920f3a5909be79a700f5c2fdf0,990089,2020-09-30 10:03:34 UTC,27010000,27000000,false,10000,990075
a59709c823e42ceef9f6df83e2f6e71bef571136adef760cbc104c356c3a0399,990089,2020-09-30 10:03:34 UTC,690151880,690151428,false,452,0
d8911fd4b3ba162ccaeaad3d6d8c8efe51cd3ac9edc6a556e73b4835ebfad003,990089,2020-09-30 10:03:34 UTC,283385134,283375134,false,10000,0
131d3aeb2cfc93ea92f77ea359fe1de5b2cdef82d68725b6838313ad0ecf135d,990088,2020-09-30 10:00:24 UTC,515701648,515681775,false,19873,990077
0eae46d34d1cd9a47b15bf53e1ccf2f9f7f93ed4b78b4ef8a889d7c20fa2cedb,990088,2020-09-30 10:00:24 UTC,237124981,237122445,false,2536,0
cdd991b91f80f3f31fc34f3554811218525dbacd0052b0a3e0aeec5673186cb8,990088,2020-09-30 10:00:24 UTC,10000,0,false,10000,0
e75fa5fa294e41aa5ddceb4009fe803720de24580ff37234700ee68ca68a6810,990088,2020-09-30 10:00:24 UTC,533752329,533749067,false,3262,990077
ea0774b649c1314649aeb55b253f0029581a85a8bf4827aa1978254b6754f9bc,990088,2020-09-30 10:00:24 UTC,58800000,58799000,false,1000,0
10de4b5534a9bb3e07a3641b448e89bfb42badc5ec5904471f0c47ffe4dad224,990088,2020-09-30 10:00:24 UTC,1304930924,1304928574,false,2350,0
565f57f05a5eee19070ced3a0aeb65ac2712c1284bab24aff3450ad27f29dfc5,990088,2020-09-30 10:00:24 UTC,1999990000,1999980000,false,10000,0
2fa70d1f15d011680fcb811d0ec4948e680b3f7c2b71929ce4d584b146780ca1,990088,2020-09-30 10:00:24 UTC,839792657,839717457,false,75200,0
b350b027c489366b5283de423ff3886d55c43c6649c7e20770f8a6f87e055e23,990088,2020-09-30 10:00:24 UTC,10000,0,false,10000,0
b1f55cb1593ada7c0754ebb8bb66a5de79c0966b43c63d07a6f510531f0e0160,990088,2020-09-30 10:00:24 UTC,499990100,499980100,false,10000,0
65669cf9d3f5742f17d5e6b7e731cdc618239b04a432ffcdd272bfc5c3b6944e,990086,2020-09-30 09:57:42 UTC,237130981,237124981,false,6000,0
3c91e945c18a9ea3260d4ad0f4f8aad67cdc11adb091d45ed7502e87a78415cb,990086,2020-09-30 09:57:42 UTC,54205147092,54205146992,false,100,990065
259e901929d1c84ff0d8149ffa8137ee7e7fd1056a0db829136d2232f3b1f945,990086,2020-09-30 09:57:42 UTC,343691784577,343691782284,false,2293,990074
7a171abccaa142e838a2ed2beb565165f2aad69f6018987fbd47d4b411f95551,990086,2020-09-30 09:57:42 UTC,1207437290,1207337290,false,100000,0
e1a1127001f0f06b4629e7a43e6836852c9cd666c8c501c12876a186ea4f50e9,990086,2020-09-30 09:57:42 UTC,500000100,499990100,false,10000,0
ef2fea279a82883d3b6524ba02dcd3679f4737b20f692cb7bbf2ad1550eba040,990086,2020-09-30 09:57:42 UTC,10000,0,false,10000,0
228d5ed9c5aec1047752d10c6808e65cea26c8d16efdee8da787531bcd9a56f9,990084,2020-09-30 09:55:24 UTC,3589941947,3589911947,false,30000,0
6ff4d0a923d7e0aaa53cc5c1afb25ab65891760d0ed407210a68d29a160b9edc,990084,2020-09-30 09:55:24 UTC,10000,0,false,10000,0
c36ee4d20c891d18a283ad33b528e1cdf2fbeff654f116032fcebb9d4b163aad,990084,2020-09-30 09:55:24 UTC,57801341,57799047,false,2294,0
90e3c1207d1d53c6f650109d96db9887f3b10904a9eb4b14d2178f8901898f04,990083,2020-09-30 09:54:25 UTC,187948371,187944798,false,3573,0
c334035fbb9d385bb896388424a434ce41a9d53a9587d98bdbec47770e271377,990083,2020-09-30 09:54:25 UTC,19208852,19201012,false,7840,990072
ebdc80ae728bfc272294095c87872897cd59aed4a9639cde65533c96807e6786,990083,2020-09-30 09:54:25 UTC,500002450,499992450,false,10000,0
37ff389646940b5928a57c85e5e54dcca17123eac0b152dfb7b95f5abfaad02d,990083,2020-09-30 09:54:25 UTC,28522204,28511064,false,11140,0
f870b868c85c17f2b0a9bde63f55dd3255d9f314a4f37757fcec9483cf6774e0,990083,2020-09-30 09:54:25 UTC,10000,0,false,10000,0
29c25c1bca9ce9264e4d5518ffda694ea707cc7b1f025f043a7ab009e0f9808e,990083,2020-09-30 09:54:25 UTC,364291286870,364291284577,false,2293,990072
29082cebfb6dbc82550dc2da1492c69cb4a71a9c0ae74d4ec31e8e8f3b259e3b,990083,2020-09-30 09:54:25 UTC,140971575,140968002,false,3573,0
1c2d8c531d2b615c9695b0dae4e0103991fc99860754a7d47186ed3955f63830,990083,2020-09-30 09:54:25 UTC,10000,0,false,10000,0
6640d3197aada978e4441d914403311d5d547e30312bf48b71069d9133092b03,990083,2020-09-30 09:54:25 UTC,172126066,172026066,false,100000,0
dffeec9ce0ea6ecd0946f1a3cedac1b6a2928b699e81b1b2962e4c4d49ff7955,990083,2020-09-30 09:54:25 UTC,323589666,323588520,false,1146,0
ecfcb920678e979867fb0a464061551288cec65e67fcc659c5c88a08bd09b4bf,990083,2020-09-30 09:54:25 UTC,79190656,79188363,false,2293,990072
f8dd5dcb708d35c520d492e06d3fa8270eb32a7ca3b1b06e32fd984b54f3f6fd,990083,2020-09-30 09:54:25 UTC,1969044184,1969041924,false,2260,0
6524e134eded103aa8a95405d91f307e89a0caa8b578e595e661f558a2204f47,990083,2020-09-30 09:54:25 UTC,10000,0,false,10000,0
025e0107efa7516161ff4d565bcf256f87331ba9f0af8ffc1272880cf7e8dbed,990083,2020-09-30 09:54:25 UTC,205062367,205032367,false,30000,0
eba7818b81049eaebff6dce307b1c6fd4679e46cbd73a3035f5cdf5148d39788,990083,2020-09-30 09:54:25 UTC,545649244,545645454,false,3790,0
88fbe9d98faae1762c14c223c1bd3203973bf8048615195325b27e1ee7aefd6b,990083,2020-09-30 09:54:25 UTC,19000000,18994806,false,5194,0
9ae5cb09eb6e97842f70c67dcc298d15e147a4af8eb251e685c012a4de66ced7,990083,2020-09-30 09:54:25 UTC,10701038113,10701028910,false,9203,990072
30b1cf03132f98c6ca03e51a3453b136c3a0d843c93ea1d20d075021a2fd217d,990083,2020-09-30 09:54:25 UTC,10000,0,false,10000,0
61f72f4026905b12bab50a311d7f468c2d670f33e3f5989074d3559af96ab5ac,990083,2020-09-30 09:54:25 UTC,664783896,663507993,false,1275903,0
89a8449c08c828e4e9b023219016ea9663e4f0c5d8c5747382c7456a1aabf8b5,990083,2020-09-30 09:54:25 UTC,516360992,516340179,false,20813,990072
69d7250742374072612af1ada23ff6e5e35f366905aef8af4c2cb2cc2c6703e8,990083,2020-09-30 09:54:25 UTC,70031518,70025518,false,6000,0
bd99c5dec56e4a74601e69189066b43d9e752e249f3215252d4bd1b38c81bcbb,990083,2020-09-30 09:54:25 UTC,971846616,971778619,false,67997,0
60a2ab37d2e5d5ee1a7353b78d45a1bdade8021b65b7c86c4fae9834ca44bd16,990083,2020-09-30 09:54:25 UTC,332946088,332931988,false,14100,0
8ed7560c24483e8a42bbc8fe379ed5fdfd2fbf68afb54363bd48726edbcc6b66,990082,2020-09-30 09:46:49 UTC,1026522,1022828,false,3694,990070
5c58e0e49ea75bc1f23318445c912a344808c66fe2219c27bc0d1a7ea909ac35,990082,2020-09-30 09:46:49 UTC,4417509283,4417479283,false,30000,0
0e1fb821e65fa330b288c6f9df5dc038e1bb1ce6d19281f03eb70c7156bbe706,990081,2020-09-30 09:46:20 UTC,492510000,492500000,false,10000,0
0d36f3320167e36f1cba374d56e554e9a0e49df72871df82d39369b191742300,990081,2020-09-30 09:46:20 UTC,1344460140,1344457880,false,2260,0
a13a1c124e4739d9128ca45bb4f3cf1c423fae6715ff816897df43a2ae1fb3dc,990081,2020-09-30 09:46:20 UTC,969621187,969439703,false,181484,0
c0463298590929439c0b45030f79d64b0621c48283cfedb490b7571d1d690c22,990081,2020-09-30 09:46:20 UTC,10000,0,false,10000,0
cb5b9611b45834d83b58e0129afa658deed50a3ec5e6a5eba98698e9c7641dcd,990080,2020-09-30 09:43:43 UTC,441793916,441788840,false,5076,990069
ba78f1cb99aab203b45b57ddc82a63e2ac6397862432e5b43c6e5062a7e97df1,990080,2020-09-30 09:43:43 UTC,134748139,134745179,false,2960,0
72fc3fb058b2cb8bb03d0d078f0eed5458acc5a10fb9790c15f9543e2d19a1a3,990080,2020-09-30 09:43:43 UTC,10000,0,false,10000,0
b51803c3409454b7ea6ab8eafc080766c12a666d225fd9a950a0ba4e14193ee1,990080,2020-09-30 09:43:43 UTC,10000,0,false,10000,0
794dc0ad51c1855734a2996ba29ace6c182b8dc6642f0aeac67f27d2acc7522f,990079,2020-09-30 09:42:35 UTC,4852238889,4852208889,false,30000,0
7fd6b9c0305f79d6e8e03fb2a25b61f777d3b3035d2bcd6f6ef63b76b387ea7a,990079,2020-09-30 09:42:35 UTC,10000,0,false,10000,0
d5897644fe62a04796173bcabe3fc8059116396efa37acbfede57d0aabf93ba7,990079,2020-09-30 09:42:35 UTC,421649592,421574392,false,75200,0
fa4d78d74914aac1ca96af60f92ca04ec590be09d7289b5fe9246ae3d4428c00,990079,2020-09-30 09:42:35 UTC,19304514455,19304504455,false,10000,0
a640ee21b7b2a3feb25d7032f92b07a15348e8047ae3de29fbc80e4fb0708840,990079,2020-09-30 09:42:35 UTC,696068000,696058000,false,10000,0
7b47f0b97e052f5f64d5b7a71d827d1e05070758d98909ac90b06cae51c62ea6,990079,2020-09-30 09:42:35 UTC,1200015859,1200000000,false,15859,990065
bd9b505c4864e013c1018200fada130eec9870404f2817ce9679a573a8fb7a67,990077,2020-09-30 09:40:54 UTC,20087177179,20087167179,false,10000,0
38441e03910e5ea11253e693ee2586e2426cf0d7c6b9fbb1638a321d4e76e902,990076,2020-09-30 09:40:21 UTC,516783634,516763751,false,19883,990065
6dc51ccd7069b70d7048e8519497c993fea173ae2a68210f42aa4ceb3260e0d7,990076,2020-09-30 09:40:21 UTC,10000,0,false,10000,0
a0b364455aff4295cf57cd485571bf33f30cd470d42991b517d1e2c4e4a171d7,990076,2020-09-30 09:40:21 UTC,30263616,30260706,false,2910,0
0fcfb4221c65873bb36235a1b69d453d7dbb5f9318b40dec06b363e9fd0596e0,990076,2020-09-30 09:40:21 UTC,8961412838,8961411256,false,1582,0
d7bf0302fef728706a107940bea0afac362150f08beaf9032adbbf5e836a30bd,990075,2020-09-30 09:39:29 UTC,20582997,17582997,false,3000000,0
3df1ab80c6f32e39bc5b63d5caf46bb527bf72fb9c348ae0e8663bd80f760df8,990074,2020-09-30 09:38:53 UTC,3001497697,3001494012,false,3685,990059
56a7d9859e6ed7562fd14550766fd888997d0ec8abdebe228c858491ff01fcce,990074,2020-09-30 09:38:53 UTC,4000667383,4000657383,false,10000,0
ac67b3bc16f4a8d56b4e15c59054f97a738e05e510dc6904235f4df04bde6418,990070,2020-09-30 09:37:39 UTC,20087187179,20087177179,false,10000,0
f58b3240c43f2f5d323d191d2fca54c5921ba400b7c3614d0fa89878b03167e7,990070,2020-09-30 09:37:39 UTC,5672443240,5672413240,false,30000,0
0b7e2290207e92b21395c4fddbb5007c41b911f34c9401bdaac2cb547bdf3532,990070,2020-09-30 09:37:39 UTC,500208154,500198154,false,10000,0
d2f4aa7ab6aef0fc2c4651163d8d3d1ced6a76fb55d376914292bd784faeaf3b,990070,2020-09-30 09:37:39 UTC,188167528,188164568,false,2960,0
352aa608e921c8b65f5ee06488eb27aea7fd548bd1eed67e363d864516cd1f96,990070,2020-09-30 09:37:39 UTC,162083886,162077886,false,6000,0
84cc0e42ba1441273e8d7cb15a300e95731577b5cb4cfe7c0d1f1383e99ed120,990070,2020-09-30 09:37:39 UTC,10000,0,false,10000,0
0adb5ede050b275d277796cb9d722ed282962c84e7ce4da8f62ce2e13bebccbc,990069,2020-09-30 09:34:58 UTC,21405519155,21405509155,false,10000,0
722d114925602ec6a53b14c8b982c3e072f4ddce86ff2cc57100d3379c7a7338,990069,2020-09-30 09:34:58 UTC,41672006,41662606,false,9400,0
361dee01fd00a988b76d30bf7b203c5939adaafb4e59a10630f806e5e8a01466,990069,2020-09-30 09:34:58 UTC,10000,0,false,10000,0
1710e8bd9055cdd50ab55b3ff85a0a9068253fefbc69297271c555b50e3e87eb,990069,2020-09-30 09:34:58 UTC,99636693,99634390,false,2303,990057
887ee12ffa9ab7492afe01833a6422854b7f749509e70002683e36436ea3ee8d,990068,2020-09-30 09:33:29 UTC,1143794689,1143792386,false,2303,990056
b47f1801689b7fb2705316dc5e82593797f481e9877846a027c7d3a66d25b2c8,990068,2020-09-30 09:33:29 UTC,10000,0,false,10000,0
b7f185878d00a7418036afa43463e6e11d2f19c307fc08915818cd29996193b6,990068,2020-09-30 09:33:29 UTC,260532450,260127348,false,405102,0
e601304796bb7342b8cd43ab0d83a0c36e99d669d3f259e6b670212399ab4b96,990068,2020-09-30 09:33:29 UTC,21405529155,21405519155,false,10000,0
64a7745db7e50452915fc5069ebf56787710d691d4bb57b771b96ef7d5d779d2,990067,2020-09-30 09:32:40 UTC,10000,0,false,10000,0
b9d66a2b9f8d7cb97638dba4b5f899070f5ac1a02210fea5274ea2d82c6be855,990067,2020-09-30 09:32:40 UTC,500119764,500109764,false,10000,0
b93872c665fef283b34a2de74149009a94ef6a1a57373b40e60558d3fa069ce4,990067,2020-09-30 09:32:40 UTC,517533519,517517474,false,16045,990055
8033d465c950dc4f22a71aba90f0f9534e8f149c19ddbd16e3f1bc1222762e0a,990065,2020-09-30 09:29:27 UTC,183000000,182998080,false,1920,0
52cbb1644432ebb5c9f2fb432e20550699186490fa68016deb78a5eaf0781e74,990065,2020-09-30 09:29:27 UTC,10000,0,false,10000,0
759e6b2ea01bd282564380be43bfca10863a206961cab41455f274c7f3b2aa81,990065,2020-09-30 09:29:27 UTC,10000,0,false,10000,0
b82e67f108f3957702b1d16cd880ee9235e2f3b2f33bed9192c3359e3ed9cd3b,990065,2020-09-30 09:29:27 UTC,10000,0,false,10000,0
7152ab3644ac1ed1e8eea4f4e323559e74d586d175a7aebb0c61aee91b3569f5,990065,2020-09-30 09:29:27 UTC,1000276004,1000266004,false,10000,0
443bec0c548316dde14607dea36f13e630db4fc8f4cca3418be0f00b1796ea15,990065,2020-09-30 09:29:27 UTC,41939940,41930540,false,9400,0
e491d78fd1773f8be5de006c691dc7f2b2788597246497b449367cf9ba84621d,990065,2020-09-30 09:29:27 UTC,17155747,17154601,false,1146,0
0639fa44e43d88fdbbd14985b3dda59b95d712640881d64763563134074777c8,990065,2020-09-30 09:29:27 UTC,141162612,141159652,false,2960,0
839a5a3482a2db8cf216fd420b88fd782de770891cb1dc0bb79518859a3c9a34,990065,2020-09-30 09:29:27 UTC,42039911,42030511,false,9400,0
3c9bbedd94d75b9143d8944cd573334d9cdee4f95a14d0023c044674bc345b29,990065,2020-09-30 09:29:27 UTC,408190650,408185650,false,5000,0
af497ab47e85c5c6a6eb82c65a1515479954ac50aac03ba4efdfe6d5b673088e,990065,2020-09-30 09:29:27 UTC,55055047192,55055047092,false,100,990053
d8267a97fd08041ee9157665eeb562121bdb9cf0ffea53e3f4162f9e99fa064f,990065,2020-09-30 09:29:27 UTC,14703800,10000000,false,4703800,990054
93d7cefa6040b27808c359d1bb5378016cd771057b17e7c21a1b8f8ff5865042,990065,2020-09-30 09:29:27 UTC,1434925426,1434923136,false,2290,0
c358fb6da0cd03d1aa0737c8825dec83b0f6e0ea814b7605414db38937c9c005,990064,2020-09-30 09:26:52 UTC,1470807400,1470805140,false,2260,0
178ee0658964a7d558b9302c8deb6e29e225d94f987fcc3bb9a3d1fac5eadbef,990064,2020-09-30 09:26:52 UTC,10000,0,false,10000,0
cb41257e6d3ec380fd413c7e99da3821cef7d89dab4142beed83c058b9fe7dea,990063,2020-09-30 09:26:33 UTC,2011075771,2011075700,false,71,0
bb3580113637e179ea5b36455fbf9df304b5cacf78469be92c8dfb605abf1f6e,990063,2020-09-30 09:26:33 UTC,1000286004,1000276004,false,10000,0
abeb7c1071b21ea94df24b6ff2fbe762821863831f9bd9db261375d264e839d1,990062,2020-09-30 09:24:59 UTC,161293177,161283177,false,10000,0
4e29fad7ce6e33c602b916d9f19582aaa8e97c98bbbf34e3c86a4cf405cf4b92,990062,2020-09-30 09:24:59 UTC,10000,0,false,10000,0
f05b25e5c844c861785c74ab3ab544c83d1f670d5d60dedf07f74a6b02cd5ee3,990062,2020-09-30 09:24:59 UTC,1173796973,1173794689,false,2284,990051
a847b609f80dc142ba564dc1ec4160a2e958afc661b761e875a5a0d6800b9b22,990061,2020-09-30 09:24:20 UTC,2862753955,2862750555,false,3400,0
8430e1b777bdbe605412a74e4c62d7d4f48f3d812361180afaa2169703f7a1dc,990061,2020-09-30 09:24:20 UTC,500129764,500119764,false,10000,0
0e069fc7a72152d1d0c585de638f5779a20a8d7e255b459ffb505bed4b322e72,990060,2020-09-30 09:23:52 UTC,13091474980,13091464980,false,10000,0
05835d04ae21b1e31e48c0b043caa85b221560afdc583b49ed58918608c3ba77,990060,2020-09-30 09:23:52 UTC,10000,0,false,10000,0
4dc31c92b85245250ab7c6dbae97849400e28a8471b4d67006dfabfbbdff2af1,990059,2020-09-30 09:23:05 UTC,267397371,267393631,false,3740,0
3311f4ef842154e6c08f820aeaf29cf6fb1121ac0f3febcb465fe205c04dc0ff,990058,2020-09-30 09:22:43 UTC,42083569,42074169,false,9400,0
2091d38174daefacc164b6a9011e47df74f9226f70f6aa6a1fcb17838e47ed2a,990058,2020-09-30 09:22:43 UTC,10000,0,false,10000,0
7fab5f28c697e56ec69673efc6950b3021c5bc75a03e618d9fea2d8d75d59dfd,990058,2020-09-30 09:22:43 UTC,4999500000,4999497697,false,2303,990046
c7917e71d926216095a92352b8092ae94742a01a0ceaa33035ff3e1eff6f3e1a,990058,2020-09-30 09:22:43 UTC,42137339,42127939,false,9400,0
3f528debef19d8cdd41e5042028cc6427cf9698acfcbb1473ae6757dc7ab1fa5,990058,2020-09-30 09:22:43 UTC,1320773955,1320763955,false,10000,0
b06dc2dcba827adb226620dcc5fa876c64f602d9645a869407205b79916e6ead,990057,2020-09-30 09:22:07 UTC,135265166,135260675,false,4491,0
48c28cd15360f462ab4e4bfb96744c0371be1add4ff60fc6f047232892e2b9f7,990057,2020-09-30 09:22:07 UTC,686166186,686090986,false,75200,0
eef557f43ecaa7f71fd31a00eb4e36d9550086364541e6bf39b9f340cf7c30ac,990057,2020-09-30 09:22:07 UTC,10000,0,false,10000,0
fce87b8c3b0ed37d75b2b94399c45f376f7fd9ead503b861395a588371089e1d,990057,2020-09-30 09:22:07 UTC,500139764,500129764,false,10000,0
061f9e6d351878140e50ffad7e2a5e3d55e4ab51d32d0c709e3a7d4e186f4c39,990057,2020-09-30 09:22:07 UTC,19911643428,19911633428,false,10000,0
436f6674b74516119342cf3e1232817823a451f8adde582d8a9faff789a7add2,990057,2020-09-30 09:22:07 UTC,100000000,99997550,false,2450,0
afa377379f67c3d3402ac1141b008bd1489ec67e723124ba2ad46ddf76394af8,990056,2020-09-30 09:20:19 UTC,518248640,518230057,false,18583,990045
b83e6f081c5a03061f586f23538a3ed85bcbe7eaaf7f52697ca40d82089586d5,990056,2020-09-30 09:20:19 UTC,1509796574,1509696574,false,100000,990044
edd52d06948ab010571cbf96174f79e3a4f2ade1d86938a85b2178ffdc635871,990056,2020-09-30 09:20:19 UTC,1542000000,1541990000,false,10000,0
887ef65ad7a9894b902b3afd0afb680c4066024cc3ee69dd55c94cb5512ade0b,990056,2020-09-30 09:20:19 UTC,1189680276,1189677973,false,2303,990044
9ad644284fb1f526f97fcad8e83697e82a276f32da9d138620e2697db959de8e,990056,2020-09-30 09:20:19 UTC,1320783955,1320773955,false,10000,0
a2f933fe3f56647f4ad56599ea991c1522f6791ffd608ce6a2fd27d0241b0622,990056,2020-09-30 09:20:19 UTC,10000,0,false,10000,0
e3d894dfbcdae07837f6d9f0412a3a124a3279104266bd5da1359f197c52b010,990056,2020-09-30 09:20:19 UTC,10000,0,false,10000,0
c57019ac7ec7fd1e374415354027838373e7935d13b7b4a2a6ad4306b2323216,990056,2020-09-30 09:20:19 UTC,26679302602,26679290227,false,12375,0
de334846db7a4b69605043af4bce57f7343e60aa9fd6644621b517c0ad3db7e6,990056,2020-09-30 09:20:19 UTC,290859446,290841198,false,18248,0
7b12f1a04094c3d12f486e72cd57354c727c3b50f2aab8bf31fe786fa05a63ad,990055,2020-09-30 09:18:05 UTC,500101050,500091050,false,10000,0
81fff39dbdee4ebaef867e70c8714a5843a95933755081850e4970b9e7f73a9e,990055,2020-09-30 09:18:05 UTC,128457739,128455436,false,2303,990044
94ef3d4256f5dbe33641cf756d779d5b1445a1b683cd1cc36cad2a6bfa792cda,990055,2020-09-30 09:18:05 UTC,140223756419,140223740839,false,15580,0
4e7a7ad26761f2c17f41adabdcaec200fffd8c1ab4f2af5b82709de9f915a76b,990054,2020-09-30 09:16:32 UTC,10000,0,false,10000,0
81a72e49f673e992ac196df603859fa9187abcfb4b3cb77923b418e9f1966417,990052,2020-09-30 09:16:15 UTC,188313740,188310780,false,2960,0
4f9fae33985ff5818a8fa98381c5c27f374b14cc8981bd5364cd820b73dc5c1e,990051,2020-09-30 09:15:17 UTC,6749290400,6749270400,false,20000,0
0c38085421e4d81a83fbc3963ffeb7ad30bfc978f2b3d200b8f280970a9c45da,990048,2020-09-30 09:14:51 UTC,10000,0,false,10000,0
c7b319069ff8ca357a7682ed599b9bf309812da26ec2b3783424556ae773e1ae,990048,2020-09-30 09:14:51 UTC,4999737687,4999727687,false,10000,990033
933139decc899886fd6cc6d3613b965482683e1ccf189c0a5cd30861985dd7f1,990048,2020-09-30 09:14:51 UTC,2455318160,2455298160,false,20000,0
ff36ed889f7aadf0556f90131085b758dba61d2db356d46a3b8c6e749188323f,990048,2020-09-30 09:14:51 UTC,10000,0,false,10000,0
a04cac9cc35361578c2cc791f0c47eff08ac6db960e2b7feb36bf6ae2a22fd4a,990047,2020-09-30 09:13:04 UTC,42168740,42159340,false,9400,0
2fd98f38f2aa48f1fdbc1c8c97936ffce2d0419243922d9e7664d5221cab5bb0,990045,2020-09-30 09:12:38 UTC,10000,0,false,10000,0
3fee199bee8f1000bb4f51ac7bfedb43f8f2b6c2d1a4f7482f9c375b9b053e36,990044,2020-09-30 09:12:23 UTC,904730508,904719602,false,10906,0
e1e326a4bb7c83df08bc7a51b6a1701678b77e2690a5d8eb5dd3625c50d08dad,990044,2020-09-30 09:12:23 UTC,1688727859,1688725556,false,2303,990033
ffb2abe7f0eb60e58171b57069a0f4c389c81331af0aad028cc87eea11445d51,990044,2020-09-30 09:12:23 UTC,500111050,500101050,false,10000,0
716a12ff3291a5ba4bc0aab735600a8aebe0ad4ce8b483943c830362eb045b34,990044,2020-09-30 09:12:23 UTC,2500165626,2500000000,false,165626,989956
6f0a56aae5d8dcf9d0847b23efc612f35ec64ba534929b7402b7d174fba5ee20,990044,2020-09-30 09:12:23 UTC,10000,0,false,10000,0
116119e1537b56e089b6818d65f7ae86dc744521949213b30e2f945f7998e385,990044,2020-09-30 09:12:23 UTC,500000000,499990000,false,10000,0
ba9071e1497f6e32d64d65d1720b4cbabf984f8d3b22372e8ca51816969c5b35,990044,2020-09-30 09:12:23 UTC,17774872,17765472,false,9400,0
3100f16277c18d98d55f6c5e54502e1f175fa88780cdf0a2321df68ec8df73c3,990044,2020-09-30 09:12:23 UTC,518869995,518845010,false,24985,990033
11650ca7b1728cb17c8c473f7d4e58213624132a56b6ec900103aaae49ae2fa4,990043,2020-09-30 09:08:25 UTC,500121050,500111050,false,10000,0
d9564ef06fd935b577f4ba1ce122ca59426909adea42729730b00dc1a4e32e49,990043,2020-09-30 09:08:25 UTC,3456010000,3456000000,false,10000,0
d18e2e8b1ac39bb7ecb107115cb711d211b13b7418cfd038ca2cb73eb440cf97,990043,2020-09-30 09:08:25 UTC,500000000,499990000,false,10000,0
ecfb5124e0be1dc27e38ab42d7c025d46ecbc994376bd063f006f798a511fc3b,990043,2020-09-30 09:08:25 UTC,1000054040,1000044040,false,10000,0
215094d130dc8fc1017386e53ef66930aef3f4aa7c3e830356831a8403250917,990043,2020-09-30 09:08:25 UTC,42201533,42192133,false,9400,0
1f2b2d091daff31eb90de8ebc527e5033ecea2e789e976ffdea721475803e3fc,990043,2020-09-30 09:08:25 UTC,16259000000,16258999929,false,71,0
784efcab555ae831780940a61c4e7f8244b980a3f7433de4c5e724524642efa0,990043,2020-09-30 09:08:25 UTC,10000,0,false,10000,0
169e5deb3b569ea3a36c0e103775aa7d96f59b13b0fcb1580a0d2a91b459fbd3,990043,2020-09-30 09:08:25 UTC,10000,0,false,10000,0
65636a0f9452860393bb0a4cb20014a4733b4d4fd3771e94926b894e50aa3053,990043,2020-09-30 09:08:25 UTC,1985011283,1985001283,false,10000,0
f866d82c1f807c60fddfce2a0690afe4daca6142bd35b299658f0684642e9f6c,990043,2020-09-30 09:08:25 UTC,158948032,158945729,false,2303,990032
ef02f004dd91e34792796217bc730ac31b39aad6df29bee911f5aa117cdcbc5c,990042,2020-09-30 09:05:43 UTC,47935265,47932962,false,2303,990030
40b97f2cce8ac454bc02527b4bc1adaaf2a6100f738824e4f8e1d94117e5152a,990041,2020-09-30 09:05:23 UTC,6545781362,6545751362,false,30000,0
66db50a2f639a6935897bb5ea58ca880e592383fe431fd7470b70a1f84dd83e6,990041,2020-09-30 09:05:23 UTC,1500220287,1500210287,false,10000,0
7d5b6705949f1f8d33366ea5efe460baa585bf641de5f99b9de92aba6dd3b966,990041,2020-09-30 09:05:23 UTC,1000119074,1000109074,false,10000,0
13d930912134106d3ebf65cf4945eec661e3b3f1d1d1799a65f25f037f427528,990041,2020-09-30 09:05:23 UTC,241736798273,241736788273,false,10000,0
b7451d38f8cc8e223a13007b96e7a2900f1082616fc3549fb00a8bcfee807421,990040,2020-09-30 09:04:15 UTC,10000,0,false,10000,0
da46139ccc1dd4a8e12930d71d10e732dc1dfc2f749f7d76f3804d5d75830f7b,990040,2020-09-30 09:04:15 UTC,644702595,644700302,false,2293,990029
e40cffa1f484ba31434c687d65b554d2be978430b975ffb3e29de6bfb16ed1f9,990040,2020-09-30 09:04:15 UTC,282074784,281999592,false,75192,0
88112bc5af00baf0fb4e946fc5c7e90d5e47040cd865c27b2dc16ea781d2e8f2,990039,2020-09-30 09:03:35 UTC,1542010000,1542000000,false,10000,0
f3325d7bf7c55164533be5a9aa363c58b342057e4955c444f878966d788024c8,990039,2020-09-30 09:03:35 UTC,6951474394,6951444394,false,30000,0
efea82bae122cb6cf1c08074de5ad81eee85fbb95fbb6dd2cfe7a92547361d2a,990038,2020-09-30 09:02:07 UTC,19834758960,19834748960,false,10000,0
5ac81ad3aaa1bb86d79d64434202a329c2ec0b1d9eac60466f588bef17772301,990038,2020-09-30 09:02:07 UTC,10000,0,false,10000,0
9ceb31ee0d51d4251ab29fb5b8ec4dd74407599c16ccb1ec3fe256299b892db0,990037,2020-09-30 09:01:47 UTC,725216326,725212435,false,3891,990026
dceff7c5a2927c2028dd626c64f907d0c969bc98260e80fa270aa30fb7674f11,990037,2020-09-30 09:01:47 UTC,2862803955,2862793955,false,10000,0
9befb9b0fcd946cbec85f9a28f3dabe304fe11c23d84ea52bdbfa5a9a5793b66,990037,2020-09-30 09:01:47 UTC,141386371,141383411,false,2960,0
04ec5ff710dea2f73d50fa782ef55d274547a2840c75d7ae4ccc5cd88e399da8,990036,2020-09-30 09:00:25 UTC,812982469,812979207,false,3262,989977
a9c802ac9e702e65e64e98d2881290ad3067469a2ba674aecd467569694a6969,990036,2020-09-30 09:00:25 UTC,1596773660,1596771400,false,2260,0
a8ae20ac92d7015d06a5581711f6f54b2a324c23cb4fae98d40c9c32399afa5b,990036,2020-09-30 09:00:25 UTC,2023727711,2023727640,false,71,0
6b4b8623bf7420c32f6ea6bc901ac9b409415ccbcaa54489d9710792b1ab0c58,990036,2020-09-30 09:00:25 UTC,2852805875,2852803955,false,1920,0
8273ee8cb12efc91fc257d04f5692ababc7d1c1f861304895ed87a4328ab3de0,990036,2020-09-30 09:00:25 UTC,519511622,519487283,false,24339,990025
111489f71cd35fafe878b3dd249a9495b1bfd2dc0f02454c0556ce92a80dfc87,990036,2020-09-30 09:00:25 UTC,10000,0,false,10000,0
9d8f9aee682a341d3c0e1a847278a607c109c0e95d26da8f0428d06aa9631b2d,990036,2020-09-30 09:00:25 UTC,21287154673,21287144673,false,10000,0
e4cfa02d76b35948d4e3482c65ee72cfed583383f3a547c06576d0a6cd4a3693,990036,2020-09-30 09:00:25 UTC,125000000,124999548,false,452,0
3e244de8118ee48c681fbf097c0c14bd12bfbfd4033666719d5cb2f34edbb1f8,990036,2020-09-30 09:00:25 UTC,10000,0,false,10000,0
545beb5d75ef300d9cfd6df862c47cdb23fc04317dd99acdec03fd86b005fb1b,990035,2020-09-30 08:57:27 UTC,474060797,474058494,false,2303,989988
b2b283a31a648e82bf7aeb22d0a4af119db811a03559bb9c20de60cb74248d2a,990035,2020-09-30 08:57:27 UTC,2862808135,2862805875,false,2260,0
e6b1dafd6770f157eb467bc419630d2d6701a15550d96d72295b4f5eb38b9673,990033,2020-09-30 08:56:31 UTC,135473440,135470480,false,2960,0
b763888395939c227e066cf521e6d52b17f0629a2ad564c98bdc97eb96b5b5c4,990032,2020-09-30 08:56:02 UTC,10000,0,false,10000,0
e149abcab440c125201dcd6ab5d38112ab50ed710b0e7763344785d46e9aba3f,990031,2020-09-30 08:55:30 UTC,2900647,2891246,false,9401,0
0019badadf58ac709a251963a908dbe545665e990166d492a436976a10c3f69c,990031,2020-09-30 08:55:30 UTC,411673032,411663032,false,10000,990016
014fe8645d642ab4fd8df8d3d6e2dfa0a7a632e09484b8af6b619dace23798ff,990031,2020-09-30 08:55:30 UTC,22712687,22706227,false,6460,990019
7a33944e3e1ab43a5c697ed7272e7d3fd5b9c9fa0430529924e2d70db2363d00,990031,2020-09-30 08:55:30 UTC,2469046444,2469044184,false,2260,0
7938ffee1acbe5a2c49c07c41fd4d6af333fee321f11395c3b46f317289bcd5a,990030,2020-09-30 08:54:32 UTC,10000,0,false,10000,0
4b1b29f65120aca27974a3c074bfa7e636d32705ada32f48c0aabc47a9055985,990030,2020-09-30 08:54:32 UTC,597000,594550,false,2450,0
504bfaed574ddef68f0fc7018137f1017f7d15cdadee1f7ed3239dcaf2a40efb,990030,2020-09-30 08:54:32 UTC,390036390,390034100,false,2290,0
aef678e1494d5cea7fa538a639709df635012f0e2f1c23a0df6ad45d76fa32ce,990030,2020-09-30 08:54:32 UTC,188586952,188583992,false,2960,0
7113b8b3195d5f5f8b3d58f0c8881e9411159a623cfcc8e9ce5deea50900ac7b,990030,2020-09-30 08:54:32 UTC,201036195,201018195,false,18000,0
e5977b586aff85dbd219a17c51a9ce638d334fd3db110b7d1572af341752c0b8,990030,2020-09-30 08:54:32 UTC,1020353,1017903,false,2450,0
ee8aaf8c077117200cc67a235c3aa8fba152b243b632a90ee551a64915a23c46,990030,2020-09-30 08:54:32 UTC,10000,0,false,10000,0
9aa1896a91f9e2a0bdddb9d8f38e6faa6d16a5ade76b5e13a504f15df189f605,990027,2020-09-30 08:51:57 UTC,519902948,519882473,false,20475,990015
72686ab485018d81527a11785f2cf74e4f388a98370846ceac030833b94d510d,990027,2020-09-30 08:51:57 UTC,1708210152,1708207859,false,2293,990016
a65198e680495b21faecdfa2fd67db27dc2c541c5e1f3b7defbf0c66402642f1,990027,2020-09-30 08:51:57 UTC,42444791,42435390,false,9401,0
27ee4b8f621b2b7b54a9abb49c7fbd7d6fc661e720a40a6292eaca70b5a26d6f,990027,2020-09-30 08:51:57 UTC,15463033,15457957,false,5076,990015
17230edac937028088ecbbfb706b91ae397788d96643f29585d24c865b5d827d,990027,2020-09-30 08:51:57 UTC,2000021498,2000011498,false,10000,0
1f1adfb08548393b09840827b953fe674ccac30ec9f0f538ed8096160195e39a,990027,2020-09-30 08:51:57 UTC,89707613,89687237,false,20376,0
2fa93cd581f0504b78bda32c52808d7a28996a82e9d9e14bec5c784479db8fbf,990027,2020-09-30 08:51:57 UTC,231098,221098,false,10000,0
b455b57c3f8247e277b5581b94b6d7303af99ff5c7fe9bb55d162bac1c8d8471,990027,2020-09-30 08:51:57 UTC,608988150,608987630,false,520,0
77dda5ba458ac9b6ed328b2c016c590d397541f84f8285faaeb2bb57ad8851e8,990027,2020-09-30 08:51:57 UTC,10000,0,false,10000,0
81b2a70743ec10f316805ac3f1c4f74824595d521f0878a96620a7c7148f3520,990027,2020-09-30 08:51:57 UTC,42277863,42268462,false,9401,0
a8e55ca6295f9159f306a7d3258af09627a84037cc4eea7d65ee210554723694,990027,2020-09-30 08:51:57 UTC,141550181,141547221,false,2960,0
aa6acb3f560e3f222eb47a5e39c61b37424eb83bb1406c0668cb17ef3afbc55a,990027,2020-09-30 08:51:57 UTC,108628579,108618579,false,10000,0
9fe339eb1f941fb7623912c695749428ee961f40ce354078c9bafd888c5b39c6,990026,2020-09-30 08:50:07 UTC,142500000,142424784,false,75216,0
81ee2a23f37f842580e8d183217845a422e11aee4a92e1b881496edea0f90fcf,990026,2020-09-30 08:50:07 UTC,10000,0,false,10000,0
1dde68924dcabd9aedeb3d79abfd0d628ab9d5dc0b4aed6382915eccbfd90d45,990026,2020-09-30 08:50:07 UTC,135621010,135618050,false,2960,0
46f18fe073a959f188783c2c093c963c85b4994f78f7240f65f98be4bc2fc202,990026,2020-09-30 08:50:07 UTC,10000,0,false,10000,0
44cfe4f04b5bfdbb4645fa2c32ed856d84191968de7153e8ff59fc4087b67ba2,990026,2020-09-30 08:50:07 UTC,2721960432,2721959244,false,1188,0
348dc30f7d4adfb5bce7a7c8f97d3dabeae6669520213f24c2094201d641e5a7,990026,2020-09-30 08:50:07 UTC,101495014,101492478,false,2536,0
2e2cca257fd9bb3e5d79aa556b58eb065649f29bcf78c4cbc6d9267c19ce4b7c,990026,2020-09-30 08:50:07 UTC,179085389,179083086,false,2303,990015
9b81ba74e836a92824d671872fe867b2715fa5e7f2ac4f5ebc872ba969fcc80d,990026,2020-09-30 08:50:07 UTC,40978037270,40978020518,false,16752,0
487c29ac1d465c91f7cd87044bb9e5be61951178e4a44aa07b3896c4eec95aa8,990025,2020-09-30 08:46:51 UTC,10000,0,false,10000,0
4533fc430e85198b6aa8bfbdf9da837e25b2d1d1c81fbeb8e03926c52f0b02bf,990025,2020-09-30 08:46:51 UTC,121650515300,121650512610,false,2690,0
e717e52cf1429bef637bb0353088e54b3ca83415ac5703ae7a9c5b4ccf7f99ce,990025,2020-09-30 08:46:51 UTC,126699961,126650558,false,49403,990014
4018e22cb9a70e1c7c8e73b59f8458b62f4d5ae4a683f1e29f040feb0a0d352d,990025,2020-09-30 08:46:51 UTC,500000000,499990000,false,10000,0
297c456efa89b9858e36d02183208dcc42bff59d4b8916508ccf68a3822e5f0e,990025,2020-09-30 08:46:51 UTC,101496934,101495014,false,1920,0
ac632e00f19f5100d96d4af4c24e0c18c11ca92e4e4a5aa837269d66e0043a7d,990025,2020-09-30 08:46:51 UTC,1040000,1039808,false,192,0
a669cc6f5337982a99c13c5b1b08ae095228f193da8f14d78b7bb5d07dc08850,990024,2020-09-30 08:44:46 UTC,10000,0,false,10000,0
0dd5213cbe86c6e1a17bf7786216dd1eb0ad631e5dc9c17087c052ae78e40a9d,990024,2020-09-30 08:44:46 UTC,6619659,6611819,false,7840,0
701e1c1909c46dd79054949850881e0298abd3d84471523b384cca9a27aee3c1,990024,2020-09-30 08:44:46 UTC,20787174673,20787164673,false,10000,0
32543ea9992d89a21648db65effe3c9d6b7a749d1a3551d06dc3bca75a63dbf3,990023,2020-09-30 08:43:09 UTC,101498080,101496934,false,1146,0
9e4e200e3b4ea85d63a147a2183a9dae7e740c2e823c06221efcbcb36c6cdbc5,990023,2020-09-30 08:43:09 UTC,500010000,500000000,false,10000,0
5311e9c489ec18fb973b8eba94ecd79d5bbfe6c0d0e50e6a9a6122cd28711f80,990023,2020-09-30 08:43:09 UTC,50000,47550,false,2450,0
2f273f772a78c4ee384a2600a564558a234b3c5988a937f6b521620f9cc8b3cc,990023,2020-09-30 08:43:09 UTC,42646445,42637042,false,9403,0
25cc5450a7332400c23c8f9ebfe74643ceaa51e83d3a4c83d2a2b7808f4c51bd,990023,2020-09-30 08:43:09 UTC,188748943,188746594,false,2349,0
990bf501cc781fa57f8d2b0c0b95a9043da6771d712add8444f8b69fc9dcbac4,990023,2020-09-30 08:43:09 UTC,8468154,8458154,false,10000,0
ce196bd68a14b035943ae68b58771f1e0e9af68ca4d9311d20a10374f3885f5c,990023,2020-09-30 08:43:09 UTC,21186078430,21186068430,false,10000,0
28611fabd0043eeb55162fbb70bdde520eedd79f9595492217cc1283f9ffdc19,990022,2020-09-30 08:41:47 UTC,85111209,85106535,false,4674,0
8a658fcb0ba8c40d296cddb55cde5fadb1b21cfd259674d973c6558d011988d1,990022,2020-09-30 08:41:47 UTC,42843237,42833834,false,9403,0
42cf50de79ca00b0eab1fa086aa1a797a735b837ec318dea7b7cd686d59df9cd,990022,2020-09-30 08:41:47 UTC,10000,0,false,10000,0
0b1a2530c1340971c034f7615c5e244d4a7a78972f755507a67aa48a280c5b6a,990022,2020-09-30 08:41:47 UTC,31596763,31594460,false,2303,990011
30dc8c74c4865bb5d2880d90a80f92f5e9642b8dc92c5a09c1155c79955883ff,990022,2020-09-30 08:41:47 UTC,21186088430,21186078430,false,10000,0
8f14c8bda10308ee786cb92c409dfc564e2b61947e1ee3251381f271800fc340,990021,2020-09-30 08:40:32 UTC,520181359,520164688,false,16671,990010
f21a6e192d53e1718e007bfafe44c9a026f74335392dc836b8b0f712cfadf274,990020,2020-09-30 08:39:34 UTC,10000,0,false,10000,0
9cc154b3f370c1d807896a720ca0338cf8fb4c4f5cc9728d9994c5605c227640,990020,2020-09-30 08:39:34 UTC,10000,0,false,10000,0
a302df598db2ac5aa2d430606312d6df0f8848e05144b0d22ad899e91cdae9af,990020,2020-09-30 08:39:34 UTC,4571020590,4571018287,false,2303,990008
61dc2407886fd9bfa2370d7641215b9f8b97f22cd46f71a3cc4062a8c7279e02,990020,2020-09-30 08:39:34 UTC,1000197592,1000187592,false,10000,0
9a746c1dd950bdc05c013a9d48b58feaa98932b240d2bba6ad8895084fd52abf,990020,2020-09-30 08:39:34 UTC,10000,0,false,10000,0
897d7e6769310bbe5fd3d539f495176ef9f66087bdd3491c80fc8b8676624696,990020,2020-09-30 08:39:34 UTC,1377885402,1377882952,false,2450,0
247cea0f7de195cbd2b3ebc7f612c5d64f175d4f72ef1590115e895bd5af3bd4,990020,2020-09-30 08:39:34 UTC,500171821,500161821,false,10000,0
f100ff2113e5114f2667e78d8eab15b907c919c99a68f7559e9754131227aa0f,990018,2020-09-30 08:36:44 UTC,2347639,2337639,false,10000,0
ce9a459a58b11fe04945c315cca289b5face6e2991cb808df0757f1619548678,990018,2020-09-30 08:36:44 UTC,5072117,5043785,false,28332,990007
ac37122a3a89e5f5479223120286421ebae0b1d7d1a5dea7e216aae519edbb5a,990017,2020-09-30 08:35:18 UTC,355684428,355678428,false,6000,0
09a6e1a9e0a87c98692aacaa12c7c105eab5a7a66c2e80dd5e911645168a40f8,990017,2020-09-30 08:35:18 UTC,10000,0,false,10000,0
f478b894342168dc4e26b765533dcbbe577959e1ed504069e79cd77423e82d41,990015,2020-09-30 08:32:40 UTC,514084,504084,false,10000,0
f4d31c6d599991299053425bf7c93ad74339e6bc5b03d38a4f612b790a0adbeb,990015,2020-09-30 08:32:40 UTC,10000,0,false,10000,0
8155a93c090a901b7bfe7f23a8f44a514950a7b855532bd074bfc532073be32b,990014,2020-09-30 08:32:14 UTC,240225842,240223392,false,2450,0
588015d72e0f3dd3995d8f161c2d262e9b558adef28a35477ec374c78ea02a2b,990014,2020-09-30 08:32:14 UTC,7169299793,7169297490,false,2303,990003
63ecc00c2be675e6d677f0a5df588c7542a942f7888f86404e5f6eb927d4ea71,990014,2020-09-30 08:32:14 UTC,500243797,500233797,false,10000,0
d50e5e79722d445956cf5575c70aaac417fdbebccf1b63555c1e03ec75191eff,990014,2020-09-30 08:32:14 UTC,1083051250,1083048947,false,2303,990002
4118fe5ff807ef414a4d7cef4c6ecdedb02f94ecdfd9b43a59c772ee64f3c6f7,990014,2020-09-30 08:32:14 UTC,14326876189,14326874607,false,1582,0
d84507d7e2a5b57e03a2796263197107161672defda1a4962302aba5991f8361,990013,2020-09-30 08:31:07 UTC,141793763,141790803,false,2960,0
5b6a9aaf5b581234bdc39f5df6e73ceb2b67564d31f4fcfc3eba5b181b90fe65,990013,2020-09-30 08:31:07 UTC,520778048,520754654,false,23394,989980
75fa9384877136f17694c1edd408b74259125aff8023fe74a83db6d5e1c4e2b1,990013,2020-09-30 08:31:07 UTC,10000,0,false,10000,0
64eeaad475f04e79ebfb1a599cb07ef7dcf73e1be19909b13b47e00ca5535e02,990012,2020-09-30 08:29:51 UTC,130010000,130000000,false,10000,989998
21c0a67c010f64eaa0167f6387c586e49874ec1861d3d57869ff411875516f10,990012,2020-09-30 08:29:51 UTC,50645300000,50645296346,false,3654,0
63617751f42b2a5e8a493b0dbbd65da89428f3c38db18eb4a8adaae62f2bc3a2,990012,2020-09-30 08:29:51 UTC,1379843553,1379841250,false,2303,989999
7cab05d6affcd28e39bbbd7e0b1ec3c9bef5e5982d4254642d1bdd199fa0d8c2,990012,2020-09-30 08:29:51 UTC,500181821,500171821,false,10000,0
b4698c02f7a81ee5105c741993e84a04ebb88e05f8855a783b3d0cecec07899f,990012,2020-09-30 08:29:51 UTC,500253797,500243797,false,10000,0
2650e65d84f00ff1a1a7dc61175adfa82f15ae1002adc33ed62f49fe8ea9b87e,990012,2020-09-30 08:29:51 UTC,10000,0,false,10000,0
16214b89663cc7d9e5a068a8c2a6b485f6d4677a8345ed396c77773fe742f535,990012,2020-09-30 08:29:51 UTC,4551073854,4551066853,false,7001,0
a196f9b5e8623128c87bfc9c13dfe65056dc29657a7ea17fac1fe7a7885cbffb,990011,2020-09-30 08:28:38 UTC,142500000,142424784,false,75216,0
10a9b22f9f6b36ad6bd3d73e30cb64df061058ee82bc6844663cba3ba87ee819,990011,2020-09-30 08:28:38 UTC,42938874,42929471,false,9403,0
c229ffccb22911c4c5eb1b97128d4b919d64e0c4b3fd36a5d44ba73f55f8435e,990010,2020-09-30 08:28:01 UTC,3321431157,3321427776,false,3381,0
6beecdd71ef48c572cf53d3b84b5a2347db483e74f7e0a1ae13f9e3381dad12a,990009,2020-09-30 08:27:04 UTC,135752227,135749572,false,2655,0
f326ae400f59bd7856a2899951cf5668b0500298b7ae03f0c1bd820c72944441,990009,2020-09-30 08:27:04 UTC,500191821,500181821,false,10000,0
46f12842d9baa2273567402382c6da23710bd422956cf3a4305eef6b96b26c94,990009,2020-09-30 08:27:04 UTC,10000,0,false,10000,0
96df7dd8c79e905e441ab862e2547b6934e5bc3ed9b14648f785bca33d7a76fb,990007,2020-09-30 08:25:06 UTC,10000,0,false,10000,0
8ce1788099e250bbb0bc9f8c86d6bc5a3971f02fd14a9e01631b1874efd8b4f4,990007,2020-09-30 08:25:06 UTC,142976,132976,false,10000,0
3db24ab22f60861bd507bb648624aed12c691ad1df884f8fe2556bc31d7eed5c,990006,2020-09-30 08:24:40 UTC,236527757,236420001,false,107756,989897
360ece73422438a1da5c4961af68df3989af4e40ab4f8be93b13bd94624952eb,990006,2020-09-30 08:24:40 UTC,10000,0,false,10000,0
125d5096e50fee77cdced2e8f916c291f7465850d5a9d55a95f18fa75ed60971,990006,2020-09-30 08:24:40 UTC,10000,0,false,10000,0
61f02d66608f03f9455a3073d403d4fd062e0be4de71f1144cd1867603774388,990006,2020-09-30 08:24:40 UTC,35394000,35384000,false,10000,0
e57c2fa731267bc8d563e824b690e94db060132a52c64b90a91020d01af2e4de,990006,2020-09-30 08:24:40 UTC,10000,0,false,10000,0
bd978aeeca1c3d23df85b46a855749142b7df42d6abbd0b89cf333328a13c288,990006,2020-09-30 08:24:40 UTC,26783137905,26783119245,false,18660,0
09d5fc9ad44508cb3ca87fbbc3b61ba0ae97ea995829486ec25d3e3aebe4b468,990006,2020-09-30 08:24:40 UTC,521165587,521148908,false,16679,989995
b67a9a037bd93cabd50a23050ba4289ff4f7078f5428398cceb2e965fb3d0319,990006,2020-09-30 08:24:40 UTC,205064010,205061707,false,2303,989995
9b222d17f33bf6e3c0a360f299bb872fa2ce1ba52863e141a51b7e170d7d1781,990006,2020-09-30 08:24:40 UTC,47121874,47119580,false,2294,0
5c4d697e8bbe637d8200b56b667917da4b45c9da11cf712f9d57c79903c2472d,990006,2020-09-30 08:24:40 UTC,7569302087,7569299793,false,2294,989995
58561bed9ddac88968e524f0af8989c93bc18ef6839224c638b0c0f47dc7c20e,990006,2020-09-30 08:24:40 UTC,10000,0,false,10000,0
b11fb1dcb527539c76bcf7641f0f955aedd0d09bceb467ebe7c3f9a8a0dcc968,990006,2020-09-30 08:24:40 UTC,42992844,42983442,false,9402,0
b7288d3af5abd9daef234a46bbf697608d65e0af804fe79e95b65bd852111562,990005,2020-09-30 08:18:25 UTC,1999960834719,1999960832416,false,2303,989992
6280f5711f73370707f9e3850160e6b3d56c42d2f3bac458e5fdd804c62731df,990005,2020-09-30 08:18:25 UTC,16634127,16628127,false,6000,0
cfe6bdda512d49e473ed0235e36588b5ecc49788cff5d47b1b34debf1855428b,990005,2020-09-30 08:18:25 UTC,35709425,35704751,false,4674,0
a80800cc2ae2d7e0b395e56cd8ef3bc33f842115a7373fc4d838947ccb2c3235,990003,2020-09-30 08:16:38 UTC,376358289173,376358286870,false,2303,989992
30455adef47f5b2f8bbe8a60902012828b091822c75d21cec08b794947532434,990003,2020-09-30 08:16:38 UTC,10000,0,false,10000,0
cbb7aa5776e0de2977e585161e87c4231da067d59ff8d0adb1dc10f609bca27b,990003,2020-09-30 08:16:38 UTC,189027119,189023240,false,3879,0
b9522bbcc8536112618df910b7704228090fc97ad5409c3cd0800616743b6055,990003,2020-09-30 08:16:38 UTC,43028474,43019072,false,9402,0
d4f157a62d28b3f1795c8148bc14b8e8cdf3676e49ddf74a8a80e467895178d0,990003,2020-09-30 08:16:38 UTC,1606821,1597579,false,9242,989992
fa6f6fc799f8af9267657ddd27bc5a03d784aed039779bf0e41c422510766bfa,990003,2020-09-30 08:16:38 UTC,521058,518440,false,2618,0
16cb6c2288c45d350c3310eb932f9f1422f16cf072ba025d22a85ae1e549d73c,990003,2020-09-30 08:16:38 UTC,10000,0,false,10000,0
991e09ec60c6d1d26667f28378071f75aa2921706bb799963cac61b2977dfa97,990002,2020-09-30 08:13:43 UTC,4478000000,4477993000,false,7000,0
f4b8d9a70de4692198b5a7fc8aaccb7cfb59293c08d8a9bed02b6b52d8d9b254,990002,2020-09-30 08:13:43 UTC,392020491476,392020489173,false,2303,989991
7c8af13c78ae4c9fc189a27861a606b5f2c8479555caa017eb32e82e6cbb969a,990002,2020-09-30 08:13:43 UTC,20370409137,20370399137,false,10000,0
f66d9a5c098d6a38f7bbe5dcf30bb8ed44957c18eac55b6861afdce416476365,990002,2020-09-30 08:13:43 UTC,10000,0,false,10000,0
abc4af299c17d8f0bef4ad2733f6d9f705ce0e39848c081eb3ae91a687278f8e,990002,2020-09-30 08:13:43 UTC,18255543,18242136,false,13407,989990
5289852f62a8f88c04ec9f6c5edfb47820e94402378e1c7fe3f4886c0cc63ec5,990002,2020-09-30 08:13:43 UTC,1809845817,1809843523,false,2294,989991
152341d69eeb0491c5455123d73f0de66b8f6b379bdfeddf97cd491d9522f3dc,990000,2020-09-30 08:11:24 UTC,10000,0,false,10000,0
880fc681197a2d3d4fb69d3c4d25444e73889d34d6d8e8fb4d0d846d66e07427,990000,2020-09-30 08:11:24 UTC,258060988,258058694,false,2294,989989
80b21778c20fea498465c718177c4e069eb2d1ffdd053970f8d78f5614b23f49,990000,2020-09-30 08:11:24 UTC,521788429,521766640,false,21789,989989
8e8bb25689e21e6c73fc220bcddc30c9c7f6d5503f3a10a1ef99a8de0bccdb08,990000,2020-09-30 08:11:24 UTC,2500000000,2499997697,false,2303,989989
75f45b2f8fbf000d0177de3b0a649364fed9ea4c0efeea41150bbb8441044a4b,990000,2020-09-30 08:11:24 UTC,20370519155,20370509155,false,10000,0
38b8e41ca066b02cdc6aba855bf95f4028cc09d3be084ebaa6a8f5db05eb8ce6,990000,2020-09-30 08:11:24 UTC,1000114512,1000104512,false,10000,0
6fed3608d36210b1c387a1f08029841debfd3d03e02b259ce633fed35e9fc53b,990000,2020-09-30 08:11:24 UTC,142018768,142015501,false,3267,0
724e6291ced0fe87276efe810e812be03c4f54343402c2af50780ebc9041e5fe,990000,2020-09-30 08:11:24 UTC,1026307075,1026231851,false,75224,0
1ad2f9f394cb551f47eb67c92d12fed00780ac01c0f94ed7b235e29d8c40ead0,990000,2020-09-30 08:11:24 UTC,1483709404,1483641649,false,67755,989989
0456155960fd205989b1d3ea0dff8302501f8828590fd679ef22f44c77126d8c,990000,2020-09-30 08:11:24 UTC,136060857,136057897,false,2960,0
cb91ed44a1980534e551215827b0a40b47c99887c5ec322595eaf13a4a8336b4,990000,2020-09-30 08:11:24 UTC,10000,0,false,10000,0
782143e3599f97372b8a8bda3db0adb979df509a56688e14aed3026d586d40e6,990000,2020-09-30 08:11:24 UTC,10000,0,false,10000,0
2e81129e6ca2d1cbbf03028be26592f3e8762b714c4c293f4924197c6cdf9ba2,990000,2020-09-30 08:11:24 UTC,1000009413,999999413,false,10000,0
0046e7764a6230e845d6f8556102f3a4c04e1f4b0343d6291f361ffbe6016b9f,990000,2020-09-30 08:11:24 UTC,4478010000,4478000000,false,10000,0
353b2d0fba3f421f25b0fcfcdc6747adfc9c69672e4386c7b2166478682cf7a4,990000,2020-09-30 08:11:24 UTC,7646126990,7646124687,false,2303,989989
52206cb3abb842238ccc7624caac1008b9a776ca9264e514704da35256cbd704,990000,2020-09-30 08:11:24 UTC,306002501,306000581,false,1920,0
2b6689eb8ae4209ed8047c7539637bd46ce850b933ee8b41a134be747704f0bd,990000,2020-09-30 08:11:24 UTC,17234034,17216034,false,18000,0
e97644c31b4fe3af11277ff116145f0cbe5e9989673a4ef96512b8a949a18ffd,990000,2020-09-30 08:11:24 UTC,145997537,145943389,false,54148,0
ec2ba97d1ab6c761e56058efc37b9d53021745525700e4fdf45d6bc3bc382bfa,989999,2020-09-30 08:05:14 UTC,306012501,306002501,false,10000,0
c2fec6917d903136c805d5e39465140b920d3a05065cc5cc1d07b41e301165e1,989999,2020-09-30 08:05:14 UTC,200000000,199999548,false,452,0
73c642393138f3b354bc8364d8e40961574a15a818194cd63ab91d13ac54a8a6,989999,2020-09-30 08:05:14 UTC,568685982,568674086,false,11896,989987
ea78dc7251856f3f91d718ec974124181c6146e60feae6788380665016f08235,989999,2020-09-30 08:05:14 UTC,40652,38202,false,2450,0
010636cd8d2c80969adb1e4fd3962dc6c7a6836d7a8298341ebbce72c37064aa,989999,2020-09-30 08:05:14 UTC,10000,0,false,10000,0
56e41371c062f3fe56542b155995b33814752fd0e6cdcdd381bea04dd48dd1f5,989998,2020-09-30 08:04:43 UTC,20370529155,20370519155,false,10000,0
1163da57a28e642cf0392f477813dd9ad40b96e3c630a4a187bca4218b3714e9,989998,2020-09-30 08:04:43 UTC,1500230287,1500220287,false,10000,0
4034c4a78713b49c459dcf118c563f18eb2045f6a20eb50b9e73485bb0deca0c,989998,2020-09-30 08:04:43 UTC,43131207,43121803,false,9404,0
cf01c446c8a9951061e55ad238db06100928754b6aafa973338b0582fe8e1454,989998,2020-09-30 08:04:43 UTC,4579000000,4578993000,false,7000,0
5c24ccce79ebb9dc49ac4f40d20e257eb8478a7cf2d0753ea29eb25c5d53a01d,989998,2020-09-30 08:04:43 UTC,239667938249,239667928249,false,10000,0
6a68c04fd54f00fe75b1df40c60b6674da636f9a0614e89a31b7839f100a2369,989998,2020-09-30 08:04:43 UTC,43081585,43072181,false,9404,0
edca44f688b732d9aebd904808f4d6f26a80330bbeaa1631de4687493db7e3be,989998,2020-09-30 08:04:43 UTC,10000,0,false,10000,0
d39abac00cb852a6027438185d419c8e22680f16ce02d416670d3eaf799e2d0c,989998,2020-09-30 08:04:43 UTC,10000,0,false,10000,0
199957dbc701fa347492b7a7546bd161797dbc10a8cebbd009b5bf57c74207ca,989998,2020-09-30 08:04:43 UTC,2502371776,2502361776,false,10000,0
516d7a7bf8df413d0cf463d85c03b26a74c47dd2cd4bde12e3b33cb9e50ab048,989997,2020-09-30 08:03:32 UTC,20581723472,20581713472,false,10000,0
8340625fbae449d08d5b54d8b524a058da50777688098ba3becb01057f7f098d,989996,2020-09-30 08:02:45 UTC,14326886189,14326876189,false,10000,0
7a1c68f71b37ac1c5cc91e84a81f8849673bc4fff9b6e80373b49a04d7717517,989996,2020-09-30 08:02:45 UTC,4512362050685,4512362011775,false,38910,0
a2996278b04e0dabcd2729a38ab1cd68687c679a228eacd63817753b2f046202,989996,2020-09-30 08:02:45 UTC,10000,0,false,10000,0
c4c94327c36b6ddb3c78767ce05354f5447dd55325aba2f1bd5f21d2e343419a,989996,2020-09-30 08:02:45 UTC,10000,0,false,10000,0
55567ea52c06c7af1c5032255d507cae0ecb0bd635b94b165325eafb412f377d,989996,2020-09-30 08:02:45 UTC,926260,806260,false,120000,0
ac06caf56804ad7da3a72e6079afeced5a03df0de2eeef9dff811672bff182c9,989996,2020-09-30 08:02:45 UTC,20581733472,20581723472,false,10000,0
81941e8e0a196a72e8abe18c4af19b72129a7d5f732c5abb77a7421412ce0623,989996,2020-09-30 08:02:45 UTC,522252659,522232469,false,20190,989984
27e66554d43b73f7a153e7f305e3a5f85162d8ef91f07cfcca829919ae853029,989996,2020-09-30 08:02:45 UTC,14803716,14793410,false,10306,989984
8ecc327e3d3052cd15cc62118c7457f1cc45e4d1f55104cd4eeb138cf83f5a37,989996,2020-09-30 08:02:45 UTC,854819815,854816872,false,2943,989930
fd7ecddb250da1411133b29c69ac3cbcd8f603f64c3cc5e1b7bbc8ae74ea354a,989996,2020-09-30 08:02:45 UTC,43288748,43279344,false,9404,0
deb160e1ae9f5a1621010d5025e07715773541ca4653ec01d7a3b5527b49e8cf,989996,2020-09-30 08:02:45 UTC,1484879021,1484824638,false,54383,989984
46f71e054178010363630ddca7f3b5eac5ac2a202c57615cdbb37b52dfbe1770,989996,2020-09-30 08:02:45 UTC,2261410000,2261400000,false,10000,0
da8e0be48ad97c4530e0c22a9e8769a8cfb4a5c19e858e0b69ed6f524bafee3a,989996,2020-09-30 08:02:45 UTC,973370000,973365120,false,4880,0
cfe7eccb3837381480681599b0d4c52768b65e01a0b5f3aef53f245990465e0a,989995,2020-09-30 07:59:44 UTC,4579010000,4579000000,false,10000,0
148d649942aecb2b1639d18e3dee49dfc0d346bd339802e077c7765125833de7,989993,2020-09-30 07:59:17 UTC,55107847292,55107847192,false,100,989981
303c8acf9e914a6cfcddbe11c34237fa21234437e5273b8e3cf89410f2463255,989992,2020-09-30 07:59:08 UTC,1325310000,1325300000,false,10000,0
fb22f90283755a4919b264959e866dfad5db7cc69b85c6c22c1b7e983308dad8,989992,2020-09-30 07:59:08 UTC,189217990,189215030,false,2960,0
133761869c04f2aa68bfa29b8629c314f8b2091442e9163c299a2fb3f2a291e9,989990,2020-09-30 07:58:40 UTC,500002103,499992103,false,10000,0
c8f7e17a0edd8ca626dcfc496b98cb1d6d321dc21e59e92c437b89d67095a620,989990,2020-09-30 07:58:40 UTC,306022501,306012501,false,10000,0
333c761fc9972935c2f6bc345e2f973809310f52cf0f8c7203bf40b015f4c920,989990,2020-09-30 07:58:40 UTC,10000,0,false,10000,0
1e34971edb7ebd0184a73d2b29b30a6eac6a4cc97cc4666b4a86a6796d95933e,989990,2020-09-30 07:58:40 UTC,7783539741,7783537438,false,2303,989979
9e76b9c60b62eaacae0b7f6c65afd6c976fb8ac8a8d571414a8c344bf74c77da,989989,2020-09-30 07:57:21 UTC,10000,0,false,10000,0
a28c8fd37067b8decb6702f097db2e7e01a08bdb91dabc48bb2c208d6b6f7d0d,989989,2020-09-30 07:57:21 UTC,136483428,136479243,false,4185,0
66ee09013ed27280727230e6ea6a55b26d5eafb46934698646e166f4d189fef9,989988,2020-09-30 07:56:29 UTC,350000000,349999548,false,452,0
88a3473e327b9e2c3949f45a2074eeb40a0988539a06453125e768f557e62b37,989988,2020-09-30 07:56:29 UTC,905412898,905406898,false,6000,0
4e7c7aa3d395de091c69abbc809cace6db5f8c2c523d96f3b1d50d3f249e9e3a,989987,2020-09-30 07:55:06 UTC,10000,0,false,10000,0
06131b6d657ab13825bb879c9ee1dc04edbda74cb79e553a3d38e76236bbb141,989987,2020-09-30 07:55:06 UTC,2885109455,2885105715,false,3740,0
7953eaa520233cf8aa2a16164fd4a11cdbe6dd0b20d04a34bf56e9e1f734e065,989986,2020-09-30 07:54:30 UTC,10000,0,false,10000,0
4ae38a1302c896abebfd86ca109cdc414292825a1dbe58b71c4396d2a4f383ee,989986,2020-09-30 07:54:30 UTC,101500000,101498080,false,1920,0
151965b901518c1d5ca19c6a2db73f1de9b740e1415db509c7b0c7af449aaa92,989986,2020-09-30 07:54:30 UTC,118000000,117997740,false,2260,0
31a7e122a5dcfc391e979c362b8c114367aa7b56f7b5167ee2cda124f055c94c,989986,2020-09-30 07:54:30 UTC,500012103,500002103,false,10000,0
1cd19b78d9a58b14b60e3435f19141098ea9511acd0aca50cd14da6bcd82683f,989986,2020-09-30 07:54:30 UTC,4971721,4969461,false,2260,0
04c3835fa53f013cd9c32f8eaa3384bde22a26e6d381ebc6df424af3c6da838b,989986,2020-09-30 07:54:30 UTC,11436299751,11436289751,false,10000,0
8bf154847c33780ed8dd9e576a7c8f9fcc612c9708c181e7c6083d31a67b18c0,989984,2020-09-30 07:51:34 UTC,55117970872,55117970772,false,100,989972
829d02b3b3a69eb5a77150a60237a8bd35c93e6da0146225748412f07f1a719b,989983,2020-09-30 07:51:32 UTC,10000,0,false,10000,0
b84d954fd262c0c39b9a08448c7b4c4b1db8953037899391f0d2d1313e57ce63,989983,2020-09-30 07:51:32 UTC,500022103,500012103,false,10000,0
21d30f9163198f53cbaf51ea42c1c68ae61c46e0c25543acafd01a5a61502ae5,989983,2020-09-30 07:51:32 UTC,142500000,142424760,false,75240,0
460e975545c46aaa8cc6090491be1c48a7d46b83486a72753d9232f9e9a84d3b,989982,2020-09-30 07:50:22 UTC,522561894,522545519,false,16375,989971
60c942fed82f77dbd540043d073b8e94c48a439421275b4bd634ce0e4dde08a0,989982,2020-09-30 07:50:22 UTC,284427305,284425001,false,2304,989971
0513e64133cebd735f5fc3240396d3c6b69aac70e140bbbebef238dc19690e19,989982,2020-09-30 07:50:22 UTC,40131473,40125443,false,6030,0
8c244147537cb527cb86ddf397bacf3cba10fbd31f261aade949762b768f27f8,989982,2020-09-30 07:50:22 UTC,1486172987,1486122816,false,50171,989971
f184069c9a4c6671d760b4fee739b3d5ca379d1acfb2ee4826f0389b51cd2202,989981,2020-09-30 07:49:48 UTC,7883428430,7883426126,false,2304,989969
7bf5b0941f39d758a48609d5b50555eb6248cd19de78cf9e9a6f1573fcb58b0d,989981,2020-09-30 07:49:48 UTC,142350060,142346487,false,3573,0
ca1db8e590e2ce3186d1954453b6fea99924a771335fbb9ddfe8dcdee5abe3aa,989981,2020-09-30 07:49:48 UTC,10000,0,false,10000,0
4fc09860435506e71d1fb3e52a70e1a9ca22b8fa7f97dd555a194a2887d49cba,989981,2020-09-30 07:49:48 UTC,428852959,428752959,false,100000,0
425543119cb8eb6e397d86c4a4aef6ea3527029be602745603cfeb772381aa2c,989981,2020-09-30 07:49:48 UTC,490716737,490706737,false,10000,0
cccabc5d45224ac75c3eec24c4153c6922cbc57c1a1321a0cd227afd603a1b1a,989981,2020-09-30 07:49:48 UTC,189605137,189602833,false,2304,989970
1e79ef3c7ab01edca3dcad653f192776cc4d5f7f2eeb3ca7d80c22c35c9754da,989981,2020-09-30 07:49:48 UTC,10000,0,false,10000,0
d94aff77f50f35d594b54d564dd0c097fca0ec8a4ed52a853bb904a800ba2277,989981,2020-09-30 07:49:48 UTC,10000,0,false,10000,0
87de9b5facf0eb8265bcd417ccee184700045cc153289fba3366603439f91b76,989979,2020-09-30 07:44:47 UTC,10000,0,false,10000,0
b23ecfb21f0683e2d11c07a2f14013575e51911d6e4258e77f55f176590266d5,989978,2020-09-30 07:43:54 UTC,1487525922,1487466439,false,59483,989967
63b8b3bd49443a04807599740f41b0019178578a3336216bb822324c992e2319,989978,2020-09-30 07:43:54 UTC,189404901,189401941,false,2960,0
c33f32c13095cf87eabca4644f22962aa2f809df258144a659dcf332a48185e0,989978,2020-09-30 07:43:54 UTC,125711100,125701100,false,10000,0
69264acff45bb3ae4234e1ca2354b62d7d931255537f35820d279304790a9ec0,989978,2020-09-30 07:43:54 UTC,523189987,523167883,false,22104,989967
13d374ada57e69d1dc585948dd5ceb519582e8a55222e636ea080c5df9bf263c,989978,2020-09-30 07:43:54 UTC,54771527,54765527,false,6000,0
bbc51a54eca03dbaa8a3402c40e22a3350f4145cd0b285c55c689c5d6e0919a0,989978,2020-09-30 07:43:54 UTC,118600791,118582791,false,18000,0
4c446dfa17ccad7a4de52eb2b58d611c877d6e5ce0d226a9de5fe199ecf00e56,989978,2020-09-30 07:43:54 UTC,10000,0,false,10000,0
706e1c08a828ac58ed1e95242a882ea1fb5cd605ead004932162e79087774cf7,989978,2020-09-30 07:43:54 UTC,14345634,14339173,false,6461,989967
6ddcf2c113017988f2b11afb28b3d8f326e8c5006ce6d2575078406a47f2fc1c,989977,2020-09-30 07:39:45 UTC,4519000000,4518993000,false,7000,0
d10a8ff7a22eb29fd4e79c6ec038ad0503926c3052a865a5888d4560c5b7238d,989977,2020-09-30 07:39:45 UTC,28242270,28238583,false,3687,989966
1e550ece714a399df995bde431f1127156000331b2ada6d9bb476d40e6b97b79,989977,2020-09-30 07:39:45 UTC,250,0,false,250,0
a027f2d0d8d5c47202f7da32d270550983f4e49d03250e6b3e93e8dd703609f4,989977,2020-09-30 07:39:45 UTC,10000,0,false,10000,0
50d988c0e76a1f6e8a1069920168e68c7aa34795cae852c7970af44960f15ea2,989976,2020-09-30 07:38:47 UTC,1820206,1817756,false,2450,0
6d969dbcdc76ac4ef8bc5140d104ed56673b3b80217a6e67378963105a62a138,989975,2020-09-30 07:38:15 UTC,10000,0,false,10000,0
198f2664b795ef64fbc21a2acd6c4b8d30ec08f1f612e42f6003deaede1158ca,989975,2020-09-30 07:38:15 UTC,4519010000,4519000000,false,10000,0
3b6ca6c059222fbe5a8d3eb4b1962171f76146850ce4311173d9681414be479c,989972,2020-09-30 07:36:27 UTC,20084395983,20084385983,false,10000,0
693ddeee6335aa497a1d326d6cfe8e0692d8c512db2549acba5deffc29360097,989972,2020-09-30 07:36:27 UTC,500000000,499990590,false,9410,0
31a534b6e62d8b7f8058855e0cd9a3a9730e861ba2dacab26dfb93e6fd0a6d35,989972,2020-09-30 07:36:27 UTC,300895831,300865808,false,30023,989959
8e8fb716f961fd61090f40e8f88e5fe929400209df9eba8f75d79d2bacb4b5f2,989971,2020-09-30 07:35:28 UTC,10000,0,false,10000,0
7b999cfc2534839a6e1e49fc55809076eade53b542538da0ac44022904cd8a98,989971,2020-09-30 07:35:28 UTC,136645720,136642760,false,2960,0
3c817186da98245b01c19646a3fc6279469df0c49314815f298cce96441103c2,989970,2020-09-30 07:34:59 UTC,1058071269,1058059184,false,12085,0
5e69f97e0c55568a783165720643a7a7592ca99dabf5830baeb825f1460f8d1d,989970,2020-09-30 07:34:59 UTC,20389126659,20389116659,false,10000,0
02c6e12211118723986ac8302a61fd37b9770f82aa9b8856df543df042ebe585,989970,2020-09-30 07:34:59 UTC,10000,0,false,10000,0
c9a713f27b600ff6f6e9d490639f5d9e509427d5d96c63d20621e8de24e531ec,989970,2020-09-30 07:34:59 UTC,424202577,424127337,false,75240,0
01b9215b111327cbf5201ec583f2cb0f7cfc1d2b04c320c7b4b1180dbce228ec,989968,2020-09-30 07:31:24 UTC,1488870125,1488808688,false,61437,989956
218fc530afa443f91a2595a4f1c7b0a3a1acab4ac026a1e5d83c319898fa66ec,989968,2020-09-30 07:31:24 UTC,523840393,523818597,false,21796,989956
05e38525dfb696e58cd3f055a6d77c91122ed5d57c087804f13f1df00764fc8e,989968,2020-09-30 07:31:24 UTC,10000,0,false,10000,0
d3cbc38976c2a924ba0eba727e9fc509d353b3f9c4f94dd374b8d0d0e5e103d7,989968,2020-09-30 07:31:24 UTC,335270204,335267900,false,2304,989957
c915e160a7c62b367e3ce890c8a5859a81e619e464f5f5b92b7df3ca7bce4701,989967,2020-09-30 07:29:59 UTC,5973981,5971721,false,2260,0
cac682e3439f39c045b04c56d3fde85afd049b18da01a8e3007a5a97988da1e0,989966,2020-09-30 07:29:30 UTC,330412000,330406000,false,6000,0
ec328eb9a8049da598578d8fe02dba6a9047a448b64cf602eb14f64d7954030c,989966,2020-09-30 07:29:30 UTC,142536784,142533824,false,2960,0
4275c7b0e5af2981fbce48d6aedc60690d0c19a3a6bcd8c3c325bf7d1dedac62,989966,2020-09-30 07:29:30 UTC,10000,0,false,10000,0
01532900fdeed0464a23411cf53911c64338c25885dae8623a0fbfc2a1d337ab,989965,2020-09-30 07:28:02 UTC,61425976603,61425961023,false,15580,0
9f64d4884a0bdd0e572ce032897d32f584aa92127720a367a1ae896f172b10a2,989965,2020-09-30 07:28:02 UTC,10000,0,false,10000,0
33bf43788c68b8d8c6097dff8fbea26045f01a192661a6c79c8687ae32beb27b,989965,2020-09-30 07:28:02 UTC,10000,0,false,10000,0
1eaf1554dc506bbf2131dacc63e6f456433b172729a61392be8115cd4c7d88b3,989965,2020-09-30 07:28:02 UTC,4857,2829,false,2028,0
aee27616aabb3e3b4c9d35a54266aae99cbc2f6c6271b47b3fba41d57ec941a7,989965,2020-09-30 07:28:02 UTC,13017040485,13017038181,false,2304,989954
3eb0a5f72b4c98270426fd8801870127fc597ad65bb504a29bcc9ffd64bac3ad,989965,2020-09-30 07:28:02 UTC,10000,0,false,10000,0
81e63ce1f710f3927bedafe8146419a04dfdc3fed8f74a8c1350bae8fa5ee4be,989965,2020-09-30 07:28:02 UTC,189610868,189607908,false,2960,0
a9d04fe25486476dd9c41b52d6484430156f5cdfa25398a7b87354006ea36547,989964,2020-09-30 07:24:08 UTC,10000,0,false,10000,0
22618ea06f04005dc9c570fab0e10a7f5106b1dd40485eb4529dd4136d916021,989964,2020-09-30 07:24:08 UTC,674628850,674615444,false,13406,989952
d20c17654944a95ec019b48a73c64a541ebba3d6155d846fe1489370748d6b79,989964,2020-09-30 07:24:08 UTC,6658371144,6658366264,false,4880,0
172ff016abf0ae8e5e93884daf23be03ff45542f3346dee50c4954fc8b7db7e5,989964,2020-09-30 07:24:08 UTC,6787758783,6787751783,false,7000,0
8b2120748327215538e62dbbe9bbc39a9afcd46e794006a9fce1c7b9664fbab3,989964,2020-09-30 07:24:08 UTC,20389136659,20389126659,false,10000,0
777f21eb54650adc3a5a7b0938fbf9747f5fcbd17d6bfbf080b02606f31c49b2,989963,2020-09-30 07:22:37 UTC,106460162766,106459662766,false,500000,0
9edfebba51299a18b68ef37b4627485ae983901c4b4e5bbda61640f398acc079,989963,2020-09-30 07:22:37 UTC,6576241,6573981,false,2260,0
d29c2f77ca0d8017b6c9b8780bb90b487ceeaf192cd53a839fcee699cb1d45c3,989963,2020-09-30 07:22:37 UTC,360395399,360393095,false,2304,989952
6936cad222e079cdc83b533fff422e3e420406298753b4ac5080690e0b4ba548,989962,2020-09-30 07:21:08 UTC,3000000000,2999990000,false,10000,0
e4efd9f52a2ce2e598b2daa42f7bcfb2edb78405d82d265ebed091770127cf9e,989962,2020-09-30 07:21:08 UTC,43333273,43323865,false,9408,0
e313e918bc604abde3f5a1429dcd4ca9c24b85bdf0f540ba1a8dbe80755631dd,989962,2020-09-30 07:21:08 UTC,4451010000,4451000000,false,10000,0
bac0fe21aa3bb6434e3376d8c9c87c26e61662f79cde0bf4d6868ade6d5e7f1a,989962,2020-09-30 07:21:08 UTC,136921768,136918808,false,2960,0
013e45fd40eb0286a3cb6b09c024fb0c8e87a2eef953df33296d77f2c7fa0178,989962,2020-09-30 07:21:08 UTC,1204211265,1204209005,false,2260,0
979c933e425c5b203fee91f221da4d098e891dfb593f4b42196516ccdd3f49a5,989962,2020-09-30 07:21:08 UTC,3086311598,3086309338,false,2260,0
3c5a7210883a66724dce2affb951231ddc5c0b1a4944517b5227460956e4c5a2,989962,2020-09-30 07:21:08 UTC,500513820,500503820,false,10000,0
6f04bfdd141447bad65bdfaa02f209c7145df481b73f389b023f8c52825b34c8,989962,2020-09-30 07:21:08 UTC,3064966368,3064964108,false,2260,0
0b8a0d79f7ddff1a2d030495a3a144eeb5f8a9403d4a131d7e8c8af06e2c8b9f,989962,2020-09-30 07:21:08 UTC,13061195729,13061193434,false,2295,989951
79c0be61562473e379564467cd23c38b7389c7412762d87f9c459ffc13018eda,989962,2020-09-30 07:21:08 UTC,19926249237,19926239237,false,10000,0
d57bd55d4a7ed6ada8b4360771b785307a01f283b9578ce668e2740b9fad11d7,989962,2020-09-30 07:21:08 UTC,1490306948,1490243934,false,63014,989951
22031ff536438dd417d3a17fe7efeeb41dc5b44fc310b5871a514dce7efaf2ce,989962,2020-09-30 07:21:08 UTC,235573200,235473200,false,100000,0
2246916d4670ab7077e8d421dbdc35b7ea7cc2247e50d9e602850e22eff131be,989962,2020-09-30 07:21:08 UTC,524272481,524252602,false,19879,989951
54c0cef45b92ddc72e7522f76565e4364a5832dbdc6b5a8eb35abdbec59e590c,989962,2020-09-30 07:21:08 UTC,10000,0,false,10000,0
d24ea50e5b0f08467d1a685c6756deb95099a82c56f81a828e6d32ba7d48a97e,989962,2020-09-30 07:21:08 UTC,43663557,43654149,false,9408,0
0d37489c468323b40e3ba676a5646ee05084945d746ce0756958ed9cc901f493,989962,2020-09-30 07:21:08 UTC,10000,0,false,10000,0
1298f1ca5c24d2efa5a950244727fbcf0dc8394444e25b75d8d6aea961742da0,989962,2020-09-30 07:21:08 UTC,10000,0,false,10000,0
cac4fa70713b4763727296f484ba4e50675da21540a535f26c166203148db323,989962,2020-09-30 07:21:08 UTC,3181840046,3181837786,false,2260,0
3bb97378ddf2215bffa3e9e52523d7043f52ec03ea640de67806880a659f7f37,989960,2020-09-30 07:15:18 UTC,10000,0,false,10000,0
fd033ea89f34fe9f2ea5d75c6711864f4fc4d438b660175a2932dfe55a0a1bd9,989960,2020-09-30 07:15:18 UTC,43691746,43682338,false,9408,0
86554195fbde03860ec6aace0278d9cd6d505a518b24b9e3498aeaf05d92299c,989960,2020-09-30 07:15:18 UTC,500523820,500513820,false,10000,0
85ff3ae6c767db220289cdf568550806990202933a9c26d5d8ce8b11243f067d,989960,2020-09-30 07:15:18 UTC,10000,0,false,10000,0
8eb68434b6ca8fa04cb9407d2192157451734775d875d8e693781cce5a17a40c,989960,2020-09-30 07:15:18 UTC,13560198033,13560195729,false,2304,989949
d58707f9365bd9ea224f35d43f0c2d1b407f3204043f1058a3aaf723950c414d,989960,2020-09-30 07:15:18 UTC,428928215,428852959,false,75256,0
a4b0910d75b0f6c3b339c021219ac367219e2858209dde83976497d92a70eadd,989958,2020-09-30 07:12:29 UTC,920130481,920125601,false,4880,0
1f84b4e576e2fdd9a73a4a278468a5a5ed8cacf879822b5c02af7b4407c28deb,989958,2020-09-30 07:12:29 UTC,10000,0,false,10000,0
a81290b7afb15a5bfcd1bbac85ecb67d450e1579a5c9d476b7c5c5706824b13c,989957,2020-09-30 07:10:28 UTC,10000,0,false,10000,0
0335befb1e38c6e942380c341d4f23800ec917052a031951f28407fb677881e0,989957,2020-09-30 07:10:28 UTC,525120988,525095010,false,25978,989945
2c83a0617a1d780c2b1e74807faaa6c41871a08a5ff24d36e0ee02c2824dfdb2,989957,2020-09-30 07:10:28 UTC,1443965584,1443963324,false,2260,0
03305928e2505f210ad04ea169b9a899c9fe0e670ed9280f3eb021c9a5f2797f,989957,2020-09-30 07:10:28 UTC,1491729040,1491666292,false,62748,989945
6709f3d65c47d8438f24876c249f40029a79c542a2a24322a0abc1e7500f7ef3,989957,2020-09-30 07:10:28 UTC,13624235719,13624233433,false,2286,989857
541c923810464bed90d903cdee027e1963cd1354e5efcf5a1a72ec2b0e47fb02,989956,2020-09-30 07:09:32 UTC,136562800,136560540,false,2260,0
882c17c1f878d1617a8c6604de2dcbd7a53f61c3d07a34b89f4d00c94e714cdc,989956,2020-09-30 07:09:32 UTC,43787160,43777751,false,9409,0
5eb99841ac2a1c67e2c9f06e6fa45e0e76eaaff3ffc28bf61cd3b8abe2720472,989956,2020-09-30 07:09:32 UTC,142949105,142946145,false,2960,0
134c89d106ad7b4de468c81a2b08570fba0b2a1136f842a45976146d66ac388e,989956,2020-09-30 07:09:32 UTC,22996,17270,false,5726,0
e64be84c26c01014c56db65565ac5a2be0196e822689fdd7bf9d79efbc336095,989956,2020-09-30 07:09:32 UTC,43925449,43916040,false,9409,0
a94c8b67f135f7f13a1910fe77f599296287fcbaba24dc24612e6934ed29ed87,989956,2020-09-30 07:09:32 UTC,10000,0,false,10000,0
dfd2d9225ac6422a55df1199a3d6ebe0a5274b97512f5a606db9a8b54029e3e0,989956,2020-09-30 07:09:32 UTC,1514796574,1514696574,false,100000,989945
f61a3b332f078d098a11a809a1eec8f48e1f17a6ee48fd0d87c6013a39d226d7,989955,2020-09-30 07:06:06 UTC,13676077455,13676075150,false,2305,989887
7a3046829076c8d64a121e04b986ac1f0d9a75ea9634815dcd6c84564c65f7a7,989955,2020-09-30 07:06:06 UTC,2502381776,2502371776,false,10000,0
07eabc288a94f710f8ff43092f7c14a32fff257c1f9a6cbd213e9fe34fa5c6bf,989955,2020-09-30 07:06:06 UTC,10000,0,false,10000,0
e1deff58055f05ca0cf3106bb9220295daa0ab10749e4c85bb840f294d51207f,989955,2020-09-30 07:06:06 UTC,19926259237,19926249237,false,10000,0
f1bd26b018cfc998d5a66c2f34445ec36d619b24e74e18a99ac0766bc4f8e40a,989955,2020-09-30 07:06:06 UTC,236545478908,236545468908,false,10000,0
79462149e1de886414c762061afaeb52edc5952716c0b56c314a0bd0d05f3d36,989955,2020-09-30 07:06:06 UTC,39874,33874,false,6000,0
2401d75c45e626efc30855db24ab228e6e3a883b7fb03a5f9a48e841fff84744,989955,2020-09-30 07:06:06 UTC,1000036004,1000026004,false,10000,0
3ebece4f206dd66a1ca92d5560e33ce809ff004168857bdec0cad66e81410a43,989955,2020-09-30 07:06:06 UTC,1545097044,1545094784,false,2260,0
b59ea32ebbdd66b5d1743e0132ecc0037f36a4a59f709410205ac1584ef1fe07,989955,2020-09-30 07:06:06 UTC,3852972244,3852966244,false,6000,0
195d17949be72ca48d982f133bd1cf26235c7c4a1104b0512e9d07b418b25dfa,989955,2020-09-30 07:06:06 UTC,3500018085,3500008085,false,10000,0
ba415035dc9d5df1f28ecd0756bf94bf643cf6b2b01348b9d0d68451dc4805d9,989953,2020-09-30 07:04:15 UTC,10000,0,false,10000,0
ff446a661475fb8bbb2bf9871679bfcc4876baa76d6690f8cdffca2b42275940,989953,2020-09-30 07:04:15 UTC,189842532,189838959,false,3573,0
a90846aec61ddda896703fac8d6dbc79f5e2676397a80d7ca46ceaedd62133e5,989953,2020-09-30 07:04:15 UTC,20269047755,20269037755,false,10000,0
452437437f679bc8114cca9b448f91fdbf77d1107a7bbc7440dafb89a5fd1114,989953,2020-09-30 07:04:15 UTC,60310,50310,false,10000,0
c49ca4ac5bec6a30130a2848b204a73f41a139d4f805267bb3caac5e8aaf03cf,989952,2020-09-30 07:02:15 UTC,1554896574,1554796574,false,100000,989881
25379f5d4545a2975b4b51b13eaa9d046eaa20e02d7d6c32fff0a111f76aa82f,989952,2020-09-30 07:02:15 UTC,390125090,390122794,false,2296,989941
90c26eeef7d5809e2788291ee04a3fb92394399af0f1d59f7b6271ede1592347,989951,2020-09-30 07:01:29 UTC,10000,0,false,10000,0
a253d7a3bdd13138d40b318eec98734714da65ec6e8704391651e0b2a0479a94,989951,2020-09-30 07:01:29 UTC,908540536,908537271,false,3265,989939
7f1ba67023262afa15947b504b2e68c806d80756c6c0176f27c1febfb1393190,989949,2020-09-30 07:00:34 UTC,525717973,525701929,false,16044,989841
6a122f91146af35eb5ba1fb943e79a4097ee3a6af936e6495d4b807ed7e7416b,989949,2020-09-30 07:00:34 UTC,1492807162,1492745668,false,61494,989937
99838f98cff511731a6e98a5fd0952287b4123a6b9f2d826bc4b118b167524df,989949,2020-09-30 07:00:34 UTC,988149773,988147148,false,2625,989937
f9f404b2d5b597d15209c7095ad5736d809345513f1b5baa6eaaa484b4d28635,989948,2020-09-30 07:00:02 UTC,10000,0,false,10000,0
f1171e4b7c393cb568dcb9390888303a5c53728a20a64ff913b68f042a8ee7b7,989948,2020-09-30 07:00:02 UTC,20269057755,20269047755,false,10000,0
1b77135592c7e8c8309947b8155ddc42ff9a6ca47b86762c0fd92e96e4136b41,989948,2020-09-30 07:00:02 UTC,48431412,48419327,false,12085,0
b10922a9a2b3fcbb09b315f632c7c7993e92854ec5467c3fa66a4fab1dccb8ac,989948,2020-09-30 07:00:02 UTC,13896624760,13896622455,false,2305,989900
45c89115852a2c997571ca79972079bb7cf76ed8a68d2026bfd3abe4c1c3948a,989947,2020-09-30 06:58:59 UTC,1509700000,1509696070,false,3930,0
8023d79fcb4788b92ab5b23a3ec93bad674620ea10e4b54d10fb0dbb418e6870,989947,2020-09-30 06:58:59 UTC,137066784,137063824,false,2960,0
e70a1cab14c90de90784bffebbe143fb4b7aa9a85a1d313f5b97af480b46fef2,989947,2020-09-30 06:58:59 UTC,119999790000,119999787650,false,2350,0
84c7993fd36b7c6c1847a035919d7f32048344635a1079d3aedcb3f4d2009a7b,989947,2020-09-30 06:58:59 UTC,43954947,43945537,false,9410,0
ae341640963b4cae975626ac577761fc8f28d3c7297e8c2b9656506b4961251a,989947,2020-09-30 06:58:59 UTC,500002260,499992260,false,10000,0
d076008c8136e2bacc0ae01cd2d6304d9e888a610df4d4cf8f2dc6b98bd3aa3b,989946,2020-09-30 06:57:46 UTC,282235048,282159768,false,75280,0
d994e6d344abd5158e2e17a37cf526dce0008e118bea4382510cd1e49018c4b9,989945,2020-09-30 06:57:27 UTC,499990000,499980000,false,10000,0
69ce4427817564213a0cbe137e19305b65593352437d07369b378552ae6fa9d4,989945,2020-09-30 06:57:27 UTC,44017817,44008407,false,9410,0
4df4e383c829aef43901d2583894fa1255e70b233c7c3dd7b0234eec7cbd2f8e,989945,2020-09-30 06:57:27 UTC,98610000,98600000,false,10000,989930
005d8f98f3ff3cf1d580643034560227c7814eec2a4eaf79684b7a043638d40e,989945,2020-09-30 06:57:27 UTC,10000,0,false,10000,0
7879c9dde06cbe66edea6357c9b1f711130a5ee21070a80d164067df782f06d8,989944,2020-09-30 06:55:37 UTC,10000,0,false,10000,0
e5102d2b0506137f913a6b042a58cf5d1dbbf5f92ec1f0f6cd41d4b035fc1b81,989944,2020-09-30 06:55:37 UTC,412574447,412572151,false,2296,0
0374049b2150c69b553969d34dc5d8b168f3a9c3014c3593823176c21648fc7a,989944,2020-09-30 06:55:37 UTC,9959415,9956469,false,2946,989933
357e7a70df2ffd75fbdb5d01d89b3cff38ed69d4aea553a1c96f350a562f38c8,989944,2020-09-30 06:55:37 UTC,500012260,500002260,false,10000,0
e03690ec3687ed552fc3c1aa3f1d1c7820219f1cf18441780111a827fdd47ec3,989943,2020-09-30 06:54:33 UTC,143191822,143188862,false,2960,0
619f014630a705409d494e6d832e1ebbf2bdae77ea5f4ba7c5d93180f64e01cb,989942,2020-09-30 06:54:01 UTC,18296127046,18296124760,false,2286,989930
7de201ce31e0f501e01d2aa5b8f711229634c8ba95ad391199b74c59194a507d,989942,2020-09-30 06:54:01 UTC,1607573093,1607555093,false,18000,0
fcdb42c9dbfa3ee99d31433c0bc8f98149ab2232b0bada6333793f9741a48c50,989941,2020-09-30 06:53:21 UTC,526397225,526377323,false,19902,989907
b646e0bcd1e11b3e4b35390d50c2c9ddc90016ab808861eef82accf03fc0dce5,989941,2020-09-30 06:53:21 UTC,1493877323,1493820666,false,56657,989861
1d31d83fb9c14ba345dfe2fef99c7159dc20377f9da49631a78479ecfe648455,989941,2020-09-30 06:53:21 UTC,6121352,6116271,false,5081,989930
049b898c1947f594068547dcff7b4b2a8327302591f295df01f3245d987ed0dc,989941,2020-09-30 06:53:21 UTC,10000,0,false,10000,0
82d2ea82d1bf6a8a88b9f75f738ecf8b7a55739c3e6adf666c069da7913613bc,989941,2020-09-30 06:53:21 UTC,657501,647501,false,10000,0
d77408c6cad3e82a04a6e1329c1ba3f3117b0b570fd1db56f8b76265c1b80658,989941,2020-09-30 06:53:21 UTC,10000,0,false,10000,0
bb9201c11be864f05261812abd2e068b1cae83958b923f9d4987dc715ee7a665,989941,2020-09-30 06:53:21 UTC,44259473,44250063,false,9410,0
5b020141450a849cde3d938db8d7dcaba5cbb1ae0575072a06d003b8a7593a08,989940,2020-09-30 06:50:01 UTC,36080731,36070731,false,10000,0
183e76900990a66a65bf1362a88dba7ab93ce3edceee6a16d07745bfc99c40a6,989940,2020-09-30 06:50:01 UTC,10000,0,false,10000,0
2b6bb9e7fa54a5d8379883805be3034e292f79f37ec5cef46eefe10526442715,989940,2020-09-30 06:50:01 UTC,18795129351,18795127046,false,2305,989885
5b1f321a9386dcd68e4a3c62e36857659c0d8e56f644223090c966421b3226af,989940,2020-09-30 06:50:01 UTC,103468467046,103468397046,false,70000,0
62f9043d177ef81dad1386cf08e65351e82aae0bf0e5ab4c202c9428a45f225f,989940,2020-09-30 06:50:01 UTC,190020495,190017535,false,2960,0
f5b00b05c12f0e42ca0ee4065ba7fac36c02cf425f93ece9bfcbc2c6aaf9a776,989940,2020-09-30 06:50:01 UTC,157760,147760,false,10000,0
4146364caa61921853983e5a094c88019c37ad45678c5f20e4abb8545aa96b0f,989940,2020-09-30 06:50:01 UTC,500000000,499990000,false,10000,0
a22e5bdc8b86e268fd67abd9221ff7d4c112b40c540f7b4468abe7caac103079,989939,2020-09-30 06:47:33 UTC,26941,20000,false,6941,0
630b79935da48ab93b44035b796cc1d4c26c04e24ac31981f17db0f793b75541,989939,2020-09-30 06:47:33 UTC,10000,0,false,10000,0
e244f0dea95e8a6ec9dafdcba89abdd5cc2db7e6cbbc12e9c8e6c72c4c8a0cec,989939,2020-09-30 06:47:33 UTC,41678,31678,false,10000,0
9f3a690853e5524c53984e0bceee94eb3e5eda7b371814d14ffb8867b26a7a9b,989939,2020-09-30 06:47:33 UTC,125745290,125735290,false,10000,0
7b43eb711b39ca182c07fcf55069d279970470de060e48dc8f319535f7d550ae,989939,2020-09-30 06:47:33 UTC,3852978244,3852972244,false,6000,0
4425270a1eaf6305bc213d8a28c0b209c67ac1bc433ce244b3d6b9b0e3f37cfc,989937,2020-09-30 06:46:23 UTC,68011772,67996192,false,15580,0
146b836f38f4a4287fdabeb48bb95767119706a47f7f61a2ff9e0ce4544d3634,989936,2020-09-30 06:45:45 UTC,44290783,44281373,false,9410,0
7db8d4efa783413f8c31c0445c1e8d57b942c746649676b28c5af093e917cf3e,989936,2020-09-30 06:45:45 UTC,137241411,137238451,false,2960,0
b0945998b3cfe7faebd15089a9897232509895bb2f24885d58ae2deff82f39d2,989936,2020-09-30 06:45:45 UTC,10000,0,false,10000,0
8235bb081b305602c67f4f1acae06171b316c4a105860c08d4aeb44b4b8895aa,989936,2020-09-30 06:45:45 UTC,10000,0,false,10000,0
b9a7d53e4dfe156f209f5f5f2f98bd31ca177d8b892a49af95e66415595a4d64,989936,2020-09-30 06:45:45 UTC,500010000,500000000,false,10000,0
d54376e24f194f22f5cf2b034b9973b44148027cec21389913f2454c6ef6bdf2,989936,2020-09-30 06:45:45 UTC,44335917,44326507,false,9410,0
5e96a27d7a21cf2c9f602607a0746c2483e3d0fbed2de3abfe9f59cbe9b4f2bf,989932,2020-09-30 06:42:18 UTC,10000,0,false,10000,0
5d26a3a2dc64d6b3ba1c6c449b6a8b619feb83b8f9ec64687aa093e6adec7793,989932,2020-09-30 06:42:18 UTC,1014577,1006739,false,7838,989920
18d62008266409d5929adf97ca8178dfea66d52b979ed394017ced0364438a28,989928,2020-09-30 06:40:54 UTC,8078501,8076241,false,2260,0
5e4dfc192cea54efbd50e2868c7e2448feadd9f799ae672d6a7f74dad135c866,989928,2020-09-30 06:40:54 UTC,289353503,289278215,false,75288,0
d753bdcc90cdc67fc7a6a83b1fdba2814c7871a2169cd51666e3f7238d5dd312,989928,2020-09-30 06:40:54 UTC,10000,0,false,10000,0
c1ebf5e0d3f7c33ac346a3631b326c24c971bbac714158bdf3bb3b00975db363,989927,2020-09-30 06:40:09 UTC,144698,134698,false,10000,0
38fb8e831e14f97af0e1ca553e7957310994050b13acebfc2ff8949114251f91,989927,2020-09-30 06:40:09 UTC,526888464,526868570,false,19894,989867
6e7e430abeeae0e9978b21654ae7a3bf59903b101ab76b71fd5375c82eb8802a,989927,2020-09-30 06:40:09 UTC,1494969471,1494913128,false,56343,989916
25c0f755aa4f17f5f2fcdf6620bb9e5cede77c102284a0d24cb974ffdb43c491,989927,2020-09-30 06:40:09 UTC,219268237,219261237,false,7000,0
9dc49829788465a10cc316da70712eeff63f19f1be24a19f90012f92536b39b2,989925,2020-09-30 06:39:21 UTC,19737337449,19737327449,false,10000,0
11747f574911dab38fbd3d362470cb0250f37f6456c767204681f9322270df6f,989925,2020-09-30 06:39:21 UTC,10000,0,false,10000,0
2d98d62a2753393d0aca23a8a7621a5303166ae40f35d6b5d80238b73d485d1d,989925,2020-09-30 06:39:21 UTC,290947594,290945334,false,2260,0
0c53da43c15fe71b60ca857805d744d0c06a38f316ad647961f9bb3cac2de898,989924,2020-09-30 06:38:24 UTC,8238405636,8238400756,false,4880,0
e4a9bea4292d110dc42331963d5c20db54ed3ba32567bc0a59b62bf36dd624a1,989924,2020-09-30 06:38:24 UTC,20330944832,20330934832,false,10000,0
0a410d62159b3fbc1e410b712fc6ff8e3bd8cdb3cb5490a4902b9b271d3074f4,989924,2020-09-30 06:38:24 UTC,143411683,143408723,false,2960,0
cdc0063d12f470eb37857fab4a35d0c65f50fde45cfb63657ed641bb7893d1cb,989924,2020-09-30 06:38:24 UTC,17083721,17078501,false,5220,0
d0069770502811462755ceb39dc030a408329a41cc1ebdaae59e9ba3a8dd37ce,989924,2020-09-30 06:38:24 UTC,100075000,100073854,false,1146,0
1c151aed2a2bb6aad4f158f113aa8552a9cf2cb18fc2127d0ca6bbc38fe3d270,989924,2020-09-30 06:38:24 UTC,223677180860,223677165280,false,15580,0
eb99bbbe07a421c5a3911b4e2b7f69fa74d9a612bff9d1614c6e4b93aa2fab9c,989924,2020-09-30 06:38:24 UTC,500003060,499993060,false,10000,0
1e5527f67c1c8f28327572511d40c60fae6906180af730b7fda839c17fb29f1e,989924,2020-09-30 06:38:24 UTC,44369653,44360242,false,9411,0
36a7725fcb99268b6bf4aa235d56839f6c1e2a77ca00f849c6be1519de598fd6,989924,2020-09-30 06:38:24 UTC,44402435,44393024,false,9411,0
516cbe140fc44c08c5c2a4dcda23ccb08bf9821ac02a4accb1ea4d34ee2541d5,989924,2020-09-30 06:38:24 UTC,163136117,163129633,false,6484,989913
231c2d2fdfa61ff157e5a541232217bb51a181dda7efe57ae9af2bf8d909b5a4,989924,2020-09-30 06:38:24 UTC,10000,0,false,10000,0
92aacd9da6ffd5fd3b73bd6d05d4eee7075bd8fb34486dba4f9af2c94fa772c5,989923,2020-09-30 06:35:43 UTC,10000,0,false,10000,0
a848f14c94cbe2a453ae95e334b4fd3992c428b9067cfbfa1b7cac2f57ba8830,989923,2020-09-30 06:35:43 UTC,5000000,4993220,false,6780,0
7389364af7e65a6f756aee0b11266221018ee57a65c51e3caf7250fdf8eab00c,989923,2020-09-30 06:35:43 UTC,414969912,414967616,false,2296,989828
134bd90dd4f96ea9b8b506282f2222e1ddaa3e3e849dfe810c08889d78f6829f,989922,2020-09-30 06:34:18 UTC,67654938,67644938,false,10000,0
ddd3766d1a27aeacb9912f5196c4cbe32f58ea55d2684ac89f8e466876b3494b,989921,2020-09-30 06:34:14 UTC,283255759,283253499,false,2260,0
e8f7d91ff8b6ba07f5ecd981196be51646cd04acfc5009ff43f1d37862d766d4,989920,2020-09-30 06:34:10 UTC,10000,0,false,10000,0
69772834ea66d3762a2a5b8527060226b57b448ffb1a869bbd40d5e3fcb1c468,989920,2020-09-30 06:34:10 UTC,11794,9344,false,2450,0
dc17ca7632c168878434aa8af625c6fb66a4659effe1c97c4ee3a7347b051e67,989920,2020-09-30 06:34:10 UTC,10000,0,false,10000,0
0f9cce6da227d180fc16e5d3ec7de8299be9dea24f27911018e5f8ab2b724fb8,989919,2020-09-30 06:33:20 UTC,7777262177,7777232177,false,30000,0
a75f14f1a183bfb552e46e17cbe263eea9068e8d84f0df24d3c0fac40fdf1f56,989919,2020-09-30 06:33:20 UTC,7501007893,7501000026,false,7867,989894
33ace7bcd8301651f567ee3d47177bb73c44556ac012846f319b26c9bbc325e7,989919,2020-09-30 06:33:20 UTC,190228887,190225927,false,2960,0
83ca0cd5296eb109d4b9483b10b8e54c3b71a8de4093c349c5b7abe86946793d,989919,2020-09-30 06:33:20 UTC,20330954832,20330944832,false,10000,0
72fe2ace14692662001e8ad587d1b7d6b56b883d040c848acdde329f6b1daeab,989919,2020-09-30 06:33:20 UTC,10000,0,false,10000,0
453b08d580694977288cbef76287ba60ef1ac2648d7f10a19b8584286c8eaa74,989919,2020-09-30 06:33:20 UTC,1496113462,1496058399,false,55063,989908
9afd386b2e56dc23edca4e9cce8bd1ba0fd999830fe84c8d335285239af914e8,989919,2020-09-30 06:33:20 UTC,10000,0,false,10000,0
9d9b351e95eb192a97950f6eb4a93f47245a4e46ece4b6031e68029a7bb97d8d,989919,2020-09-30 06:33:20 UTC,438934177,438924177,false,10000,0
2a6af43488283386d85e61b1d1761b6c6dc810820b0a7fbc52baa81c3280d517,989919,2020-09-30 06:33:20 UTC,527330088,527311794,false,18294,989908
efc8bc88d8877096082ca55a59c30ffa9ab9939fd74e223d2643cd1a13e97c1b,989919,2020-09-30 06:33:20 UTC,3852985782,3852978244,false,7538,989908
b66a37b653415e111ecf5a5d34ef290db4e872b25c97d1fdd21b73f72e4d4c7d,989919,2020-09-30 06:33:20 UTC,44444706,44435295,false,9411,0
feb88c3c45175f303724ab6534d2b8603ea948bcc26832a5eb7b5a66414bb2e8,989919,2020-09-30 06:33:20 UTC,5387461,5383721,false,3740,0
51a0e6fa7b2003bed38e57332f4527bcc020694c7909bae004cd02ecdba6cc99,989919,2020-09-30 06:33:20 UTC,110000000,109987915,false,12085,0
d94d80135693c17022021c2989c0b5ac12ec6d22a0040baf98c8d8c21b0e0512,989919,2020-09-30 06:33:20 UTC,8001015248,8001004614,false,10634,989908
b54cc67b9fedb0f2b0bf3d9f91c83ae70654cc6663ad44c101c7afef122f9a7d,989918,2020-09-30 06:26:32 UTC,10000,0,false,10000,0
17c10934837a41f45e79895a5449965305fee6909afc2212c45c32a69fee2f46,989918,2020-09-30 06:26:32 UTC,154325,144325,false,10000,0
66fc4692a181a8746371242a0ae0c63d46417cbb4abe4fc49eaf2ac0b162b46d,989918,2020-09-30 06:26:32 UTC,2843459648,2843452647,false,7001,0
5985ca9ca8dcdea7dfa41b4e0a2d0d8be776887b344ba15c6caf48212c640108,989918,2020-09-30 06:26:32 UTC,499989414,499979414,false,10000,0
ede4bcb9bd56f16bf9cfe6854408bb6613aedb9e2d114039636b3e9cd3f0564e,989917,2020-09-30 06:24:12 UTC,10000,0,false,10000,0
ba5c1e2927ee1fee75f65461a1562ca2ed00932cf7e5bc2afa308a1c929743a6,989916,2020-09-30 06:22:29 UTC,5364549132,5364520272,false,28860,0
0bfce6f41791f03b75f48b62e7fbfd00f451e7a786c897647f61f522aa66aa9c,989916,2020-09-30 06:22:29 UTC,101281073,101191073,false,90000,0
514aa1c786b4f9d5a226d1110a89b6a2978511b34b1cc26213d035eb526df3f1,989916,2020-09-30 06:22:29 UTC,10000,0,false,10000,0
6a394d81150ea3a3ab2948e5dfa10904303cf9c42ccef9a690aec14b55a59e48,989916,2020-09-30 06:22:29 UTC,1497352606,1497286664,false,65942,989905
7932321347963bbea421ef627153ea571f00b1cd18771ae5b26e99e24291d0ac,989916,2020-09-30 06:22:29 UTC,142500000,142424712,false,75288,0
8d8d07478fcb9aa42a084c75aac2a665c84913369d33eabb2a71fd1ea4e7e951,989916,2020-09-30 06:22:29 UTC,32778074,32774385,false,3689,989905
a6055e448fd125878dcdab4d166c6e0a05674603ed1307b77795308a9bb694bd,989916,2020-09-30 06:22:29 UTC,101797046,101778953,false,18093,0
bc919b0ed125075b040424191d7ca46c7c87a42883aa2cc56d4c286b32c2c8c3,989916,2020-09-30 06:22:29 UTC,2769527200,2769526054,false,1146,0
eab2d6bac8b5857b6e47d4930f9652351451191ada7c0e69d8862abc724b6847,989916,2020-09-30 06:22:29 UTC,10000,0,false,10000,0
de2a8744a53143fad1700d78f782a84deb6e21972e72e1c0ddcd81df287e0a15,989916,2020-09-30 06:22:29 UTC,44537784,44528373,false,9411,0
ed0acb8adf6cc7c669cb8df4afa44da41774b6fc126dba63e9f7bda0916a16b8,989916,2020-09-30 06:22:29 UTC,137413262,137410302,false,2960,0
79c17feaafd9d0ad5ca234b2835871117de993b7edea4782bb76da6310bb1052,989916,2020-09-30 06:22:29 UTC,1953734627,1953728627,false,6000,0
f1abe25a12c47c177a1b454401c0ec22cecd6c24504c290781292e86b90eb4ce,989916,2020-09-30 06:22:29 UTC,527636879,527617982,false,18897,989905
c989806811df6e75cc741ec7b6d683a5b45683de6c6d5d6b5e20ea5f5962f703,989916,2020-09-30 06:22:29 UTC,368866537,368836537,false,30000,0
dd3cfbb8cadfa40628ddf3396cbbdfd73b1688c274446e438b32c9452645ec49,989916,2020-09-30 06:22:29 UTC,199764972,199709432,false,55540,0
15a9b933e944fff803c83ad2f2b282f2f938adafc898cc512cba151c9cc6bf72,989916,2020-09-30 06:22:29 UTC,76870643520,76870641170,false,2350,0
35364e29ab5608d7ed20a85569387e4ac5a068995f8d540dcb07efc9a6845871,989916,2020-09-30 06:22:29 UTC,605072437,605066437,false,6000,0
498bac0c59c452fd0a569b959e402af3e4851ba7f7396e2cfcdd4978d3f306ed,989915,2020-09-30 06:18:00 UTC,67844260,67838260,false,6000,0
91e534e485c8b9b96a4ca82015e0d1ca6a242fe4bf2286b92b8d13cd06d3ed62,989915,2020-09-30 06:18:00 UTC,143873984,143871024,false,2960,0
fa5ceabb692cc935373fb9f1d663e1bf058132d797e2d91891d46f178c8baf92,989915,2020-09-30 06:18:00 UTC,1953606,1779606,false,174000,0
dd44141eae2f1756d641c10c48aa0456bd81b56d0d7f3611b482b995dafd4542,989915,2020-09-30 06:18:00 UTC,67830000,67824806,false,5194,0
768d3bdc7424e67ead0cc11880f77158253f52795069f33ce0e16e0523744434,989915,2020-09-30 06:18:00 UTC,10000,0,false,10000,0
9dfe928e5c4ff61e20b9fb5552848ff7ff5c7a3d3c9f10f365090dbbc3589590,989915,2020-09-30 06:18:00 UTC,499999414,499989414,false,10000,0
4900e0eca4a41437316b95e9c6b81ae80bea99197ec9563869c0abb0f9b9b4f7,989914,2020-09-30 06:15:55 UTC,500009414,499999414,false,10000,0
b39e1e47deba15610c68600a02742c4ed21ff8a1044095dc64819c1888c02728,989914,2020-09-30 06:15:55 UTC,190383646,190380686,false,2960,0
243a74015490bcc5fa9e58664c512c8a405fac5d09b4fc96bdcad8471494b44c,989914,2020-09-30 06:15:55 UTC,254116333,254016333,false,100000,0
ea4e9becc89447475ae975f849ddbd5ed2cab8ef7acf860d6ad3b0cd3da43092,989914,2020-09-30 06:15:55 UTC,44569192,44559781,false,9411,0
7da1d013e8fc8ddacc64c08c9c056894bb1bf2229f92c17ec5c577c7eb46e250,989914,2020-09-30 06:15:55 UTC,10000,0,false,10000,0
436c491c4a4cdf884c9c17ad00bd361a516ef3c4e9594ac7ab5f03b5539cf295,989914,2020-09-30 06:15:55 UTC,10000,0,false,10000,0
2e3707b6aeaab02c3e43060f7ea8183dd162f780f505dfb8de23a10c1d8f861a,989913,2020-09-30 06:12:38 UTC,10000,0,false,10000,0
e2d4ad95aac662f7b49598d5c1b8038efbd3b2a134418d92387a84ffc349f87b,989913,2020-09-30 06:12:38 UTC,3228154,3225704,false,2450,0
be8399dc73d8e075da79cd1a70de4ef01224b0854158ac0aa3ec53562223d6a1,989913,2020-09-30 06:12:38 UTC,500000000,499990000,false,10000,0
74a897643cbcc9ebab6d92bea351dcb886ef45d94854b6940a17a9f99f7d8167,989913,2020-09-30 06:12:38 UTC,5265822,5263372,false,2450,0
8ae7a7ddf67d6863f49afddbbe26b88359e7fbf73cffc46fc563b82691dfa5b8,989912,2020-09-30 06:11:22 UTC,1986644608,1986634703,false,9905,0
85fb6190e9fdadc6c51ff8017310c56ecd081ea1d90e4213865abf7e9c886278,989910,2020-09-30 06:10:58 UTC,10000000,9998080,false,1920,0
367dd16290d13c78a0eea1a48eddaaaec5bef22b3779385c610f4c0150aed29b,989910,2020-09-30 06:10:58 UTC,1351415211,1351409211,false,6000,0
c6ab92ce710f28eb0792139b50dfe8af9b7e72dfadf1001045ba9249e2d2fa85,989909,2020-09-30 06:10:36 UTC,100746380130,100746217082,false,163048,0
5ad1f2fd1a3ec19f4b7e53938d845861ccdb57ebf3d369927016271e91d9d2a7,989909,2020-09-30 06:10:36 UTC,1076592,1072912,false,3680,989863
012a9926e8cf3a39b56ec9c7283b3f3135ab3c8bea7aa6c4d86155488a9dc6d1,989909,2020-09-30 06:10:36 UTC,1498498108,1498437009,false,61099,989897
b1426410692b2bfea8bf9ea52c588dc4e05bc50b2724112e29487674c1a6c37f,989909,2020-09-30 06:10:36 UTC,528229217,528203247,false,25970,989842
52975c1609f5fd6157a2b18cefb52f7489cb2aa99da090d1734130e743fdc22c,989908,2020-09-30 06:09:51 UTC,34838911,34836605,false,2306,989896
911d645a3ccb99798d0289afe00898f73ac1ae7dd54fb8207315950e3a6cc76a,989908,2020-09-30 06:09:51 UTC,21564658857,21564656551,false,2306,989896
62b18af7ea725f959263c01b9468803295a564526bef13a95419d59724a63b68,989908,2020-09-30 06:09:51 UTC,6730900000,6730897704,false,2296,989856
e41306c09a57fc286bcdac28a6502af7257bfed9711b32df8461c1c77b74b64f,989908,2020-09-30 06:09:51 UTC,873424943,873419723,false,5220,0
b156cd38a7c374785ae18b4bf844fefaf36bcf24688cedf34031a2cb63a8d48b,989908,2020-09-30 06:09:51 UTC,10000,0,false,10000,0
488cda4abe87073a7ec00933f6a7ec06490dd723f8b8c010d116da25e41aaa5a,989908,2020-09-30 06:09:51 UTC,208556266,208364266,false,192000,0
68fead6963ff477e77d1bd93d3495d462cb8025dca316e90e56a0cc965846d03,989908,2020-09-30 06:09:51 UTC,10000,0,false,10000,0
ec4de443b1fe454ad4d5a6122d7bfaa26c9d5b6ef32c57c2a6f1c987eae579e8,989908,2020-09-30 06:09:51 UTC,10000,0,false,10000,0
85509be37f186fc3167d0703fd8c2f86aeb58fee40e2b3436af5c0def7b216d9,989908,2020-09-30 06:09:51 UTC,20717499273,20717399273,false,100000,0
551e47497644652e663398e00b4ea8302d9f0492d43e28f9b02f6f2e64b24130,989908,2020-09-30 06:09:51 UTC,195113539075,195113523495,false,15580,0
407712ad59217a07bac24e55e92f18fc2e4ae8b1822b537abd85914451cd1ac2,989908,2020-09-30 06:09:51 UTC,500010000,500000000,false,10000,0
23ee0d8066c638662b293045468c8d23dd20c69606e236948a39539a9f8a4a85,989908,2020-09-30 06:09:51 UTC,137563281,137560321,false,2960,0
da4211abab6e8c933fd9d5cafda6a84edc73c426423ac9e6d0e24d4d4f338467,989908,2020-09-30 06:09:51 UTC,392083410,392079960,false,3450,0
42b21d3f5dffefd18a22a3595e4ddd8c9ef5c2286acb38f26ae398b1b2f98644,989908,2020-09-30 06:09:51 UTC,1568904287,1568804287,false,100000,989897
9798483ebb09e46ab95fe262d52e023226fea0c29d42e86d9024341485ae683c,989908,2020-09-30 06:09:51 UTC,189941284,189938978,false,2306,989895
22f1a47f564ae302ad2af7e743182f7ebe805313e61d1c5301fcbb8a6d894950,989908,2020-09-30 06:09:51 UTC,97724749,97722299,false,2450,0
ebb38026c4436188d7fd69cea382a1703dbb08fb9a143fc5bef3ee55909b2993,989908,2020-09-30 06:09:51 UTC,2000138408,2000128408,false,10000,0
e9b8823f26358cdfc0210ce2cc16a7b326ac120c9d5db63807d048a0a70ee125,989906,2020-09-30 06:04:52 UTC,10000,0,false,10000,0
f2a649876bdd9f21004a4cbf2525f96676084055ee30e8dbe448bd0129399985,989906,2020-09-30 06:04:52 UTC,101064826,101000018,false,64808,989806
5d26f1f31be7a1d8c8499bdfcab933871f5d6fa405e752f2d6cda069d42c815c,989906,2020-09-30 06:04:52 UTC,3500028085,3500018085,false,10000,0
4e5e23f08c79dfad5e4c6750bb20625ed4ad3b18f888718c12682ea7e2e09475,989906,2020-09-30 06:04:52 UTC,248863105055,248863095055,false,10000,0
aa85e7712fb2ccbf9abaf4cfca020d3818d636f3b69a0b00bc8c2641cdb9da22,989906,2020-09-30 06:04:52 UTC,1500295881,1500285881,false,10000,0
8e8112f33065c5fedf7b8607e44053eac3d42915047a767a7270e819efebd7fa,989906,2020-09-30 06:04:52 UTC,329407907,329405611,false,2296,989895
c3954ad178a57b4b8ae329ed5126418addeb2ace5cca0864878c11d5efae364b,989906,2020-09-30 06:04:52 UTC,142500000,142424696,false,75304,0
eae413680484109acc43315b6ba2985be861ac20f484546756bfc7d5df8cb411,989906,2020-09-30 06:04:52 UTC,44599957,44590544,false,9413,0
c3e6d3181d634ff190ed816805c6c41936660e822d59286e2f27f3971a399178,989905,2020-09-30 06:02:29 UTC,67592804,67582804,false,10000,0
306daad7b350ba4b2737152d12ed9e3333a63f2a2e110e6e0e7fa02d1561e9f4,989905,2020-09-30 06:02:29 UTC,88953203,88948703,false,4500,0
20646d249da1df8d5eb85b4e0c2d0488173c9838f383bfefe424df1efdaf66d5,989905,2020-09-30 06:02:29 UTC,54449,49569,false,4880,0
c750df78f368275a596f24dd50290f59067223e506fa766277747e8ae5954e14,989905,2020-09-30 06:02:29 UTC,144057594,144054634,false,2960,0
49cb3cbdf5f1c03ddc7edc7666bac58fa8268b69494daaf7ca20f1d012dd4183,989905,2020-09-30 06:02:29 UTC,94827126,94823220,false,3906,989893
dadce3d403c9ddc4f1fd3030c433bd8be76f9c76015ca194add5b9ab4c8c5cd8,989905,2020-09-30 06:02:29 UTC,10000,0,false,10000,0
7a320ed163c789d785f38b0d1ce68aad20f12033810b72e4ee01021bbe2e2bba,989904,2020-09-30 06:01:09 UTC,44656138,44646725,false,9413,0
6b493998fc79c468819803eaab995ae8627aa9956402ddd122b491d1145f68d3,989903,2020-09-30 06:00:31 UTC,8000501567,8000497341,false,4226,989892
58b6ffa4973638feb10534057d9f226cf80be120c3287499a0ad8e76ba42d662,989903,2020-09-30 06:00:31 UTC,44727195,44717782,false,9413,0
10b5eda3d59cf6ea29cfc3d97acb9a03dbe94ed8644bd82f449eb2c32c3e9e29,989903,2020-09-30 06:00:31 UTC,10000,0,false,10000,0
4c052d968e825a42ddd2ee08c6cb1f8621ed3aeb03e6d1a45cd6c1161f2a0c79,989903,2020-09-30 06:00:31 UTC,100000000,99997550,false,2450,0
2b8602c16347427e677a34e28c4c6adad91708e4b40076e69b5a79841a9137e0,989903,2020-09-30 06:00:31 UTC,1500022754,1499949399,false,73355,989892
50e522af63daa83d9587dce471bf785e04b5dd745562f0df02b194d2f566a381,989903,2020-09-30 06:00:31 UTC,528912396,528888327,false,24069,989892
8c8345ad293bc8c0ffa099cb7f426363c19cc0d395a145cd15cf6cb23b027937,989903,2020-09-30 06:00:31 UTC,7128,6078,false,1050,0
1adee785ca942cd44009dd8045a847cf3b257e90b68adf7a6c07906234d07a78,989902,2020-09-30 05:57:52 UTC,347850260,347844260,false,6000,0
1ab437d7dd68704bb0009413048aaa14061c18ce8b57d0f73b16855c5c3ce2fa,989902,2020-09-30 05:57:52 UTC,10000,0,false,10000,0
777392d6e28b2920ed327d1416d0db38797b2e7bb86e6765756d3342d6a45447,989902,2020-09-30 05:57:52 UTC,44755617,44746204,false,9413,0
8f3a3080d0663869ccf13b83d4531fc650ddb764a5fe4fa5780169da71c399dc,989902,2020-09-30 05:57:52 UTC,360796461,360781221,false,15240,0
7479cb3320e071aba8bee241e58812d122e711657161aece27de1477cfd3764a,989901,2020-09-30 05:56:59 UTC,440802234,440799938,false,2296,989890
b15eb88e5cac75d4474f7e6d0903a045dc6dae8423b948c9d7af8e4836b3a8cf,989901,2020-09-30 05:56:59 UTC,217468832,217374919,false,93913,989888
ec1389777424235dcea423e842b0540e0979361dbe1fcb420ab023568a9ad2b7,989901,2020-09-30 05:56:59 UTC,190541749,190538789,false,2960,0
14fc923ff5b5609bc90f1d9073bad9fa0560c385154dce26aa8c46b0e6a842b5,989901,2020-09-30 05:56:59 UTC,10000,0,false,10000,0
4c3eb056cb35a6c78dbe67744ae806e520fdb31b43d2e19e6fc883f04014b74b,989898,2020-09-30 05:54:15 UTC,127001081,126991081,false,10000,0
ad6e13394a570604ad288280daf24af4f04abca20a5851f0a86f39caaf3087fa,989898,2020-09-30 05:54:15 UTC,10000,0,false,10000,0
f1076c62a7c0df0f1bb8acd4a5492449a7b1f6fc740cea567d47618fd5bdd91f,989893,2020-09-30 05:52:48 UTC,255453394,255353394,false,100000,0
9619fce18f0ed4f233ff169a9ed8abb8218c2a3f2ebdbf2cff696a28b5a0927d,989893,2020-09-30 05:52:48 UTC,10000,0,false,10000,0
03fc2354f996bd214cd53b02ab05982d8ea0a2b25bfecd68f42b755e91ccc742,989893,2020-09-30 05:52:48 UTC,137735216,137732256,false,2960,0
d8b6732ff47deb1fc194499dd7ad6c4e195860c83f4ffc88154253fc38039df6,989893,2020-09-30 05:52:48 UTC,10000,0,false,10000,0
f771f0395dd3873008b88a8cce09b1c92b96fd874fdb174785548b41a26dd513,989893,2020-09-30 05:52:48 UTC,10000,0,false,10000,0
472462b5960aa5802dd789f3712adab22aa888c0f2085a7553e1ef11861929fb,989892,2020-09-30 05:50:56 UTC,1019335,1014243,false,5092,989881
3a608c1f9665c6dfc33ca7ef07606d73ed509aa39323bc2364930799cf8c78d0,989892,2020-09-30 05:50:56 UTC,9427537290,9427437290,false,100000,0
875cfa09be10d7da6b5aae7555f80f7d0e2efcd15afe2856ad5828cc7b0e7a1f,989892,2020-09-30 05:50:56 UTC,1501009620,1500949142,false,60478,989881
f0288fc32cb344284faf918a2a8ba7ef93ec160a4abeb09bc8c7ef99e52d7f2a,989892,2020-09-30 05:50:56 UTC,121034790,121018406,false,16384,0
3771ad86ddeb09ff7a1aebd7d8e553d6e3102e8eb6e2cb34f31851062267b6a6,989892,2020-09-30 05:50:56 UTC,529331514,529310684,false,20830,989881
87f1f8e1a2db5463d1dacd155e7c4d97c0c93db40415634fd49761afcfedf4e1,989892,2020-09-30 05:50:56 UTC,10000,0,false,10000,0
787478e2cb61e9cdafd8407f61a0683195f1992de23993b6e4919a49b1150285,989891,2020-09-30 05:49:52 UTC,699100000,699096550,false,3450,0
f920dd55294bef76ecdebb406d12fc4695b93b6335623ded5dd1774c66879056,989891,2020-09-30 05:49:52 UTC,19710273621,19710263621,false,10000,0
c6159ff40bf2b0959830ad47fb115cc6367bc78c4aedc9a3b58635a9a6102899,989891,2020-09-30 05:49:52 UTC,10000,0,false,10000,0
ace776c124818ddcb5f49a9e9bca68a601436626867b3160d1671d921ba8c47a,989890,2020-09-30 05:47:51 UTC,1673697036,1673621740,false,75296,0
bf2cab2fd392e268711d1f7c025cb6ce5666316a2e8a635f559f4f0ecb8eaecc,989890,2020-09-30 05:47:51 UTC,27447670,27442578,false,5092,989794
90704c59371316f607b90e1d9b04c248d0f2496b0122f9335ec260012dd2695c,989890,2020-09-30 05:47:51 UTC,10000,0,false,10000,0
c2ddc792badbe329be3af8f6dc489cea0669f8419950634e111699c7a3652ca9,989890,2020-09-30 05:47:51 UTC,242632536,242630000,false,2536,0
487a681b861386e172fb5ad1ec30b5c0f17cccd574f37bdcab3bc51d1995f3ac,989890,2020-09-30 05:47:51 UTC,19750285415,19750275415,false,10000,0
e02d9934d10e2eedf3af53d7dabda6d719b7f244ba1c8767a48a832d55efbde4,989890,2020-09-30 05:47:51 UTC,1015319,1008539,false,6780,0
fd7700e46107f7f0d8e1b4f415936b3e5a0b69314e0aed385d5feb3a3fc0ee26,989890,2020-09-30 05:47:51 UTC,126222864,126212864,false,10000,0
ddf0f4444db67306e42d4522992b3d41f8d384c65d0c664b4109c4e7ecb2aed7,989889,2020-09-30 05:44:06 UTC,10000,0,false,10000,0
6ee17e9e842068c448a35ac89064f2ce77ef014d6a9e2e5ff93b8338109f2d0c,989889,2020-09-30 05:44:06 UTC,144271636,144268676,false,2960,0
7690cb77e73a63e9626b4b5377c4754713275e5a7b856b9b6165ce937a3970e4,989888,2020-09-30 05:43:23 UTC,242650536,242632536,false,18000,0
db088537915fd738767446f551aa42d7f9a8ba6abf907c83302985524e90fda6,989888,2020-09-30 05:43:23 UTC,17096927,17095927,false,1000,0
ea4311d5d77040f42698ff6ffb3027f271622cdd58fc7fd527e3bcbdbc8d8b69,989885,2020-09-30 05:42:03 UTC,10000,0,false,10000,0
c675fc13fe301344babebbb01258e36a410fe4eb3ec8987ec4d15f27f34af480,989885,2020-09-30 05:42:03 UTC,1575704287,1575604287,false,100000,989874
383492cbdeda2684f29057041e79d2d88a68d4d760c3cacda946e309b46f5bd0,989885,2020-09-30 05:42:03 UTC,19090176,19082317,false,7859,989871
7c59086a2af4427c3c2ff4192647c0e3f28ca783b32f2680e9dafd52f96a63d7,989885,2020-09-30 05:42:03 UTC,19750295415,19750285415,false,10000,0
7fa1839f04fea3b6e5761ef27839896511f694f10d8ffc184bbf1e977317c43d,989884,2020-09-30 05:40:36 UTC,27847243,27835158,false,12085,0
8b8a81d2c3b23c38dab2f56a7b28af592bc6755f2cb11dae07a0fbda86275ee1,989883,2020-09-30 05:40:32 UTC,1501983491,1501927456,false,56035,989871
85d375d127f8d97b8b4eea62cddbec8fbf929ccccc60d3e2cdfcb534d50d2bad,989883,2020-09-30 05:40:32 UTC,258162614,258160308,false,2306,989871
9883cdfc4bb6c4d1324b627498a0921bc69ffced434a3148d206b1f55b75a5aa,989883,2020-09-30 05:40:32 UTC,10279196232,10279192492,false,3740,0
6a9340b95e42f586dd871b2bcdc08898bc6389ba833e3b83c024ba521982b029,989883,2020-09-30 05:40:32 UTC,672371504,672351504,false,20000,0
6c43beebfea0d205754bba01dff12b9e02e54ba5d9e7db826674384644280954,989883,2020-09-30 05:40:32 UTC,529889834,529867403,false,22431,989871
b28f7d9120db0e16135a8a33d53daaa6be53044d89d2528b4bbef33c424f4459,989883,2020-09-30 05:40:32 UTC,10000,0,false,10000,0
9a9b17e276ac6fa78ae81e578132a561d334823d017636e589447ea97998287c,989882,2020-09-30 05:39:12 UTC,44856585,44847172,false,9413,0
516f9ac38a7f38033778d322d76122c59f158bc665c475b3c5808e5687bc24b4,989882,2020-09-30 05:39:12 UTC,20771152705,20771142705,false,10000,0
b460b11e79b31fee651a908ff241a6b98910cfb6294e8c1ea2c68bf47489889d,989882,2020-09-30 05:39:12 UTC,74983524420,74983521730,false,2690,0
d8efedf7552f787a3de78e15a1f3d7603876285dc212c7fe63e7da82419de42e,989881,2020-09-30 05:38:49 UTC,10000,0,false,10000,0
cdad8177d922d89ad3d88f5a58ffe15d45b193a843175fd468539b14fbe22bb5,989881,2020-09-30 05:38:49 UTC,1000402219,1000392219,false,10000,0
b1133896dd7eb1792f261321821dbbc9efca7291f721ba399cec7d25e3cebd59,989880,2020-09-30 05:38:09 UTC,125000000,124990000,false,10000,0
6e25529a4c2b4307c5daf3203fea27ad6de33e986ff7eaa2b8da0b4fceba7e1e,989879,2020-09-30 05:36:58 UTC,20771162705,20771152705,false,10000,0
a27f5c003d531d23dbb83f5990211b4dc9e8a590c3b2ea1df6a1a71ce06f989e,989879,2020-09-30 05:36:58 UTC,190790366,190786793,false,3573,0
7484748c304d2d4c7573009edcf68563599cf94b2d21f32009fa47e61d29d55b,989879,2020-09-30 05:36:58 UTC,106568589,106556589,false,12000,0
60408152f631a1b14e9368c08e2b52363d37551c76c7c2431f827d2585ad5c39,989879,2020-09-30 05:36:58 UTC,10000,0,false,10000,0
d1cb25ce73cac13f60460cf0e0f85f57b3534200f1aaf04cbe1a60b664287d9d,989879,2020-09-30 05:36:58 UTC,454262182,454259556,false,2626,989868
37d58f159d4a1ec7450b244e3dd00fbf08d4a8151556ad4eecc3a5d35ed8176a,989879,2020-09-30 05:36:58 UTC,10000,0,false,10000,0
5b4b548d5bb484120c7c25f4fac33a2a4e3f4bcc3bfe947a42746258cb38b9bc,989879,2020-09-30 05:36:58 UTC,50015099972,50015096232,false,3740,0
718a5a0e0f22627508769dfd7dbf4dc20439aedf4dca7b5f1140cbf6db949849,989879,2020-09-30 05:36:58 UTC,10000,0,false,10000,0
1f3578a127e8813b0abd549a14b779e23253a92db7f59e5af63c9146ffb3f476,989879,2020-09-30 05:36:58 UTC,238633,203813,false,34820,0
c77222da184280fc06e85cded14d877f18be5b6db794a9a78116fba9e1f6b2c9,989879,2020-09-30 05:36:58 UTC,996548299,996419279,false,129020,0
6a489c09742cf0089846fa0d4a235e77285f13ef6f678ea999d03b3e31207a11,989879,2020-09-30 05:36:58 UTC,3164421555,3164417815,false,3740,0
4640025979dd922d33c8ca20ad974f3230263f2ca4400b7ab687a0af31ebb4df,989877,2020-09-30 05:32:21 UTC,530215832,530198861,false,16971,989865
02bae2f5e068efc248ecfde35bcc0a78b814e1f4bd7f4676bfab385ad2db165a,989877,2020-09-30 05:32:21 UTC,45096824,45087411,false,9413,0
0c8b1f90df060d03ea709e7250c3c96a5c3a1b4987a84d7454a05f0336c16e3b,989877,2020-09-30 05:32:21 UTC,44896970,44887557,false,9413,0
03531b3e7f659691e1ed6828f7857488f16ad1b53ab8a9fc96ec8ad4423897eb,989877,2020-09-30 05:32:21 UTC,10000,0,false,10000,0
cff0d57024a4d440c369aab1392ea59128bb76debccfc797275ef0e70ffaa09e,989877,2020-09-30 05:32:21 UTC,464393725,464386173,false,7552,989856
28475e3926e25b4f11953530ea86f0bb80b732f2c69fcf600b2982d196aafad5,989877,2020-09-30 05:32:21 UTC,353074599,353022019,false,52580,0
2ca7a83d1955e00509c50b14651d258cc49a409dcd7f5a3a09a18fab74f32c11,989877,2020-09-30 05:32:21 UTC,499980000,499970000,false,10000,0
208d8cb6cc9aaee83d81b4fca35709323a76f2d61dcd9df8a01936dfd52eeed1,989877,2020-09-30 05:32:21 UTC,1502879380,1502817885,false,61495,989865
3b9fa52c92221ece8fa2c6f252ca931aa5cef9981b976ca1544dabaaebf6732c,989877,2020-09-30 05:32:21 UTC,225464273,225454273,false,10000,0
93d142e5d7a6a764c627bb854fb865ec50b6fcb6a5777c74c6a6315f68128afd,989875,2020-09-30 05:29:44 UTC,142500000,142424704,false,75296,0
175b0c9edf4c2a2c1d0705bc36cd640e43f91f0efa52ad858b9aca627fa3a8c5,989874,2020-09-30 05:29:22 UTC,426347730,426341730,false,6000,0
523272306004617d2069714c03e0bc4e4711b87c61b2329c57475a95c4e40d60,989874,2020-09-30 05:29:22 UTC,10000,0,false,10000,0
c63a1470385b57b32f2b76eb3fb5bb01073e234069cee051da68b9eb30442da4,989874,2020-09-30 05:29:22 UTC,50409499,50406099,false,3400,0
df844ee2edc03662c0ae6cc71d98f3a67f824ffcf686ea44bb8ef5eea8fe8db9,989874,2020-09-30 05:29:22 UTC,74045503,74033418,false,12085,0
e094d2e05d004c75870f6dc8fa4a16e05faf542cf488775bbaac3df669e68218,989874,2020-09-30 05:29:22 UTC,21883661163,21883658857,false,2306,989863
354dc75a66dcec79e41ced5d23078d0e66cf6f0c79e9006c69a7c75aff0d2b3c,989873,2020-09-30 05:28:37 UTC,45126065,45116652,false,9413,0
b291e1dbf8986c68da934bde9cfd9b234ac64052ffe8ce712be33c6943ecdf7d,989871,2020-09-30 05:27:49 UTC,113461,89461,false,24000,0
4825e1aaa6ced33fae753927093665ee7b9caf90f6c1e471a424bc47d125733e,989871,2020-09-30 05:27:49 UTC,24927541878,24927430082,false,111796,0
53c16e9b7734ec24a5a7b1dd1779894adb4cc1818f7b4ece40ab9f0fd7cc0eb3,989871,2020-09-30 05:27:49 UTC,5880095,5878949,false,1146,0
da4eba5af996c01eba37a23dab6a9019b022ccc929a3d3e1bc813ae1b588d9c0,989871,2020-09-30 05:27:49 UTC,1027124164,1027024164,false,100000,0
946b2e79f09dedf716ac0ec562eac4e338dc6d91d703331d72f4afa814fe6e06,989871,2020-09-30 05:27:49 UTC,845727073,845724743,false,2330,0
3ac1528d44fd89c70a346e4331211829fbd7797675861b0a8f01a83cb908467b,989871,2020-09-30 05:27:49 UTC,10000,0,false,10000,0
ea4418137e58b30ca692b2c33925016d5d231d0cfdebdcf9b1ac4f248dcf13b5,989870,2020-09-30 05:25:01 UTC,45216160,45206747,false,9413,0
03f7c0565e480f5803a6ade90b1817ed958f4006e823af018232ef415556ef75,989870,2020-09-30 05:25:01 UTC,10000,0,false,10000,0
b0d19b8a5e0f476b1fcc297b8c23e9ced2da38cae12a0b9537e8858cd49a7ab0,989869,2020-09-30 05:23:48 UTC,1503802648,1503745060,false,57588,989858
c47997b1520c0483effbc5eff64a56ce67a3c3d3b93ecaba3b4823ac56be8933,989869,2020-09-30 05:23:48 UTC,500474960,500472664,false,2296,989857
1f04088ae230400ca8867b1231e4ef789d61882abe2de3c0938266432eaa1222,989869,2020-09-30 05:23:48 UTC,11047570,11043871,false,3699,989858
8201111baaf0fcb1872250797be49ae673976a86ec4ff770b3c9bfcc0061fbe5,989869,2020-09-30 05:23:48 UTC,10000,0,false,10000,0
cb71dea5493df5208eee279cc97d123b14e576de75e9aab9566ee4ddc36b77bc,989869,2020-09-30 05:23:48 UTC,45289313,45279900,false,9413,0
6609f7f33cf5aed2a079f62ec6636ada932cfc2b1ec2e3a9882c439673502cfa,989869,2020-09-30 05:23:48 UTC,137943143,137939876,false,3267,0
71d07f389dd13bec38c79a0f4460117b67b8c3f8bcad7743ea2c71bb448b83a8,989869,2020-09-30 05:23:48 UTC,20549712639,20549702639,false,10000,0
2bea8172fc02f3a15aeeb0dd3d0bee6e8658ff64ea14d899b1edd6f827dca2bf,989869,2020-09-30 05:23:48 UTC,10000,0,false,10000,0
834ddf30b648cc47707b91160602d6a55e2b81bf8f4388bde267f86373b30cdd,989869,2020-09-30 05:23:48 UTC,530677815,530655356,false,22459,989858
a234f7f1ba26c919c317d7e252014948bd7e268de6e926b24bcffb26c1eec93d,989869,2020-09-30 05:23:48 UTC,100000000,99997550,false,2450,0
3aedd011a2aab0bea74ca8924fabbb98d137595d47b1dec26e51a8f96facb5b3,989869,2020-09-30 05:23:48 UTC,21124010,21114758,false,9252,989858
c6b1b0a16dd3f17ff6c8c7571068e8690ef522d26a29e5e912323e9bc8b51949,989869,2020-09-30 05:23:48 UTC,102141777,102114671,false,27106,0
1aea8fee63b966b68c27cf337b122499f2daec4c6934ad73186d2b7f7ff1a851,989869,2020-09-30 05:23:48 UTC,45249258,45239845,false,9413,0
76b8782c5e6654384266edccb23864c6505089a0e479710934439acb947cb345,989869,2020-09-30 05:23:48 UTC,70346422,70316310,false,30112,989858
8c41e659056a407d3756ae245ebacd441c4f4eec7dbf166f202a5e010e5990ef,989869,2020-09-30 05:23:48 UTC,499990000,499980000,false,10000,0
74781dacaa7e5ff35964e4c07f4259838af0316eca7953f646e342856da60994,989868,2020-09-30 05:19:25 UTC,22000636942,22000626942,false,10000,0
09ae15612e5db670b3cf3dff1dfa48ce356f9bd5ef0382cb39f93e3e7cb3feb2,989868,2020-09-30 05:19:25 UTC,509500000,509490000,false,10000,0
f7ad90d2f80f478776f63ce360718a63d399a4f39d49aa80dcacd7cf625055e3,989867,2020-09-30 05:18:45 UTC,10000,0,false,10000,0
a999c7e010e816863696f54131eacbbd8e3a50a04c719ffbf4501d590db460e7,989867,2020-09-30 05:18:45 UTC,500000000,499990000,false,10000,0
aa036da91e56a015eb1fe3bf40c589f96183018918e96ee017d592b295b7d149,989867,2020-09-30 05:18:45 UTC,10000,0,false,10000,0
358ec7abcf5e70adf01be0aaf05938a3032aff510893b9c1c0e9cbcdc77c497b,989866,2020-09-30 05:17:09 UTC,119136324,119126324,false,10000,0
e2a114d6c1f64ac551ec20461979228778b6def6fbf7c42b74e4e754c05aabdd,989866,2020-09-30 05:17:09 UTC,594360810,594330810,false,30000,0
3637d7c8c1da5dcb3fc279ec352a37448179f8595f85c1ccce35d10916b6d87d,989866,2020-09-30 05:17:09 UTC,402020087,401951909,false,68178,0
f7a374351cd2245e62c03672e40b09c331fbeece705b98996b41f15e7d48506c,989866,2020-09-30 05:17:09 UTC,10000,0,false,10000,0
944f2a2bfe76f85547fe92b4c7ca31b81f2d4efefc9ee6351177f5b2cfd56c7a,989866,2020-09-30 05:17:09 UTC,1009637,1007331,false,2306,989854
71932dde72399882437194ac0b2fa335c0495eb12bc9aab36a6594a749c22f5f,989866,2020-09-30 05:17:09 UTC,500010400,500000400,false,10000,0
ff152d833a5c54272151cdc8abff34c92a7b405899fb765336ddd80eac98e885,989865,2020-09-30 05:15:10 UTC,10000,0,false,10000,0
778991326d87bfaf46f411a096cfe69a24ee2cd8d6d5ef8698ddc8b3c3b40f51,989865,2020-09-30 05:15:10 UTC,21822,19372,false,2450,0
4c96f35aca40448b9bcd4a9cb640e61b752f44e602160132a2246dd4c56f1898,989865,2020-09-30 05:15:10 UTC,500020400,500010400,false,10000,0
d79778d2ae548a73f85a3a1f30b64782547dc43572461793c96585b6aa2be7a8,989865,2020-09-30 05:15:10 UTC,126367,123917,false,2450,0
c9acf697f705219cc0f6b440b3d5d9d2e99fa960b00bf0869a48ae8aca89598e,989865,2020-09-30 05:15:10 UTC,144623676,144620716,false,2960,0
79d7a6e9379589752ce5712eb4463bc59faf8252cacda91789ba89df49e181a5,989865,2020-09-30 05:15:10 UTC,45317347,45307934,false,9413,0
606bc72ce5e5c876021524b32a8519423826f32af8dcc6a78d7cdaaee82a3b20,989863,2020-09-30 05:12:31 UTC,45375807,45366394,false,9413,0
83a3e091704d9c387303003fadf239b725c65616f7e20acffc76710596580776,989863,2020-09-30 05:12:31 UTC,9981029800,9981019600,false,10200,0
f4318131de9fe18d4d421b3fd3bb2254f95dc7bf5cc0e7659ddb78faea17558d,989863,2020-09-30 05:12:31 UTC,429173464,429098168,false,75296,0
0062cbb240cfb45734740a694771c5652c0d4efd95c9d14351e631c43871f6c0,989862,2020-09-30 05:12:22 UTC,45759664,45750251,false,9413,0
93fc01ba4538249406b82f4f78eee1fb8ac5408fe41e1304f62a846c3d54504f,989862,2020-09-30 05:12:22 UTC,10000,0,false,10000,0
2cd7cddee5dd037471fd9b6209dc97b392f5a7631b67e7578d3cf33c11d07e29,989861,2020-09-30 05:10:36 UTC,10000,0,false,10000,0
ae318e3c875b67cde41e9013f3c3785e9e43e919d06fd069a98391f3c09195d3,989861,2020-09-30 05:10:36 UTC,531315215,531288633,false,26582,989849
633fbb69aeb2e64d868e01acd0e78ec79eb4a1269df0972cedd810d03161cbd0,989861,2020-09-30 05:10:36 UTC,1505008949,1504942691,false,66258,989849
d2f4f916546d7a77167624d84bb9f4d64f3abcaa90072b578072dc22fb2a405f,989858,2020-09-30 05:09:17 UTC,10000,0,false,10000,0
26ab4b1f09e781583468c5ae0fdba3b328360ab650f82e11f4f22ec371a47fd2,989858,2020-09-30 05:09:17 UTC,6000368981,6000358981,false,10000,0
c92e6868aa8eb3cc43cdda656c1ef1d01d799711e2f8b2bee6b44c747663d054,989858,2020-09-30 05:09:17 UTC,21836296461,21835796461,false,500000,0
57dd7f65265ffb67489c82e99247c869eafca44605907668ea0ab2136674f2b7,989858,2020-09-30 05:09:17 UTC,164664225586,164664221766,false,3820,0
657c44bb90f2ce804ae0cb6b90d558bce454fe2518dacaffaaa907980670bfdd,989857,2020-09-30 05:07:06 UTC,2000036271,2000026271,false,10000,0
69f5d0af398c0c4e3569633308498518b6d6d76c277f1a8d13f58b26975e161a,989857,2020-09-30 05:07:06 UTC,502501695,502491695,false,10000,0
51065b7a0b0ca5bf440a5ea743558035605a6aae9a77dcd211afbeee3a7e4ae9,989857,2020-09-30 05:07:06 UTC,190939225,190936265,false,2960,0
1c75cc817ed84da8c37514db51d9347bbc7b7042f5a8348ddbdc369e74d051d2,989857,2020-09-30 05:07:06 UTC,7250270,7238270,false,12000,0
357bed9502887f5bd3a97128f316320f6be9f13f1a530914d196f14699730195,989857,2020-09-30 05:07:06 UTC,10000,0,false,10000,0
3b4d719c604b43e7e510bfdc3c984a555eda71c37cdb01e7a1435ba2da75407b,989857,2020-09-30 05:07:06 UTC,34360,24360,false,10000,0
68a7cd9b6ef9358073fba28f8a910966e937122d57e7373f35f3b3d91de08bd8,989857,2020-09-30 05:07:06 UTC,16690063748462,16690063734722,false,13740,0
52a33a01a05bbfcd8b28c9c8f7d8e375499c214a862ade8f6f03afd6240d7542,989857,2020-09-30 05:07:06 UTC,2500381865,2500371865,false,10000,0
7d7782f8173099b588f56f178f174d7fb5e046f6b9b1d540ee36f40802afae9c,989857,2020-09-30 05:07:06 UTC,1500305881,1500295881,false,10000,0
2d9c8648bacd971b6dec8c26135311a3a34df68bb695827fb1ced5da1b0f335b,989857,2020-09-30 05:07:06 UTC,392585700,392583410,false,2290,0
393d060d1c5b7b977eb542f411e869f4b74961ea91316ad62530e9560b9752f6,989856,2020-09-30 05:04:34 UTC,5831994,5830074,false,1920,0
7073787965683a3ff0387dfc6e387ec10562e9eb48fc92adbd0eb1547eb8b82d,989856,2020-09-30 05:04:34 UTC,21945605359,21945603053,false,2306,989844
47aeb776c6bd2a90573e793978a18e125589a2527671dcd5eb7b56738c91348c,989856,2020-09-30 05:04:34 UTC,10000,0,false,10000,0
bd897b7c7963ff8df541880f35da1962685cb21a695d77fae44774d7887f9f5f,989856,2020-09-30 05:04:34 UTC,247678067491,247678057491,false,10000,0
3f50b3ead52793a81a7399e2683ba012628ec862f3f966fa1ae858dbfd6065b5,989855,2020-09-30 05:04:02 UTC,3762000,3755220,false,6780,0
9fe7b7917e8304e3a80b0488c1f20028292bfb4920dc4efc6bd1bbb1d1d709ee,989855,2020-09-30 05:04:02 UTC,115119870,115109243,false,10627,989843
2a4d8aa405ce8b1a451f4904e39ca42cbcd05973975125b87d2cb755d882892b,989854,2020-09-30 05:02:33 UTC,138131615,138128348,false,3267,0
f81bd60d8ba76abd85045722389c215ae3ff7e547af89ff56b0c039406d31d77,989854,2020-09-30 05:02:33 UTC,10000,0,false,10000,0
e9d7d7b9ee42e805fb96b1528a4bc8e268e9e4aa98b9a41acf15d3a4daa36300,989854,2020-09-30 05:02:33 UTC,502511695,502501695,false,10000,0
8befd77a7971af08756db555797b9446fd5f42f18f0935d8ec43eaebff1ea0c4,989853,2020-09-30 05:01:14 UTC,531908040,531885609,false,22431,989841
6fb0de9d7a9ada6777731ffc821c32aac02a7814cf7166f3b657f75c3022c7f5,989853,2020-09-30 05:01:14 UTC,10000,0,false,10000,0
cd0b79e70402af4a62622a53f0c4cfe1da2f1bac8b09068eff94364e47531446,989853,2020-09-30 05:01:14 UTC,2679660,2677354,false,2306,989842
39852a2d30d1bdc677e549ce423bc547b09910a69002233eaa9a79cdac3e999c,989853,2020-09-30 05:01:14 UTC,1506216225,1506148386,false,67839,989841
253370c846bd3f03597c10c80992d603e6c59a2feb64b309bd353a4b8d275096,989853,2020-09-30 05:01:14 UTC,1017928,1012845,false,5083,989841
80af24abed24a65705080a6f0ee94753f875532ab075c3adeffe4da48fc8354b,989853,2020-09-30 05:01:14 UTC,136814768,136811822,false,2946,989842
eb922875a605fb1eadfac5b897777494cc132bee5c16b2ba0fefc654c1c57a99,989853,2020-09-30 05:01:14 UTC,55867310,55837594,false,29716,989841
8df8bbd348a235865858b22755383b0cb033be45f65e21b2c874546af2a51e13,989852,2020-09-30 05:00:07 UTC,20998154847,20998144847,false,10000,0
44cb4ef145eaa002c0a4f4a6718104aee75b932fe74470715f68606cdc35ce3d,989852,2020-09-30 05:00:07 UTC,70322148,70316148,false,6000,0
570ddd0a783c062aecd421551be3f08c7e72e80ae3c9b895917a7ce080eae336,989852,2020-09-30 05:00:07 UTC,25934407980,25934226496,false,181484,0
b8e3a71d0b1ab937760b29c84854966bcb16146848277d75e823c73e24a41373,989851,2020-09-30 04:59:06 UTC,150097740,150096450,false,1290,0
736d325d8e13e8f5e676e82707c629ef613a7386161423a3b8ad41520e2c7b1a,989850,2020-09-30 04:58:39 UTC,10000,0,false,10000,0
75b3070907f611c8c40bd9192e85bba5686f8b4db3fb0f2ed677b25f25e5d2f6,989850,2020-09-30 04:58:39 UTC,1027640,1021174,false,6466,989839
08f067bacc04d5207fe3c53ca30c7a0c6e55dc555b80ff4f4c7d50e4d07a994c,989850,2020-09-30 04:58:39 UTC,144960040,144957080,false,2960,0
327e3fa75cd0896263335d52589f2ac5d3cd6b12ddf1a594f63d232359c663b3,989850,2020-09-30 04:58:39 UTC,45808629,45799216,false,9413,0
05fce204de86c13a5f9f173ec0866d9447c053e386f719010dffcae423954224,989850,2020-09-30 04:58:39 UTC,25146681625,25146679319,false,2306,989839
49e3c24020b10cb6777499b1570c98354dd61ea075a817d0d4da581c53040bb2,989850,2020-09-30 04:58:39 UTC,10000,0,false,10000,0
886d13288373fd3567ec9937f42b4139ef39ffa80f8a9d659e8edfbf88886d3f,989850,2020-09-30 04:58:39 UTC,21435214298,21435204298,false,10000,0
eed8e83c657c9624e725a3b261b8885b06aa5891d23a6d072f15c215bfa30e52,989849,2020-09-30 04:55:37 UTC,4000000000,3999997464,false,2536,0
255dc2e9d549a79976af3279580440310b84e22d88400860d8448d33ca8261cf,989848,2020-09-30 04:55:20 UTC,3604887,3602260,false,2627,989836
bc76a56cb6af3de3a8d59d924ac7da515594cc4161fb50cc8bff8a71ca5671c0,989847,2020-09-30 04:54:34 UTC,1124839325,1124764013,false,75312,0
b8a83075bd373c1967af6c7a5e61fd58e1f2a37351bc60e4a0cd274cd86cf646,989847,2020-09-30 04:54:34 UTC,743000000,742998080,false,1920,0
73250f7e480599339d57f2614ef7ce8695fccf9acb66e70b971af2a63e55c612,989847,2020-09-30 04:54:34 UTC,2283058835,2283054335,false,4500,0
28bd03e9a06695de05e291722a5ce90c3a11a0c64b854f82bc8c694d7806c460,989847,2020-09-30 04:54:34 UTC,191330083,191326510,false,3573,0
85ddd55aa0267c099840d4fbc0c8ecd45037ce95801bf2ff51bdfe76b052011d,989847,2020-09-30 04:54:34 UTC,10000,0,false,10000,0
18278107247c4c7dd0b14d43bf09da7fd4659741ec10c0a358abb3d937e84d29,989847,2020-09-30 04:54:34 UTC,10000,0,false,10000,0
df3807d95183088597df52b8b954d3efe701ee989f16548a554f3985c97ec681,989847,2020-09-30 04:54:34 UTC,45843274,45833859,false,9415,0
db65af2b5e649aef8bb86bcd9bf1bcaea2fcaddfdee993c1dad6cf0d2e0f50a2,989847,2020-09-30 04:54:34 UTC,4070328148,4070322148,false,6000,0
3505e3c0dd11afb4f77432b67c06e279e0ec3c8823dc08caa999a4522340133b,989846,2020-09-30 04:52:30 UTC,10000,0,false,10000,0
435c8f3de3d738fa03702181efec87e58791062b698587bb28a69c5068adda61,989846,2020-09-30 04:52:30 UTC,45892071,45882656,false,9415,0
752152fd46b4c24b94961b9ab5c93768549d96aafbcbbb919714c6a1f7590312,989846,2020-09-30 04:52:30 UTC,532518284,532493259,false,25025,989834
72c0c418713fbb1b8da3dc8e25d43a4bd5de725b5ec74d55478ed5ba9517e5c2,989846,2020-09-30 04:52:30 UTC,1917937135,1917921555,false,15580,0
a82165c7d14c9a28a2e21330c694684eafb37f88d525d3fd4a9bec2e94780d2a,989846,2020-09-30 04:52:30 UTC,1507542843,1507471139,false,71704,989834
8bc7f26208f569f775b4d4df033f5f4ed92126e216075ce2c3aeaba82d13146e,989846,2020-09-30 04:52:30 UTC,21435224298,21435214298,false,10000,0
4a18a37025c4018a5edded74829ac293f53cb4b8cb74935f54f71bc82d0a2a49,989845,2020-09-30 04:50:07 UTC,45947326,45937911,false,9415,0
5b1641f2978c31ad4445b5e68ebb0582194259144d6e9a94139763ea4733a569,989845,2020-09-30 04:50:07 UTC,466909767,466907847,false,1920,0
6ff647e328a937d3ef02412ae35fe4e1d91cd0f8c69acc9711e008481c48014d,989845,2020-09-30 04:50:07 UTC,10000,0,false,10000,0
7666daf30b1a2661d3352201b2835300e4f08fad07047ee950c70e1586caf840,989845,2020-09-30 04:50:07 UTC,499984601,499974601,false,10000,0
5dfcc087dbeb02395065348bfebcfcb114fff3b8aad6772c98bad04b4a117ab6,989845,2020-09-30 04:50:07 UTC,88552562,88550256,false,2306,989834
4efa151a80bd398d550110ed631281bf90024fdd45d60808f3f8e25a1db8e785,989842,2020-09-30 04:48:37 UTC,138359026,138356066,false,2960,0
28cf9c23362dfc47f8026e98d258c65a09a30a669101bd876aca87d742a13202,989842,2020-09-30 04:48:37 UTC,10000,0,false,10000,0
7862227cc2b62f53d4b521d56162ff37f3d2d055dd5eb616570522185467f80a,989842,2020-09-30 04:48:37 UTC,95898001,95896081,false,1920,0
056c5638626b518f43bb3f164071a60e236bc2a8572c3df8b8a602b142c14d64,989842,2020-09-30 04:48:37 UTC,101010662,101000042,false,10620,989830
568750a62b8d7c02bc5850a36a6821983f09be145dc721198988e8534fe96ee1,989842,2020-09-30 04:48:37 UTC,255725781,255625781,false,100000,0
0f3c7f96582e39d681397d4be7641f76b4b29af952b3b0082ba937f5f88e77c6,989842,2020-09-30 04:48:37 UTC,3028014925,3028013643,false,1282,0
d6516a95e3b86d95b779cc0567494cd20bfb26359311ad745e3438a6cf2f9ae7,989842,2020-09-30 04:48:37 UTC,499994601,499984601,false,10000,0
96f3da1e3fe3cadc555f5244d581c739679c9504283901ff3b9941a1f3b96150,989842,2020-09-30 04:48:37 UTC,22461674,22451674,false,10000,0
1d4dde85c613f3c4998e5363cfe1b4ca6a4bd3da150d4a154417ceab36ac62f9,989841,2020-09-30 04:46:05 UTC,10000,0,false,10000,0
738d22bfc5a123ae4bbf95f6419a7f5ca34e39425493467ded5cd6d5ae7640d3,989841,2020-09-30 04:46:05 UTC,191795261,191793001,false,2260,0
7ec7af2c1965a35f38b04b49bac8387b40a88855df4f721a7476a57b5b5493e1,989840,2020-09-30 04:45:45 UTC,46243134,46233719,false,9415,0
8833be2d15167e5dee2e3ddb8ed472fbe2ef4f017678861aaa786566c6590cfe,989840,2020-09-30 04:45:45 UTC,44850,31090,false,13760,0
ca9fc56c6c9c456c9511ad3e19163b3d3408c4c5e051cf73f725e46c2f533c67,989840,2020-09-30 04:45:45 UTC,46335534,46326119,false,9415,0
075f051e880cfae1aaa21da7d4e60b36009afb3148728df7eae4e8b93187364d,989839,2020-09-30 04:45:14 UTC,500004601,499994601,false,10000,0
091f4dc561c3a178d9218436a62963a458677a4f40ca71bd301e581133a7b7b2,989838,2020-09-30 04:45:03 UTC,10000,0,false,10000,0
45ea3881ff5aacd2b11c4a28ea6b901162fe1980a7232cbd391de1405d474cd2,989838,2020-09-30 04:45:03 UTC,94374855500,94374839920,false,15580,0
f5bb08118399512b03792cec5ec1218bb7e9d18ea754c5c70b13052ad3cc2e85,989838,2020-09-30 04:45:03 UTC,55304410972,55304410872,false,100,989827
17e5567a12ae3f870875067f9687a47d9af503ba650ff6119aae5c36b9cb7e63,989838,2020-09-30 04:45:03 UTC,4576265101,4576162901,false,102200,0
cba5282212b391a1dca38ccf83c0469d830593017a00545051a1ed0a06423098,989837,2020-09-30 04:44:00 UTC,1331267900,1331264210,false,3690,989826
c611ae17f991e5b6eb138b18307593fb2ef71e5efafe2b06b826982215ade7ae,989837,2020-09-30 04:44:00 UTC,10000,0,false,10000,0
db69efc97b7f03cfd3553705fbddffb6caf1d68cf12f8ad75b2954d4ba2bfe9f,989837,2020-09-30 04:44:00 UTC,25199207531,25199205225,false,2306,989826
08744b7b30aecc9100892b84a0820a29e842c74951d3a0fa78f7de43ac34b597,989835,2020-09-30 04:42:36 UTC,532991449,532966754,false,24695,989824
ec8250719a3d9cfc4d1dac3e991b6d81556f870e02b5dc9b22dde49344601a25,989835,2020-09-30 04:42:36 UTC,12848644066,12848640136,false,3930,0
363195e0485108ad499869a337628500fc04d8e7c422b38ccdfd8d2116cc7958,989835,2020-09-30 04:42:36 UTC,122540880,122520145,false,20735,0
65db2c557a3d66b59882117544f3b619e6cb5bed6883a1a9ff957d6c557f9f85,989835,2020-09-30 04:42:36 UTC,10000,0,false,10000,0
d573f3e1ebcada29db83cf2be5d5d0205c3ce80a1812adb84305d1bc3fb8c848,989835,2020-09-30 04:42:36 UTC,1508735085,1508673276,false,61809,989824
aeb4c84450d4d0d8ab5dcd93f3f7750b32319e20da1e4f0c72912c32fb6864e9,989835,2020-09-30 04:42:36 UTC,499990005,499980005,false,10000,0
aa8e6a49ae089db2625911616d36fac6e22ea96d8ef3ebcf60a87533d301180a,989835,2020-09-30 04:42:36 UTC,15499509,15494435,false,5074,989824
bed47301ca632d3dfd69172c0558b022671efa7b1183ad0db836ae7c0573e52b,989835,2020-09-30 04:42:36 UTC,46369756,46360341,false,9415,0
28cc1914d0cd22983d0f0ed16d842895f16a26a8105b6b56ee36d662335298ba,989835,2020-09-30 04:42:36 UTC,46403740,46394325,false,9415,0
3475daf4c59c450006f856324b9acd117568fb71682ac569b321163cb21d2ffe,989834,2020-09-30 04:39:28 UTC,46507624,46498209,false,9415,0
d982c6575e7526ac41058aae7bb38de85e7e980c2067cff5b9d3312bf1aa6312,989834,2020-09-30 04:39:28 UTC,2999900000,2999895246,false,4754,989822
1e7b2adca3da4cf04be93a6307e2c8fbdf4748ad22efca8bf34d43df6bd3e52a,989833,2020-09-30 04:39:13 UTC,145152874,145149607,false,3267,0
285cbc9f465577c95d8d014d87f30123b5d489556447b8d1f11763a62aa80a3f,989832,2020-09-30 04:38:43 UTC,10000,0,false,10000,0
2c7abc2ee3a120a143c5f0a77b73efe133a4e48ad83a31f00707f95b2383f29a,989831,2020-09-30 04:38:26 UTC,104195261,104191607,false,3654,0
8aabc655b653af200595098f9999d4c9d9e801a706f6d4f93ae3d1b5d42198d3,989831,2020-09-30 04:38:26 UTC,113910508489,113910506139,false,2350,0
aaa374d06dd9c84642706598506d28094cbed7a0f6d1676710bb1910deb1cb21,989831,2020-09-30 04:38:26 UTC,3000110000,3000100000,false,10000,0
2f41c12ae937fe3f29cc903490c5cdc33d88e40fcf0e32b1ae12fc3a178949f1,989831,2020-09-30 04:38:26 UTC,1000161435,1000151435,false,10000,0
9d0261fe16773798153cf28a05255e6e0cc84aeb0feac6803bf475e2b7ae222f,989830,2020-09-30 04:37:35 UTC,10000000,9925100,false,74900,0
cc761431a2ea554c72849b7d37b8c03886badbf466a7cb5893ad419cd78e62ae,989830,2020-09-30 04:37:35 UTC,21765200,21764054,false,1146,0
a26ec53f33f6eb083df6ccda5fc17cde06da5774f09b2a914c91694b6356a3e1,989830,2020-09-30 04:37:35 UTC,30288246,30276161,false,12085,0
6b81f8bd1011fa3319f760087740b000b1a8ed7fbd01f4c0877ccdd74e9e1361,989830,2020-09-30 04:37:35 UTC,50151319,50144263,false,7056,0
7febad778f0432263f48cb31075daaa1551db0125b1160838b10118dd70a84fd,989830,2020-09-30 04:37:35 UTC,9165360093,9164674703,false,685390,0
e5c1a6c797d8613b3c4d7b78b699c302d93d7791b44558a66c86699ba37f385e,989830,2020-09-30 04:37:35 UTC,20948913013,20948903013,false,10000,0
1469c80a89d9d497437451c798f73bedad8148106c6cd1d329540ac51bfda49c,989830,2020-09-30 04:37:35 UTC,3000153857,3000053857,false,100000,0
5f5882edabc94db388c6fdbacb7dc8c8ab4240a70441d5d273cc5583807edcc1,989830,2020-09-30 04:37:35 UTC,289598776,289523464,false,75312,0
b371a972c0b99cb7eb53c0b1492017e43907a5238ec80b6c515503a53cb15c8d,989830,2020-09-30 04:37:35 UTC,14558006203,14557999423,false,6780,0
9900abec72ddbc1b1aa6066e541fda4530d9540d10b05b7572d185cbbb73159f,989829,2020-09-30 04:35:45 UTC,10000,0,false,10000,0
a88317e0fb993e36a6b7aa56403a99bac8141b2317c4afb19026e4fbdc690d09,989829,2020-09-30 04:35:45 UTC,10061174,10053320,false,7854,0
9cf61dadd3ef2aeb7525833f9b89fc62b785934d6f182eaf744ccc77e6ad528b,989829,2020-09-30 04:35:45 UTC,500039779,500029779,false,10000,0
0693f3a3c76cdd3c0e165484436149376b7ea1487fa94ebf23353994110dc0e5,989828,2020-09-30 04:33:54 UTC,46615222,46605808,false,9414,0
8e74aa384bc2b8bc6e9ddb45e2f9db67117af4440075850752c7b1f341cff30a,989828,2020-09-30 04:33:54 UTC,1018921,1016615,false,2306,989817
1c5c20c86fb7e7d6fa7ece40c6bc6be3304c14de323d796fd57ac16896eb16fd,989827,2020-09-30 04:32:56 UTC,10000,0,false,10000,0
62061aa4e15724b94d9aaf6c2e3349c3993b09e5e047eb65b2fab7801e533713,989826,2020-09-30 04:32:00 UTC,1510228311,1510154383,false,73928,989815
e6b3f492ddf6553f80d169271dedceb7bee205152c875e2b8c455f8160d1a703,989826,2020-09-30 04:32:00 UTC,10000,0,false,10000,0
5bb55e89e601204f9341faa8184a9b1a60a0b2a8a6693478f65d443577f675c7,989826,2020-09-30 04:32:00 UTC,171500000000,171499500000,false,500000,0
a12e16c3394b01f4b241fa6646602133999af17730cddb577b55037c66599da3,989826,2020-09-30 04:32:00 UTC,191596386,191593426,false,2960,0
33db19240a64747546f1fa4b47e545b6dd4db88957d65a533be9bc894b59467f,989826,2020-09-30 04:32:00 UTC,533511991,533489859,false,22132,989815
2e92fca4bb82d2370eaae5c8e7ea9209d1111e9666eecc7311d1150b5b5bf405,989826,2020-09-30 04:32:00 UTC,6298807,6288807,false,10000,0
3b3cace22d80eb41915c2d9e1274b4ac9faddd89b6e7ffea4b23ccf613d1c2db,989825,2020-09-30 04:29:28 UTC,10000,0,false,10000,0
8d4431cce09bbd541a98b0d2f177222b502c0ba97e4224e35c50821520f3b0a3,989825,2020-09-30 04:29:28 UTC,46828772,46819358,false,9414,0
ab638fa897b37214c8e376711bbeb187395e7b648ae9ed029bf9db096567c166,989825,2020-09-30 04:29:28 UTC,126033727,126031277,false,2450,0
406a275ae21e48593a903c989fd2c94b27f1436eb9e1839a441c6e6cbd217aff,989822,2020-09-30 04:27:59 UTC,10456456,10442434,false,14022,0
0ca68d1030bea953b6afbc0b9d1144f334dd7f411d1b1e6a0f8b5cc3c411a8a9,989821,2020-09-30 04:27:26 UTC,141470575,141465165,false,5410,0
3ce8eab847164b5b077e8f1f91f52df97a8b717cbc91c344576804017af551f0,989821,2020-09-30 04:27:26 UTC,10000,0,false,10000,0
3918cc2269525233b0b5d7f2ca333a9e8e6d6fd66591057bca9fef8deafc1fd2,989821,2020-09-30 04:27:26 UTC,504469998,504459998,false,10000,0
0284913dee0a85281e03d938d3c99e56ce8d88a3b8b22a42857d9bfef5646c82,989820,2020-09-30 04:26:38 UTC,309584,285584,false,24000,0
e1544f1c7f419f5baf22fe90f363b76b6475af66aae646b7c61b415ce0f5fb80,989819,2020-09-30 04:25:38 UTC,500049779,500039779,false,10000,0
85f00cda7166d2d049baba8d8fe4faddd6f1dff063a4b330c5a3a5d964162d3e,989819,2020-09-30 04:25:38 UTC,8518659918,8518654326,false,5592,0
592d5ca9b915d0f7eb910bff5e9980dab16f23bc159b302e92b904dc68921af2,989819,2020-09-30 04:25:38 UTC,500000000,499990000,false,10000,0
921937e312fbf2fb7ef3f0ea7a5ebefc43ab56b9c70f259170f7d537ef6ebf37,989819,2020-09-30 04:25:38 UTC,10000,0,false,10000,0
50c0c1d62c0c1c93d565dca1292ec2f08cecd96ca6709f69caf4c1853bf92489,989818,2020-09-30 04:24:19 UTC,3000452,2995360,false,5092,989806
7fd9e99f6450ce16109299b622ec6dbbe78fa03f04c4588442b8495f933369d3,989818,2020-09-30 04:24:19 UTC,138538963,138536003,false,2960,0
da4a52d6ca5a5c4ae1061e94e0fd30b0ccc63dcfc2b949c261a60a56eef5aefb,989817,2020-09-30 04:24:04 UTC,10000,0,false,10000,0
f47255d7125967b66528b13d6b50b3ae9a0d9f1b6bbe2c84169cf5545bf7ff8c,989816,2020-09-30 04:21:59 UTC,10000,0,false,10000,0
c91513416254c77c40ddad6413403a01fc637649170f08367d57605480254f4a,989816,2020-09-30 04:21:59 UTC,145396471,145393511,false,2960,0
99b2f819ddc9459c0fde230e1e7a8fc925232dd5c5ab248ea12847fee30bd283,989816,2020-09-30 04:21:59 UTC,5000000000,4999997464,false,2536,0
9c42dd161969ae122c0c4161c75e95154f78bc329c337a2753f59464303d37cb,989816,2020-09-30 04:21:59 UTC,500059779,500049779,false,10000,0
de2ba0e2ef7fdcb33e538b28f939e0a41561e37531eaf4375ab002969b500a63,989816,2020-09-30 04:21:59 UTC,28170617257,28168524289,false,2092968,0
0f480bb217e3993ed76cc111f9c9e03ea6cbc6c6be476ca4a4fee3dd1b44f9b8,989816,2020-09-30 04:21:59 UTC,10000,0,false,10000,0
54357c799cdd5827b82d2b69a4a13e37c2aa17e715450e5af9bf5fa497a6757f,989816,2020-09-30 04:21:59 UTC,16594,14144,false,2450,0
90fb7e12f0323370c7aa930777647ce975246e7ebbbad00e293cabac3d0390b9,989816,2020-09-30 04:21:59 UTC,20914958547,20914948547,false,10000,0
f44609818effedbed7e2b3602dcca12851cca176724cb809f22f6e4962ec83cd,989816,2020-09-30 04:21:59 UTC,534008913,533985181,false,23732,989805
168394d8fde2bef47ee57b1314852921ab6ac47b1be0b8af604a0e4e1dd1a0e2,989816,2020-09-30 04:21:59 UTC,982224137,982148825,false,75312,0
1ea6e2e256af9e48b57f4ea523526f5a9e615bc8b6d5e03f90736738a75b92a0,989816,2020-09-30 04:21:59 UTC,392130493782,392130491476,false,2306,989804
563ece6c375ae18dee744f01e171c162565957a2bfe9c4f78210bb2bc87ea128,989816,2020-09-30 04:21:59 UTC,1511405475,1511336979,false,68496,989805
277a5014c77ee3ddc68ca7f92d3c4e955032f66633b393f54d65627094bb4491,989816,2020-09-30 04:21:59 UTC,76789915949,76789913599,false,2350,0
d7f505e0cabf7d4423d0b1936367cdbd72ef5c8a9cd1809ad9173ac8796e458c,989815,2020-09-30 04:17:51 UTC,418486023,418483573,false,2450,0
d971861727fde86631a89a1335e6e5192d09acf73acc9bb272bcb642b2000e3a,989815,2020-09-30 04:17:51 UTC,10000,0,false,10000,0
daaf79ed99e0e93ef6c95eecd8b03f999d542479963afebc5735dfbff2d1a750,989815,2020-09-30 04:17:51 UTC,9070334148,9070328148,false,6000,0
b585ca6379471d708efc4e0b7e68da620fb176aabad58448d451e6ac568d73c4,989815,2020-09-30 04:17:51 UTC,21191228873,21191218873,false,10000,0
4653b5f587d7c0e279e1931d2435172b4a2b30ef7c40242b290f3f0317054dde,989815,2020-09-30 04:17:51 UTC,263290689,263245929,false,44760,989814
8c7f442433b567418e2b4381991e9c91e401852d06ed7003bcca088e1465fe90,989815,2020-09-30 04:17:51 UTC,126833352,126823352,false,10000,0
2d9fbb814d13e11e373e7acf3e1448e65b4e1ec776556abbdde1659117e25e37,989815,2020-09-30 04:17:51 UTC,3239008,3229594,false,9414,0
9928e372d9b19cb8b7a27382e759aa62a86259e5f239418bb5fe9e987cfa704d,989815,2020-09-30 04:17:51 UTC,10000,0,false,10000,0
fdefd6a63e981cb7add3b24a7c91bf8b340df26c2107af296d330b97ff5692c4,989815,2020-09-30 04:17:51 UTC,500000000,499990000,false,10000,0
306f4d79bcb03d2ac4f52a572306e47e092a669fb5c598e1ab525d44cbf4e8ab,989815,2020-09-30 04:17:51 UTC,845202537,845198797,false,3740,0
f5c245a7a08e19f37b27c8025f7461bce61b27f63527c23f7f67c836594d808d,989815,2020-09-30 04:17:51 UTC,26028663357,26028660731,false,2626,989804
9435fe1ba33805be9694d2d82c623d8fe33beefd86e1ec5ba553ef0d68d132d1,989815,2020-09-30 04:17:51 UTC,10000,0,false,10000,0
0ec2f3499ff2c1496978ad1faf386539975b7857f91ff41249e071aec2a060c4,989815,2020-09-30 04:17:51 UTC,58791901,58789451,false,2450,0
b9f2b2930cf2e6a23afd37cc1b3ef7ed1a41273d41c42e64ffebb025c788a5ca,989815,2020-09-30 04:17:51 UTC,191861198,191858238,false,2960,0
428e553dc9ebd318b96df637c594ecc01b38a2355c820a58a36a6415fdc19efb,989814,2020-09-30 04:13:01 UTC,1484072052,1484066832,false,5220,0
8091d89804155b1a8d765f4a2a0779b10315ac8515aeb5b83ac07b093746e126,989813,2020-09-30 04:12:30 UTC,217686985,217680985,false,6000,0
8b7cc358c129dd9de124fc7744581491877a9d79152ee003d128d44690aebdc7,989813,2020-09-30 04:12:30 UTC,181017600,180981636,false,35964,0
cc978aef440c4e6ff558c2f14c65247a2b8906ac5ed3aecddb919dc8301139b9,989813,2020-09-30 04:12:30 UTC,10000,0,false,10000,0
0a0964e5a45f082c181249f08751542a9ddf8e4bb3a095a9fb8a780eec6f83bc,989813,2020-09-30 04:12:30 UTC,2500056870,2500046870,false,10000,0
4c86880aca8d736368bdfb2422f1e96071c453b088d7c2f28a8023a3a690304d,989813,2020-09-30 04:12:30 UTC,138874518,138871558,false,2960,0
ab244d6cd9e800b02581019eab9715d090cdbcf04478118416ab3021a871eee6,989813,2020-09-30 04:12:30 UTC,46857553,46848139,false,9414,0
72dbac830b084540e1ba7a7ca0cfbdb8b621e18751ded43489d7378a717a0ac4,989813,2020-09-30 04:12:30 UTC,1512542965,1512480824,false,62141,989802
25baf8226ada2af4de84cfed26cd102341d125124fb8d02d5deaae055bb7fe24,989813,2020-09-30 04:12:30 UTC,2500653432,2500000000,false,653432,989793
8e2df8771971e4e9495f0ffebeb587fe8b2c589ceb4d5b9eaff9df56f265fab6,989813,2020-09-30 04:12:30 UTC,10000,0,false,10000,0
cff2e6cd4cfdbed08e1b03e2bd226a7f2b4809ebd7c6479fc47d4b4b17fbe82a,989813,2020-09-30 04:12:30 UTC,265196105,265176105,false,20000,0
45c3e28f1283db9ab1128716e25410f7fe4b4581e9e8abbf9ea31fc895183cff,989813,2020-09-30 04:12:30 UTC,100000000,99997550,false,2450,0
08ab2f505b349ce4f1afcc0c30738f5ee9fd4c12b2c0387054f6316bee9b068d,989813,2020-09-30 04:12:30 UTC,10000,0,false,10000,0
9902b83a71bb499b9457af74756f9e2eddfe20db2a4ad01bc165875d35b79670,989813,2020-09-30 04:12:30 UTC,21191238873,21191228873,false,10000,0
eac781707903ade0e4d93148e233bef2f65a616d6dc22bdf3f522727fbdeb63d,989813,2020-09-30 04:12:30 UTC,8469100000,8469087625,false,12375,0
8e9f0dbb5e3b4ec16f929b8575a9b2f88cc7182ec61af7579086b3eaedeb27ae,989813,2020-09-30 04:12:30 UTC,534490917,534469425,false,21492,989768
bce1e25b754482134162908c8ce771541b41c2b65f3c39fd78c4cbfb34a7835f,989813,2020-09-30 04:12:30 UTC,10000,0,false,10000,0
581fb9469e0a8713d37c6c7697a694001df18e59caecf25a6f3565b316ad1777,989813,2020-09-30 04:12:30 UTC,1015930,1010856,false,5074,989802
e922f3b733e69698ff2d60346004f71b82c1754162be8cb6602d9adb793bedcd,989812,2020-09-30 04:06:22 UTC,46913385,46903971,false,9414,0
d16e74b38db475e6c0b07a3708e284aaa45808c34ccdf85e605fc30a1239f7f8,989811,2020-09-30 04:06:03 UTC,10000,0,false,10000,0
bf75fc93da805950990d28cfd0807bb56c7e96619d02e8877acb5c755fa2a174,989811,2020-09-30 04:06:03 UTC,44187360396,44187057396,false,303000,0
252c03a4ee96d61055f94522bd888414111164abde7e7533d645113d92d59ce2,989810,2020-09-30 04:05:58 UTC,499989412,499979412,false,10000,0
b5637d6a25a9137483437b0d1d671cb3ead52d72ad1dfb6f32030bd154986274,989810,2020-09-30 04:05:58 UTC,2000046271,2000036271,false,10000,0
cf623cb65e3ca14ccc1375add47e65add1a941fa65ca8eb5561a2a94a4496f44,989810,2020-09-30 04:05:58 UTC,159482700,159480250,false,2450,0
9f5822b4a75558cca893d81096c0a9bd005eb4f2a2b07fe66456f31f23715ad8,989810,2020-09-30 04:05:58 UTC,247158645544,247158635544,false,10000,0
a3e1a280090aebe69e928a71d930d7ecd2d71b3df87240ddbb8371719268e024,989810,2020-09-30 04:05:58 UTC,500000000,499990000,false,10000,0
087fe2956bfe58fea952e8b45e56382f8c78cc7c594e2119531b6d8545fedc30,989810,2020-09-30 04:05:58 UTC,1500042368,1500032368,false,10000,0
2e44009a14a758b2157d940a35929289a157b40e6bbcd447a0fb6a7bc36ef0f1,989810,2020-09-30 04:05:58 UTC,143771,113519,false,30252,0
18dc1af1d18f4a40affade01d6c38df1389d925f3c87e7c290cb55f9490fcecf,989808,2020-09-30 04:03:54 UTC,10000,0,false,10000,0
8bb6b832f7c39a7cb9c559e61dd56c8dcb920e463a4390c28cb852cb8d260239,989807,2020-09-30 04:03:43 UTC,55486518621,55486518521,false,100,989707
21eacd71d37cd0a62e8e13ce0370a906b3642e84bc9f15447dac3bd13b751455,989807,2020-09-30 04:03:43 UTC,145593027,145590067,false,2960,0
65bda6720d55031048c5c2385b6acaf807fbf2e93613e2452be6f1ca1b31426b,989806,2020-09-30 04:01:46 UTC,10000,0,false,10000,0
8b6616bcc82a9c846cd646463fb8cbf47d0effe430dd2365504e6bb29f961866,989805,2020-09-30 04:01:38 UTC,142506847,142431519,false,75328,0
5fe19a8e041dfd37ab8f2f9fc2710b52ee3338adc66825e256bf4955cf65753c,989805,2020-09-30 04:01:38 UTC,62604323,62599239,false,5084,989794
a348e7ad7717b50ee9ef169452724e9fb404a0a34b864eea38d71aab7c65a73a,989805,2020-09-30 04:01:38 UTC,98424,88424,false,10000,0
6b0e54d072eb0f9c9fec350569ec173ad76cce11ab55ea1463f0505e814f2f2e,989805,2020-09-30 04:01:38 UTC,117886205,117883899,false,2306,989794
5c686a3204da87900101acd02588e163fb5d3ffb4903d24aa4525a2d30630f0c,989805,2020-09-30 04:01:38 UTC,203743285,203739698,false,3587,989794
be455c6c31820484058dc47626c93d993c5ff1ae27fe4e34dc5076653d60ae0d,989804,2020-09-30 04:00:30 UTC,535241877,535213677,false,28200,989793
67094b2aff398b03ad52d0c4c8f06540ab100ab6d1dd551c484acfcb5ef6b948,989804,2020-09-30 04:00:30 UTC,391850925,391849005,false,1920,0
832a0735f8f22aa1cd265ad48fdeba8562717b5c14cc2ee3ae4ad6b7dd27a87a,989804,2020-09-30 04:00:30 UTC,10000,0,false,10000,0
5947aaa4695e7de0b21947d69bf4dc44b8300a01ff4327c1c01f5b948f15c22c,989804,2020-09-30 04:00:30 UTC,405216964,405213057,false,3907,989793
64bf7ed31525da207d0d1267418c25a94eb8f933eb6ea774de2c7aa26666e273,989804,2020-09-30 04:00:30 UTC,77115893082,77115890732,false,2350,0
5729376068981f672f354733f78d94120c08a1e05e6da75b6d7bb293dadd0af7,989804,2020-09-30 04:00:30 UTC,684417648,684366447,false,51201,0
7c1aef2223ae7e4bb84fe73edc2a6e803af915aa18e1e00b0824b87a72ce07dd,989804,2020-09-30 04:00:30 UTC,499999412,499989412,false,10000,0
ce1468b570326251766f027472f9b2f32f0950f83104477c8d8de34d386a0b88,989804,2020-09-30 04:00:30 UTC,1513747978,1513682989,false,64989,989793
1592b6ae135651779c5ef3d64ea3d1934efef2096cc1d49a4e96fa97add4f82a,989802,2020-09-30 03:58:27 UTC,500009412,499999412,false,10000,0
43d8c58bafeb14fbe8ba2dbfdfec732658d64faaae0baab1cc2b7b418c2e8761,989802,2020-09-30 03:58:27 UTC,47376035,47366619,false,9416,0
df7f8e21c4098eb30f92a29c7f9fa0cbd7e754871dca947294943d926a7c5c27,989802,2020-09-30 03:58:27 UTC,1001026,994246,false,6780,0
503f53a92951db3dc1e214bf073e3bbc236e8e93eaf135129062dba352fe219c,989802,2020-09-30 03:58:27 UTC,47347939,47338523,false,9416,0
fb947b3d76269585e1c2c50a0bbca8c0ce3ace5b5e73505d13a169b4d9caa8bc,989802,2020-09-30 03:58:27 UTC,10000,0,false,10000,0
325b16bc7ffa614cb0f80042ddec3109f1398b7e2c38df5a06ce6d0d1bcaf65d,989802,2020-09-30 03:58:27 UTC,19792148292,19791945292,false,203000,0
296237f4b93031fd783980767b32b773d36002ee313a7324e87c96ecabe0d06e,989802,2020-09-30 03:58:27 UTC,192127653,192124693,false,2960,0
71f72f0b02099228c866b965b96beb96bc56a522a76151cc13c7f7995d78f1e2,989802,2020-09-30 03:58:27 UTC,10000,0,false,10000,0
03cd37dfe74b19361d520a270e48c146eaadf4b2cea38eede39aa7cce55b144e,989802,2020-09-30 03:58:27 UTC,10000,0,false,10000,0
9e303f427e214decf83d2152e099e5b4d2dd08e00917c0b684f3dc7a6369c9c7,989802,2020-09-30 03:58:27 UTC,25874,16449,false,9425,0
09b64cae5a7daf7c5f8c4a173cfb9f4ddae16578599cf859618e2ed116eaa37c,989800,2020-09-30 03:54:00 UTC,139085848,139082888,false,2960,0
1a6b04b71296b70cf86ffe9eff428d59502aa278d679f121d89713f78d53bd8c,989800,2020-09-30 03:54:00 UTC,10000,0,false,10000,0
332f7293c22a7c77ac8bce71839b574c5c69f8fbf978b9cb44a587492b78c819,989800,2020-09-30 03:54:00 UTC,10000,0,false,10000,0
b800b565cf1715d8a4a58d7051e6139b3b41d1a36ec22cc641fcf2d92896dac4,989798,2020-09-30 03:51:41 UTC,20434733,20428733,false,6000,0
1efe9c1156bcf6dc36a3247d932882ac446d542b96fa85c9087e484bfb2e8f1e,989798,2020-09-30 03:51:41 UTC,55590103526,55590103426,false,100,989787
24b55af656af05ce65921977d2b4dc248108e9c27ebad6b64509cc426185c885,989798,2020-09-30 03:51:41 UTC,10000,0,false,10000,0
59fa86be43dd770bc57bb58eba98b02f31e608187025b69c36722662fdcdc35b,989798,2020-09-30 03:51:41 UTC,30633239,30629499,false,3740,0
b622e078c1e3737046f888038a3a224b3920313819a4c9f948e085e31c694fb4,989798,2020-09-30 03:51:41 UTC,15529968,15524875,false,5093,989786
d9008e776290828feb34795e0bef135f7a143d43eafdd61408234f6fb8e1fdea,989798,2020-09-30 03:51:41 UTC,47445526,47436110,false,9416,0
f2a784184200715d2d2d7cf77e89beeab3381e88082990f149332359abf9a0b8,989797,2020-09-30 03:50:14 UTC,1514873603,1514808970,false,64633,989736
e5f12e39e3655181210a9e2b5c952bd034a8be6f312c8da80a0367aefb108123,989797,2020-09-30 03:50:14 UTC,535763420,535743216,false,20204,989786
53d15f0749ebc3738283c02cfbe49e7e23e97f04fbb81bdb0257c3fe0733a75f,989797,2020-09-30 03:50:14 UTC,500000000,499990000,false,10000,0
e13862a8bfd2d17980da40e76645c54860553efaec97b0a99f0bd310f602330a,989797,2020-09-30 03:50:14 UTC,237632782,237630332,false,2450,0
8888cc57a55dafae7358975a5319787cf5e76b0e2273bcc736421eb67a6898f5,989796,2020-09-30 03:49:05 UTC,119230756,119220756,false,10000,0
63bc4ba493f849915544d7cc631b05de89af234e888b32dea3d3abeca7508fec,989796,2020-09-30 03:49:05 UTC,10000,0,false,10000,0
dbb1ebd41341522294ac55217a1ee50b07d30b96ba34f4bda9566d0519c1b5aa,989796,2020-09-30 03:49:05 UTC,47474820,47465404,false,9416,0
6110c4ff9ede897de3f7b790965157acc3a983e6e1df1225ff2be00a02880075,989796,2020-09-30 03:49:05 UTC,9905992,9903694,false,2298,989785
be7df376c4df869338ccb0bdfe2e63571e47f2da953a448347a65abe79f4755d,989796,2020-09-30 03:49:05 UTC,145787527,145784567,false,2960,0
670b3006ea2e5b0391b192d53900eec32751492ae3b13198a1213dbf9a6f4f40,989796,2020-09-30 03:49:05 UTC,500010000,500000000,false,10000,0
c90ef93cfff180493c27b27ec20084198230edfd0cf06ba3686641e75caa7b2f,989796,2020-09-30 03:49:05 UTC,10000,0,false,10000,0
7b120574d1d49ed744caec4710bdca1f8851a09871510eacc839ec38e6a6f49b,989793,2020-09-30 03:45:08 UTC,10000,0,false,10000,0
bf7a8edf0e6ba17e8f98279aef13286412a5545bd05bdee18203fc46eeebed7d,989793,2020-09-30 03:45:08 UTC,192399408,192396448,false,2960,0
a39b173c52cc634b5f7f08c56bd9a7d037202cd6e7dac35056985898bca76d2f,989793,2020-09-30 03:45:08 UTC,5100000000,5099997464,false,2536,0
3da5d3fa2184beeb8e6c697ca72516ccbee1ef125693fb79918e8150775a1641,989792,2020-09-30 03:44:22 UTC,39970025,39964025,false,6000,0
a189935ccd86586d7eeaea3c9de1006c1671b17907987d1649cc391ab81edc1b,989791,2020-09-30 03:43:53 UTC,842649457,842574137,false,75320,0
2c93694ef7856f6b5752af8523db6bce7fe83633e6c07fb3c5e56e264b3e3b8b,989791,2020-09-30 03:43:53 UTC,5139976025,5139970025,false,6000,0
bf26dc97aae959aee836e0f8d1d9bf276f21c068e1673a6a093f89eef84470d3,989789,2020-09-30 03:43:03 UTC,20557538860,20557528860,false,10000,0
8168c192b3f4c60eeabc10c39c832db9f1ae40d3e367a501f9b8377fc0e1c0bc,989789,2020-09-30 03:43:03 UTC,427906996380,427906993782,false,2598,989778
fd0ef969c788928505ca8ebc3f94c19cd24f4237eecacb97e121d50a9fb7ba14,989789,2020-09-30 03:43:03 UTC,10000,0,false,10000,0
adad3a72538d7d05062b6d74aada100a6a9d5e105a87bd4d83466df92a30f6c8,989789,2020-09-30 03:43:03 UTC,4800010000,4800000000,false,10000,0
1dd05f414cee190594eedd6efdc3751a54b265ff0c355bfd3c552bedf7b1d58e,989787,2020-09-30 03:40:39 UTC,499992280,499982280,false,10000,0
3d5efc5c8094b9a72521d3a2371f0c3a8884ffe9ce18848c3899c9a06f7d775c,989787,2020-09-30 03:40:39 UTC,10000,0,false,10000,0
4b5c491e0aa9575f074810b7a2501e4975f0a4817c5a6982634bc1401235c6cf,989787,2020-09-30 03:40:39 UTC,499260000,499250000,false,10000,0
10f95795b1ea4a552d6ed01e71dacbee41df362f469cee28acd686f4defb60b3,989787,2020-09-30 03:40:39 UTC,1516225366,1516159753,false,65613,989775
6ec77011f249fec5f62391db87de60e0bbca51e665cc952ce91d4db7dc99e9ff,989787,2020-09-30 03:40:39 UTC,536452686,536428029,false,24657,989775
6ce802b9aca740a2104340767ad9c59589018ec3276a9f28fb128b56b504da45,989786,2020-09-30 03:39:59 UTC,500029501,500017416,false,12085,0
f719213f5504a772bd83057b7cfdc483affaddce179d3e7579cac4dbc1572c2d,989784,2020-09-30 03:38:50 UTC,38419393,38412613,false,6780,0
75a64ac73f6516702303feef28f60a02d8c517c9564402c8ee25b0c3a2509a18,989784,2020-09-30 03:38:50 UTC,500016647,500006647,false,10000,0
e67f1faa99ab708664f182c346143c7d111370aa7b2c68135c59fecdcaae1c2d,989784,2020-09-30 03:38:50 UTC,10000,0,false,10000,0
ff66bb263c3543607add614feaf462e1807675a4b6d594cf8c3da97b06098cba,989783,2020-09-30 03:37:21 UTC,1726631000,1726531000,false,100000,989772
f21eacea42fa294ff843bac9f7388ce415411feeff281fb2e9d58d9f07ecea5a,989783,2020-09-30 03:37:21 UTC,201850292,201847666,false,2626,989772
4a60910145742cddc2c6dac73c64fc4219e3a40f0954125bb8f55aef95433f3e,989783,2020-09-30 03:37:21 UTC,65672280,65662280,false,10000,0
969c18c0eef0798ba671d8b6165adaf603649501393b777f8cb2ab557422a93a,989783,2020-09-30 03:37:21 UTC,10000,0,false,10000,0
1939276da229f89827b9f24ad9397917d23dc48722576d692e11dbcb3bcc9b3a,989781,2020-09-30 03:35:35 UTC,10000,0,false,10000,0
0ab549b8bca2ca69b1fc5eb4db36c44e9a8040df27cc6591424861051fce9d3a,989781,2020-09-30 03:35:35 UTC,10000,0,false,10000,0
df2a04465f92a1a29783dc7da35d1b5b87f1eb8d9a420d2fa5552fcb24c0a13f,989781,2020-09-30 03:35:35 UTC,20150433739,20149790249,false,643490,0
9df2dd95314b70feb0cac15be73b0efdd1c1066ab5f8362c34da9d0c9e1cc302,989781,2020-09-30 03:35:35 UTC,139594237,139589134,false,5103,0
a046b44e563aee16e4460b4610badd4483d53220b27befb4ba87c05096146b23,989781,2020-09-30 03:35:35 UTC,4000000,3990800,false,9200,0
63416e48667778c1cdbf9e910e681b7df647d05e422dfae1f4e3605c629d4e0e,989780,2020-09-30 03:32:44 UTC,5023831,5018757,false,5074,989768
c33072e06e770760b1ac846f5ed1423cd25eda444626713b9b566e8cd367f815,989780,2020-09-30 03:32:44 UTC,10000,0,false,10000,0
551990ed14f85313484ed46f0ba9f9673294d32b43b957b1a7d5153d4f18cf1e,989779,2020-09-30 03:31:23 UTC,55336607,55334301,false,2306,989768
a6d8205418e94492ce97de9af8358d08ca45bdcb7f6eade106c7926707210921,989779,2020-09-30 03:31:23 UTC,108090487,107955037,false,135450,0
be6a70aa60b6c8784ac3aa14ff93d8b179741441cc10f2f75238e566fca1c863,989779,2020-09-30 03:31:23 UTC,1517380102,1517318582,false,61520,989768
730fb911f8ac6c108ce3dbd2f3955ab0f25bd9b7e719795dc8c1d2c1f9f7a461,989779,2020-09-30 03:31:23 UTC,3450376123,3450370123,false,6000,0
53cc231d0359ffb84aa8ccda3a591d5075c51354eb342da1d15bae88424954bb,989779,2020-09-30 03:31:23 UTC,26292765663,26292763357,false,2306,989768
2d4291ca4d5249a418e96192e8edd96d12bf18f1a0e429285bfe7c7bf0f69aab,989779,2020-09-30 03:31:23 UTC,536966737,536946855,false,19882,989768
92b9d1502f316fd7510598a9c9968d7b51902c92bf85a4602a6d3b0b3313c607,989779,2020-09-30 03:31:23 UTC,500000000,499990000,false,10000,0
f0ec0b266257b25856cd3f8c13654ca7ed15c257d8154e1d8e0ebe07636b84e8,989779,2020-09-30 03:31:23 UTC,101979469,101975729,false,3740,0
1a9d067243e3d50c5969f05e0a5ddce5ec2ae70a07ed122d9e7fbdd9a683341b,989779,2020-09-30 03:31:23 UTC,3520382123,3520376123,false,6000,0
b40f54518f4def0d340755ded7ddf8611047b693f1dc9c8bcfc74775441e3f16,989778,2020-09-30 03:29:16 UTC,47555846,47546432,false,9414,0
59f9508b6dc82d556f100b42d90d9eae2cfecdbd9b1546a19f6cf3b17e19be76,989778,2020-09-30 03:29:16 UTC,145904697,145902042,false,2655,0
1f0de8569c98e2a46b2cae95f76f2690397d96c0d3ae019d9329b3e3e5b109e0,989778,2020-09-30 03:29:16 UTC,172763,134611,false,38152,0
60967857aa9f1ce98d1cfd9b070e320a6efc83bb2c24b8c04be97f9b1f1c7955,989778,2020-09-30 03:29:16 UTC,10000,0,false,10000,0
4558ea67195aa596e47ddaae0948d550e782c78a62d252f3a4972b70778af707,989778,2020-09-30 03:29:16 UTC,1023842,1021392,false,2450,0
be36a00f92497fd8c1e1d0703f210dcb1d5d81b8137bf26411f440232b483095,989777,2020-09-30 03:26:55 UTC,10000,0,false,10000,0
543306ad49f9bc216a1ffc0f1783a2c4f0f8fbee8c162aa55801e8694199aaac,989776,2020-09-30 03:26:20 UTC,703050541,702975229,false,75312,0
2a999371b398761c2b7a1ab80fd727903a55ef32b4459da9f2769c69259480c7,989776,2020-09-30 03:26:20 UTC,500002280,499992280,false,10000,0
71028b5ef4da56ea44111527119eee1766a910204fb895ff3ef6ade4004cdd86,989774,2020-09-30 03:25:04 UTC,499990496,499980496,false,10000,0
3c52e5a6e3ccdf2bafe88e4057ca9efe985ed381db5b5a639a0fe43b9849a436,989774,2020-09-30 03:25:04 UTC,26317267960,26317265663,false,2297,989763
7e345a8f717d735b2b96317c275d3c85f4b173f1918005c76bf22bd7bfc59cb5,989774,2020-09-30 03:25:04 UTC,10000,0,false,10000,0
75499ac7998dcb7cc3e9776b4e1b1597185ef2751af8aed6be0e79878dc2a84a,989774,2020-09-30 03:25:04 UTC,47721810,47712396,false,9414,0
116625bbd90d1201dbb9db9fb1f9b275d1b1d1a2398bfe5bb457497bd29e6716,989774,2020-09-30 03:25:04 UTC,500012280,500002280,false,10000,0
8b1ebcd2f62cf8adb049f68734f11f624b4f757be94968d7e63847529c4a5be5,989774,2020-09-30 03:25:04 UTC,10000,0,false,10000,0
9cf38eeead22504c10caba1a2b498ea22506a0c1535ea29e750667f29d7a7f94,989774,2020-09-30 03:25:04 UTC,427954766686,427954764380,false,2306,989763
f0ff401503b2d8bcb8dcdc596623e492bc89c3bdc2e30f985250d51d4f47b2c9,989772,2020-09-30 03:21:29 UTC,11845420,11840346,false,5074,989761
bf0ad3658f60be0afd45e5514c9d8d610c4322d5ab4939e047bf4bf7b6f3fb8c,989772,2020-09-30 03:21:29 UTC,20385516076,20385506076,false,10000,0
ecde48233ad43739fd993072bfa6d75e73f55e19f4385e8ab2165980092a54a3,989772,2020-09-30 03:21:29 UTC,10000,0,false,10000,0
eec6d4e676116b32f1b2b9c1cd96db66be49e479a92e71f8582523d7c6dc5de7,989772,2020-09-30 03:21:29 UTC,537490451,537466069,false,24382,989761
9271b4460f194624afa9d5162b47f9dc782114524354fee3ed56f00f36ccd93c,989772,2020-09-30 03:21:29 UTC,1518613951,1518548948,false,65003,989761
a3874813cf8f78eea59b9761d22f785448848b908e444f0d9a7a091405f23f9f,989770,2020-09-30 03:19:22 UTC,21892,11892,false,10000,0
98463a176402329c64a945f4ccc72ec148a68b0cc8e1cc67179d66626fbc4725,989768,2020-09-30 03:18:42 UTC,10000,0,false,10000,0
0854bb79276548d5fd70203d663930529a283718376ed2b5284eea341cad86c1,989768,2020-09-30 03:18:42 UTC,20514996765,20514986765,false,10000,0
7f9dea72fc9a336c2032784b76163743e4e057b1c3194af1a870cd0c50b82282,989768,2020-09-30 03:18:42 UTC,384632848,384563908,false,68940,0
2055da4de664ddbe85b224aba25edd41474cd4f9228028149522a9d4b9d263d8,989767,2020-09-30 03:17:43 UTC,234564004,234561698,false,2306,989756
3fb8e144efd3d705f02570c425bb2e52588854460ca7b177da67d260202de8c6,989767,2020-09-30 03:17:43 UTC,47751160,47741746,false,9414,0
e1b551246d9ea52d48dd95afea7bcd68ae415ff11d20eafdab0f4540d628a3b8,989767,2020-09-30 03:17:43 UTC,10000,0,false,10000,0
5166ae81fffcfc60230b4500a76555341e043e77d7920c5b0f994089e671ca3a,989763,2020-09-30 03:16:10 UTC,9999470000,9999459800,false,10200,0
e1d222b2c420f4e854a42949158472ebe36b7231da5fafce5bb3609aa219cc79,989763,2020-09-30 03:16:10 UTC,14160231200,14160221000,false,10200,0
433c776056b36e16ea5363c049fdda630ef9c0a7fbe0cae1a83689ec1fa926cb,989762,2020-09-30 03:16:02 UTC,10000,0,false,10000,0
bfd12868814e5c727aa1c5d7d8dfba1bdb77b8c9850cf40eacd96136569bc72f,989762,2020-09-30 03:16:02 UTC,80006691418,80006689068,false,2350,0
71e9077c25b26c76edec2413058647977956853deae74e3eabc646cfc9d49438,989761,2020-09-30 03:15:26 UTC,102924263,102918263,false,6000,0
8beaa8a75b9a85692742143395889055e74f489df63184d37309ecf56b690f8a,989760,2020-09-30 03:14:28 UTC,10000,0,false,10000,0
af378013ab722aafdf3954be551ded34456fd26efd765251f467bd01179d6e99,989760,2020-09-30 03:14:28 UTC,3619207959,3619140689,false,67270,0
abf42d5fcdaefb36018e62f76b59effdf9f0ce9e37159c7b5dfce1f9819d52be,989760,2020-09-30 03:14:28 UTC,34548,24548,false,10000,0
9a999922dcd611f50b69b3912e25bd850a423a4455bb450839643fcb2f2f9119,989759,2020-09-30 03:12:22 UTC,10000,0,false,10000,0
5384329cb78ac7b4186cfda11df59416a88eae7a9ed7e64a355881f662c82c2a,989759,2020-09-30 03:12:22 UTC,20515006765,20514996765,false,10000,0
086a3e4cd73bb95460633228146fbd0c70ebffb5e38c780ae61b77c5b7eaf6cb,989759,2020-09-30 03:12:22 UTC,19999500000,19999497261,false,2739,0
d0398aa37434ec29c04e5b3c681afa23a59c9ef94056e67e3996da816006810d,989759,2020-09-30 03:12:22 UTC,47815602,47806188,false,9414,0
e76bb000cb87fc6dda7a9d17f7bda5127144d4157d9e6050c1d628d0e6d42fda,989759,2020-09-30 03:12:22 UTC,192561104,192558144,false,2960,0
e6e43a7dfe3b1549e48d963fd26f16c5ae99724a9cb505479e2bf8d92a59ca99,989759,2020-09-30 03:12:22 UTC,109243052,109233202,false,9850,0
ea9521b4104017f3380ab6d1800b6a330f6f951a6646e893283871d3898b73b6,989758,2020-09-30 03:11:10 UTC,351099990000,351099987740,false,2260,0
dd3330e6985e6fbea3e6926dcb93e1f9e2dcea1251146bdb79756f03d4dd20e0,989758,2020-09-30 03:11:10 UTC,21213513433,21213503433,false,10000,0
3c9df5888854589a75371890c267cfa818766d3df07902875e45a1496426ea7a,989757,2020-09-30 03:10:23 UTC,941899196,941880481,false,18715,0
6c387ba4427d2ccc93bd3a6523f906debf0fd6ce9f43d09466d725269f1996c0,989757,2020-09-30 03:10:23 UTC,538058388,538037518,false,20870,989746
0647a1ffe24187987f578bc237941fa7ba1d24f7bf0552b9f67e083d1fd75590,989757,2020-09-30 03:10:23 UTC,10000,0,false,10000,0
0102fb7c4c9fed327b29c7563cb6dc878aac04a9da2bd99e0119bf151482923c,989757,2020-09-30 03:10:23 UTC,1519829908,1519770346,false,59562,989746
ac3db7278d26dbed66a007a670a06565ad05f7bcfb40440a37ba82f29035a1d3,989755,2020-09-30 03:08:49 UTC,500000000,499990000,false,10000,0
21c0e189c80bd85a256a912e25e6cc9e513691a4725dbab762d4eed69d3cc479,989755,2020-09-30 03:08:49 UTC,1415886623,1415307107,false,579516,0
bbc8f9766b87591d4b0958519dabcc362fee3dd3d017c55b638e4158c7770f2c,989754,2020-09-30 03:08:09 UTC,1500052368,1500042368,false,10000,0
a1e900509f47cb9e1066b32deae5fe6c4c74125695de7dc643aad67389f39291,989754,2020-09-30 03:08:09 UTC,10000,0,false,10000,0
ed080873bb6330848fc1e8073e1b6760e463d9b1378ed99142c147ee22ca49b2,989754,2020-09-30 03:08:09 UTC,244641858364,244641848364,false,10000,0
96cb1488fa7e9fc2d25b7de9803b2a98a2a1efb6b4f960efe206d637aa94ec2e,989754,2020-09-30 03:08:09 UTC,4285981476,4285881476,false,100000,0
97bd517eb41047043107a29d48ea3e6a145c27e77a4bf03aa8b7797c551e4f84,989754,2020-09-30 03:08:09 UTC,9034968086,9033692183,false,1275903,0
c544e3ee42ded2f8bd5effa84d373de5dd6da4543a7c2ec6c5d5fb88aed35a29,989754,2020-09-30 03:08:09 UTC,316328676,316253364,false,75312,0
b133b1d9af0577ec145db6bc7a4c496a9a6a709685a6deeba14816e93a769394,989754,2020-09-30 03:08:09 UTC,1500184029,1500174029,false,10000,0
ea49533e20b494190f42068f5558f9db2ca5ab6fb9af2aafe5d119fbd3b39080,989754,2020-09-30 03:08:09 UTC,242686548,242682808,false,3740,0
45f24d2379c0a1e40b9f4a96b3616d51e1393ec7afbe14d41a33ba4e7fe0d5e1,989754,2020-09-30 03:08:09 UTC,4000465615,4000455615,false,10000,0
5172fce46978a1befc2ca9da5e09e1b49ad485a940b9db15364e71be531568d0,989754,2020-09-30 03:08:09 UTC,21213523433,21213513433,false,10000,0
5eddaf199746f1b869d80317ce288388545bd3bb7a199aab545cd13a627d5754,989754,2020-09-30 03:08:09 UTC,1000002430,999992430,false,10000,0
9caae2f98a3ef186d92baa1bf23c51818cad4b59ab2a803d87dce9f9f54004f7,989754,2020-09-30 03:08:09 UTC,10000,0,false,10000,0
d72849a1854961b5067e79832ebb26bd09c273b17844c5a58489098a8557a820,989754,2020-09-30 03:08:09 UTC,10000,0,false,10000,0
8bb112f61c698de7078b44fba6a25b8fcc705da85fdcc0ca098abd7633c7d540,989754,2020-09-30 03:08:09 UTC,456062949,456056949,false,6000,0
1fabc47957b3629907529810149e4b16acda89518c9858691447484614accea3,989754,2020-09-30 03:08:09 UTC,139814925,139811965,false,2960,0
4da5b990f37396586438c62952a1697df8f3d85cb35dfc98b4efc2a0d37f893f,989753,2020-09-30 03:02:23 UTC,101698528,101694839,false,3689,989742
a8dca57501b7afcda6730553f996d21a808906edb8665c7349c6782da4604e6b,989753,2020-09-30 03:02:23 UTC,5000489500,5000485604,false,3896,989742
940f3b95bab43139909c631c7d6aa0bc196f05dc231c9ad10c72c4e0cd66e1fa,989753,2020-09-30 03:02:23 UTC,91307654,91305204,false,2450,0
17379aabd9fddc3ba4df2ed4fb19ab4a954834913b6c85319e51da1792fc59ce,989753,2020-09-30 03:02:23 UTC,499980000,499970000,false,10000,0
e0074570da3b00498533c7334b8cae658f2777d5fec29033342524769423bb07,989753,2020-09-30 03:02:23 UTC,523044707861,523042707861,false,2000000,0
30f491b3aae5696d19ec9a918ada76bd716ac3dbd530c7634c33e28d7f4e6340,989753,2020-09-30 03:02:23 UTC,2589458150,2589456030,false,2120,0
82b240d82a03e60960d0155dc3b8568ddf67d8a6eb61df8a49d697aad029d629,989753,2020-09-30 03:02:23 UTC,115770186533,115770184246,false,2287,989742
bd92765365eb1b359629f856deca2ed9109970d49651a266448d0c583d1e4ac8,989753,2020-09-30 03:02:23 UTC,538492641,538469862,false,22779,989742
8e0ebdbec2228f3a0b833b3a081d40f44ec33c7cfa3644f85278990fcd61c344,989753,2020-09-30 03:02:23 UTC,10000,0,false,10000,0
334b2842ae80ed1f9c91813f1cafc5d941babcaa83bc2a004738f7d2fb0a3180,989753,2020-09-30 03:02:23 UTC,10000,0,false,10000,0
e84600fa67ea4373d1380c50d43a90fbcd73e1de45a85799f0e78c1a8d53ea11,989753,2020-09-30 03:02:23 UTC,146156192,146153232,false,2960,0
b58f3a30aa983dab539154acaefecca6127d7f88bae81c113170e853646966cd,989753,2020-09-30 03:02:23 UTC,154659584189,154659239580,false,344609,989742
486bb7bc1c641c13c18cb7e57f7f70d974499d94208716854f371dad8c9fc1fe,989753,2020-09-30 03:02:23 UTC,441187784,441184848,false,2936,989742
2056e305f4b6941706d37c78cef45e9ac8629a949b177a74faa219a482059401,989753,2020-09-30 03:02:23 UTC,262413553,262411247,false,2306,989742
e89c629966817a3cd6ecd2973a087da1425915e5d92cbd11d99c64504bf6b359,989753,2020-09-30 03:02:23 UTC,166509314009,166509310269,false,3740,0
d7021ea3dfdf812c8dbbe30d86e35705a5657576e5709673658c0191979be12d,989753,2020-09-30 03:02:23 UTC,114982594,114978854,false,3740,0
a89c7ff13fbd1cb14000bee073ea755457f2c3d62e92a53989f3bce590772588,989753,2020-09-30 03:02:23 UTC,1520842381,1520781611,false,60770,989742
bb0310039105c50de9618f9c08a47d941fd2da6e866d478d69c355dc4219deac,989753,2020-09-30 03:02:23 UTC,10000,0,false,10000,0
07e0fd32362affdb579e7071be5bb91a506d60133cd38d83b777340d441a6743,989753,2020-09-30 03:02:23 UTC,32413557,32400144,false,13413,989742
8cfc376efab9afbf0b5359a9f9769b6bcdd76739a8a3d99b4375f1bbaa44f389,989751,2020-09-30 02:58:33 UTC,257497128,257472588,false,24540,0
df6b3020f6e50da6d485099c8635260109df039270d04e994f1b1b9af13f7133,989749,2020-09-30 02:58:04 UTC,290604500,290500000,false,104500,0
02b8a3c169661ceb10fbbee896ca70a82907a38062b797856500715f49d79c02,989749,2020-09-30 02:58:04 UTC,499990000,499987694,false,2306,989738
a78d58ec034f7647d52ac030566605d8f3d1d1d3789abf68334dd17b82c16b8d,989747,2020-09-30 02:56:56 UTC,2574506,2570805,false,3701,989736
5b14013773e5c20facac48fb90dbb9fca35297534c70433d1b25019b0529e08d,989747,2020-09-30 02:56:56 UTC,10000,0,false,10000,0
42e04eadbed604dc1d20d0df9f64f51b1c631ae6c8977a9d1e8452a34f33e3da,989747,2020-09-30 02:56:56 UTC,9030394123,9030388123,false,6000,0
65866dda1645bc5c484e0b0dc88f8a927cc7b8d24a64fc92c4dbe9134867da92,989747,2020-09-30 02:56:56 UTC,6696200000,6696187625,false,12375,0
21a32f46d779479f2760835d1a1231b52a497f2a46a10893abdd3d8478924a04,989747,2020-09-30 02:56:56 UTC,135769688839,135769686533,false,2306,989736
0d635ede08684678325448c29410d2ca17543d28498791b98f8e9994406a10b7,989747,2020-09-30 02:56:56 UTC,10000,0,false,10000,0
81f88641110b45484fe26d1ed07e70bd0797ecbf40574ca7c28ef9c3b05e4645,989747,2020-09-30 02:56:56 UTC,8990388123,8990382123,false,6000,0
f82b1fd820bf6e95be8ece7582d873abc1563c07385586e1937b2f1cece44a72,989747,2020-09-30 02:56:56 UTC,135608645,135580341,false,28304,989736
0a3d78ace0f6b547d389724925e2537991093305eb2f3b684fd4837b22e50856,989747,2020-09-30 02:56:56 UTC,47862619,47853206,false,9413,0
7741b5007237f881667179b311b43e04dcfe944031296129b68b85911fd25f58,989747,2020-09-30 02:56:56 UTC,5500000000,5499997464,false,2536,0
9aad8edbfbc10c428cfb2c7891a65e6aa11c480724eed1de7e81c96b340da9a7,989747,2020-09-30 02:56:56 UTC,499990000,499980000,false,10000,0
885a52f95875723a7d56b22d818d6ae1d4e8d9117a91d9a829e702bd066c5c78,989746,2020-09-30 02:53:34 UTC,173350144,173347848,false,2296,989734
1dec69bd86b4c61476e68af5714298fba4b247cd4360140474f1505eaad46297,989746,2020-09-30 02:53:34 UTC,2518641130,2518638825,false,2305,989734
328dbb5688af9b1c6f431f18725f62aed32246f6a83d08ad57a7a686a2f37a84,989746,2020-09-30 02:53:34 UTC,2596291162,2596288857,false,2305,989734
7552072215591be870ba65687836f808f01b182eb798d539479b4ae0bce0d98c,989746,2020-09-30 02:53:34 UTC,382073981,382071676,false,2305,989734
d1ab1ea9bbd3501ca78e6c79b541bc6f207b5a78282121e00a7ff94e0c6b25c5,989746,2020-09-30 02:53:34 UTC,304167678,304165382,false,2296,989734
cbfb4d5920e719be6f93e6291af9a8e56ed763301eb663102e07cc5bacd01596,989746,2020-09-30 02:53:34 UTC,315699538,315697233,false,2305,989734
5908d1a112f177639fb2da5e8e54e67dc4783e8cd0c45fde2ca4bc0cec97e395,989746,2020-09-30 02:53:34 UTC,993467603,993465298,false,2305,989703
2a7602d9ae03705f7d4d100bcd35b85a1506586e4e6702a02e1076151a067d56,989746,2020-09-30 02:53:34 UTC,1195349545,1195347249,false,2296,989711
473a5c9311ee2109cbdca35e2e79fd508fa97ce64bb4d3069c3b50a2f6af732f,989746,2020-09-30 02:53:34 UTC,296456727,296454422,false,2305,989734
382657702dff1bb354b5dae9cb2519ca3c275208961fea2ce711e10a0657bbb5,989746,2020-09-30 02:53:34 UTC,234590611,234588306,false,2305,989700
79b4b5c9df6333c5f44cd7fe6389cfe6dcbadcc81ecec14b36166e8b202b87bf,989746,2020-09-30 02:53:34 UTC,2669477525,2669475220,false,2305,989734
5dba45160b087f97b61d70bd26dff9798b63135f830815c1ee649ce6b88ffa96,989746,2020-09-30 02:53:34 UTC,813528725,813526420,false,2305,989734
9d5e788acbfc182cd4c4a732500cc64725f9887c46c1e2ca52db0b46e4c073a7,989746,2020-09-30 02:53:34 UTC,2491179059,2491176754,false,2305,989734
81a58b265e9e9451204418ef4c9c92a97f8ca9f5b25bb6ea5bcbe5a4bb7d47f1,989746,2020-09-30 02:53:34 UTC,311841610,311839314,false,2296,989734
7b2d393a278cd8a6549cf3426a4f6d2a85a7cbb166ec96c60ce9715731cb4791,989746,2020-09-30 02:53:34 UTC,385909240,385906935,false,2305,989734
5ebfadcc3cac52d35b0f00ee3917093de00559b0d3488577db4bf6220f0a94e1,989746,2020-09-30 02:53:34 UTC,577572371,577570066,false,2305,989734
531f8e11221ebb64eb7bf564335494e271b6e3299a8135d74c84575c797c71b4,989746,2020-09-30 02:53:34 UTC,561646984,561644679,false,2305,989734
1dc334a429239061bbee4f7abd3d7f2cdf0ee4505bf67672b4f809f6c3ce1090,989746,2020-09-30 02:53:34 UTC,1227923317,1227921012,false,2305,989734
9d269c5c89b4f36b38699b1a72db51e260c67fbb670a722f9aa53b323852c5b0,989746,2020-09-30 02:53:34 UTC,10000,0,false,10000,0
4e43cf34e039b35064b3242adbbd84a58b47ba04054072f8162d26a73a0c1101,989746,2020-09-30 02:53:34 UTC,365640881,365619058,false,21823,0
12774c70a1b82156b4572f18e8319c2b5d807fd9c2d806f7cda67bda89bb66ad,989746,2020-09-30 02:53:34 UTC,2565582036,2565579731,false,2305,989734
2d595c413f9b0098722cca5aaac651ebacfa4f6a6e3ee482fd535b8ec49499bb,989746,2020-09-30 02:53:34 UTC,2774847135,2774844830,false,2305,989734
7e0a749f6458c6652fe5218b1af36473149c2e51db5d097c48fa11079cbc2ca6,989746,2020-09-30 02:53:34 UTC,146406553,146403593,false,2960,0
fca2e295b51c867af07fc163e2043804359c29c38f0053bdd8cf5c905e3d133e,989746,2020-09-30 02:53:34 UTC,2850309485,2850307180,false,2305,989734
b287605683fb2d21b72af71a4785e07dbaaebea7f13159610c0db680827bbd14,989746,2020-09-30 02:53:34 UTC,323528947,323526642,false,2305,989734
6dc7f6ef46bc71c0afec04b8ac0f87019134f563d6f0f15c0ae335a957947837,989746,2020-09-30 02:53:34 UTC,1250716453,1250714157,false,2296,989734
eb0906391e1d58c6a2491ff8e32e020d26966e167a38bd52cfbb122a9cdd86f9,989746,2020-09-30 02:53:34 UTC,473332609,473322609,false,10000,0
d1bfa35f26006bc62c6843f3bbf3a670fe686830db1eccefcb54cc9bc1198b33,989746,2020-09-30 02:53:34 UTC,10000,0,false,10000,0
4b941d31a7a95781244d81489b2a4d03817dcca365fa96bcd9e898987872395c,989746,2020-09-30 02:53:34 UTC,500000000,499990000,false,10000,0
b36caae36d48b593824fab3777576d2ef65f1118043cb5ee0407d29d263451fa,989746,2020-09-30 02:53:34 UTC,193211159,193208863,false,2296,989734
227b3e720eabd86489afa2782dd55f58627aeca54e2eb42be48d5a12aed84241,989746,2020-09-30 02:53:34 UTC,1004865872,1004863567,false,2305,989734
9702c107d618ccbe6f2b9d60dd0526e2420e33910660524ba6aa74f7d900b00f,989746,2020-09-30 02:53:34 UTC,557733373,557731068,false,2305,989734
b03d20666d7ede2934d665ef108a97f0d736a6c0121451c27f34924939933b90,989746,2020-09-30 02:53:34 UTC,2495020557,2495018261,false,2296,989734
8a6686e162c02d25f638ee4c87256584fc0eb3238500cf43911eb0b5b1469c48,989746,2020-09-30 02:53:34 UTC,246105684,246103388,false,2296,989734
b2e3bc07aa4efdd026b62a2369a227fde9cdc9e9d21f81581f19ac4be143a3a9,989746,2020-09-30 02:53:34 UTC,492088288,492085992,false,2296,989734
e99731026d90a153709f9e9aa171f76dab55c30e256c0c87dedcbd1b5d011e0b,989746,2020-09-30 02:53:34 UTC,2771125370,2771123074,false,2296,989734
a62819c3c037720b9cabb868d0ffae673df8c67932465c96779feb9fe42cfba2,989746,2020-09-30 02:53:34 UTC,599451072,599447807,false,3265,989734
f694abc2e9f9ddfd5702cd4fe74adc89fc53bc7c91d4d7bcf44e5c0649fcbf8e,989746,2020-09-30 02:53:34 UTC,196973338,196971033,false,2305,989707
9821e94d1565f5bd22db848170d8a3de98c48590ec7bf0934b4462be62bb684d,989746,2020-09-30 02:53:34 UTC,968600767,968598462,false,2305,989734
fda6107008d815dbe4da7f1f63e68a23b37dcbf7841eb6093159befd9b2580f4,989746,2020-09-30 02:53:34 UTC,1288970144,1288967848,false,2296,989734
1b01a6261c649670d190e5c972a55b3245339657e47b7ab03ba4673d60e427e9,989746,2020-09-30 02:53:34 UTC,2813450309,2813448004,false,2305,989734
d812ff48ec5c5b90cca223b07127456d924969b2702c51f7a35ec19a303af585,989746,2020-09-30 02:53:34 UTC,250061830,250059525,false,2305,989734
5c6b689bf0ebf0ec0b14bf8a330b0d801d7cdb8c4a76038b568612217d208b98,989746,2020-09-30 02:53:34 UTC,257770975,257768670,false,2305,989734
d4f4b596df3e6135f7453ce869698af5ebd36939c5e65747fddad307ada39b76,989746,2020-09-30 02:53:34 UTC,427473300,427470995,false,2305,989734
574f5925ad8ac2440325b7e8ea0fe1958040baf4513175b07376e998ae01630f,989746,2020-09-30 02:53:34 UTC,1246776673,1246774368,false,2305,989734
dd4f2ddf92a06e0e6018155624ff8828d99c4eaa725de60904917e9d37198d15,989746,2020-09-30 02:53:34 UTC,1521786381,1521725232,false,61149,989734
c7933669e2eff47f8a660285deaddf816d64490d03753b287fe0da563e5e3695,989746,2020-09-30 02:53:34 UTC,849439358,849437053,false,2305,989681
3899a40a918dbea77c4f7cc438bbe11481e01edce4bf0aa2ad0328ae2dcc2fdb,989746,2020-09-30 02:53:34 UTC,2763259410,2763257105,false,2305,989734
0c581fa3cc3256fffec67a8e1dbd3cb963e7fb5fadb578a6362f2654978c0a42,989746,2020-09-30 02:53:34 UTC,550087647,550085342,false,2305,989721
742e539401abcb1d51bb84a9313ef79f37033b92095c93bbcf1dd85d47dc83a3,989746,2020-09-30 02:53:34 UTC,2641889674,2641887369,false,2305,989734
97231ca804a7b36917eec0fc94d2dad491f6541f402db4b85f7126e546adc52b,989746,2020-09-30 02:53:34 UTC,503754786,503752481,false,2305,989734
ec11cfaef1acd889b3afa7e3898d6bd54fd880632e0bbc077b77295fb5ff0cd6,989746,2020-09-30 02:53:34 UTC,1309157345,1309155040,false,2305,989734
959b0586c5e0771c0d36ef86f29ffdcd3133963c59c420a78ad477e75a83ec77,989746,2020-09-30 02:53:34 UTC,1202877777,1202875472,false,2305,989734
ac9069c033729af22d2df5f81006cc87b77b9d5decf624309a5bd02ecc1531ed,989746,2020-09-30 02:53:34 UTC,2573371421,2573369116,false,2305,989734
20f5c4ba96f616fc3bd7e6cd64a05e989de87d82339167fcc896b80a1dd11fc5,989746,2020-09-30 02:53:34 UTC,10000,0,false,10000,0
92d46544d93adb85cf3f3b6c45273f64af8dcf1b5b9cfbe915a5677a5f285003,989746,2020-09-30 02:53:34 UTC,100000000,99997550,false,2450,0
7357a48c51f5b1e193de8c0e22080c380e4b127df44a8990534a83b25c09cd1e,989746,2020-09-30 02:53:34 UTC,2767243859,2767241554,false,2305,989657
31a57e44f853e5da9a31411968b675f6cea761192a604fd7a2101d5f7513e78e,989746,2020-09-30 02:53:34 UTC,144268896,144266600,false,2296,989734
3ba1634767829469d2053ce35e6f3dd026113f19ec99e17682205322a8882eac,989746,2020-09-30 02:53:34 UTC,2577257873,2577255568,false,2305,989734
ca4fd42fbc9be02301fdf4121a2fe453a850afab563ad185c7b10f8ae3914e01,989746,2020-09-30 02:53:34 UTC,192754587,192751320,false,3267,0
03f38a57a345e0b73aaeb63ec861e6520f419b9a7fc8f3e0c735d4a81ad68cae,989746,2020-09-30 02:53:34 UTC,344782563,344780258,false,2305,989734
e25d5b53046a7e3bbee8fcc492c1adaad468638be78629bf69a7d62afa10e574,989746,2020-09-30 02:53:34 UTC,431382536,431380231,false,2305,989734
d8b0a6c4ad049161dd9614653b456cbc46ec6ec341320da771dc396534ffd435,989746,2020-09-30 02:53:34 UTC,2569505899,2569503594,false,2305,989734
4660ad812cb116d514606f6a90b411b4fa8478052e7997b0e97b3b29e4a4f20b,989746,2020-09-30 02:53:34 UTC,500000000,499990000,false,10000,0
2ea9a4f5f940319dbb7264d9a69b3a6f8a34d673db9f8ab1cc95ef8928fa47f9,989746,2020-09-30 02:53:34 UTC,2453616279,2453588768,false,27511,989658
86d61fb89b17bb93e90572fc63ead13314eb57e78f7b6dad2cd3da4a386ebf7c,989746,2020-09-30 02:53:34 UTC,2718839480,2718837175,false,2305,989734
698a0ef236290dcec2188aa3e5a18e5f674448d75bf533291ac3bd5a96b09a08,989746,2020-09-30 02:53:34 UTC,809714756,809712460,false,2296,989734
c9545e82d11510a17e51d6c85becae8e421615908d424bcc196e014ef40cc2a6,989746,2020-09-30 02:53:34 UTC,997199696,997197400,false,2296,989734
3ef477e2fb3ff393540ecd33ff0e7166eaf6196e0e670efa357b049e5755327d,989746,2020-09-30 02:53:34 UTC,151936378,151934073,false,2305,989734
4809a4d624c34cfe8cafa1eb08324103c8b991277df513b44eb7d5cf63057765,989746,2020-09-30 02:53:34 UTC,989630709,989628404,false,2305,989734
3e5d6e24b32f2a4320ba8cf7cb4b92dbac5160973d9cd20a21b84f81ee747170,989746,2020-09-30 02:53:34 UTC,238381908,238379603,false,2305,989734
e6569e606a11ebd36c6e8cd27dffd995b06ea85ca89f021a243f544b2561c00c,989746,2020-09-30 02:53:34 UTC,300325678,300323382,false,2296,989734
c9632eec099c899ff591301a97c2cae550714d386709a95daaf68bc1dbead03d,989746,2020-09-30 02:53:34 UTC,1277426138,1277423833,false,2305,989734
b4a05574328807e76371e33377905d61f197fde00ea639894b93f1446f2b0f12,989746,2020-09-30 02:53:34 UTC,468815079,468812774,false,2305,989734
73589a4285cceaf23f664581352ff27ac52cd743e5dbd2af362cd1dfefb9a558,989746,2020-09-30 02:53:34 UTC,964859523,964855618,false,3905,989734
623fe5b3c94fa12d98e443c3619f4b4013ce059addcc94d079d6e4e663ae4b45,989746,2020-09-30 02:53:34 UTC,2722701896,2722699591,false,2305,989734
68c46527a7c1a8c372f26fde272f369a55b39974214e9c0c04afa6e641d3c7a3,989746,2020-09-30 02:53:34 UTC,253822934,253820638,false,2296,989734
ce5496878494b73983085aaccbd41917b74461a41f51fd57d959e80071351a03,989746,2020-09-30 02:53:34 UTC,10639982025,10639976025,false,6000,0
4c5e89eaa385707bd5dc372fdcc209326ce8a7ef82e27bfb69acea700cfafdcf,989746,2020-09-30 02:53:34 UTC,553854276,553851971,false,2305,989734
280ca8aa0f1fd1f7224e2795e5acd663d07dab679de88bef7a4d392e3e5bf0b9,989746,2020-09-30 02:53:34 UTC,499704778,499702473,false,2305,989734
84c387e1b0e094105e232e4ee11a314e64bc2e27a7b8167b99347fae55de6fef,989746,2020-09-30 02:53:34 UTC,1224040972,1224038667,false,2305,989734
98bf1f2be65786c707f379052e39bac935926c36743597b10e0c8fed978b135d,989746,2020-09-30 02:53:34 UTC,495929137,495926832,false,2305,989734
46d75e0790598d063be257f20358879664fd67d6d292de37ef0f79ed19acbb65,989746,2020-09-30 02:53:34 UTC,8847776549,8847774244,false,2305,989735
8558fd82721fd2b5b7d594651a751248e52627936109fad9557c2eb94582c9a7,989746,2020-09-30 02:53:34 UTC,2673282926,2673280621,false,2305,989734
86d53372c615634365958530f3c887e0caff48b4d40e105c38efe0f31a1df1c1,989746,2020-09-30 02:53:34 UTC,2600284832,2600282527,false,2305,989734
129a8c1854aab06fe66d823b33b81cc140f1787657fb57740b860cf67f37df87,989746,2020-09-30 02:53:34 UTC,791516543,791514238,false,2305,989734
e567c8e8cb947878198574a335b4b516ea2a818ae8bcfab81b087cd78f03aa29,989746,2020-09-30 02:53:34 UTC,500034636,500024636,false,10000,0
8a77ed2a0037686997d217e5f0d472d6b288068202e79632f1fe2a0940d8cce0,989746,2020-09-30 02:53:34 UTC,2561666917,2561664621,false,2296,989734
daf6314f16c42a22ba5a7a5b932568931e71aa503106056644e42d9e306fdf93,989746,2020-09-30 02:53:34 UTC,2677132452,2677130156,false,2296,989734
f0c32701ee2fa9ea77c0ccbc05564901b66c80d353cdc13d67062e25d7977b10,989746,2020-09-30 02:53:34 UTC,581324457,581322152,false,2305,989734
a62cd7c88ffb53c2f502029f22c47ffbb09ee1034c5fa9e7f357413bd16e5989,989746,2020-09-30 02:53:34 UTC,2665584233,2665581928,false,2305,989734
dd96e1aae197214077b7670c7a66d8c77bb1c70b3326f6da8304bd96ae2f92f8,989746,2020-09-30 02:53:34 UTC,313055244,313035244,false,20000,0
e928e4739954aa9a5ee2803e536afcfc1cf937fa3893dcb86e8c0c9ee115c24a,989746,2020-09-30 02:53:34 UTC,1273542424,1273540119,false,2305,989734
3edcfd073c6b4da7ceb7247cbd4779f004f7caba79d96828ae4e40789b959a40,989746,2020-09-30 02:53:34 UTC,10000,0,false,10000,0
c0eacbbbf02707bbbab04d4e230d0abcff22e33fd55e3ae3ee937684ed168606,989746,2020-09-30 02:53:34 UTC,60754700,60744700,false,10000,0
9c05d3f36ea8174ad0333932803714a59ef7c9934395ccd994c271dfb9eb7e34,989746,2020-09-30 02:53:34 UTC,2557751290,2557748985,false,2305,989734
6e7ca9c210c6bb2463ed06cdd2e8c5545d387e35b60d8fb6cd9988d070d302d0,989746,2020-09-30 02:53:34 UTC,853409898,853407593,false,2305,989734
64f29580226b2cfae831992ee87f6b64ffed19af4dba1ae7d13719dae684385a,989746,2020-09-30 02:53:34 UTC,140037096,140034136,false,2960,0
09b71d953c6cd7ad489ca076c15985470b3b95aa61d0cb8cbc68c9fdfcbddacb,989746,2020-09-30 02:53:34 UTC,546194301,546191996,false,2305,989734
01c32e56fc128f1c50f9a351654b6859f709b440c6272eeee4eb9f6dcfc21f90,989746,2020-09-30 02:53:34 UTC,155745077,155742781,false,2296,989734
d168481372b731815174a20d3d2d051c48d416ee2c56b81f2f399bb0c2b37b6b,989746,2020-09-30 02:53:34 UTC,148085865,148083560,false,2305,989734
050f5a3b1aa92e994963c081717b2037dc4b991477ea370d92e3d8fa78ee9d16,989746,2020-09-30 02:53:34 UTC,1000947446,1000945141,false,2305,989734
401fe070310284cef6268f0f93aa9c1af55ff5ef648749834e8592152b3341c9,989746,2020-09-30 02:53:34 UTC,47994687,47985275,false,9412,0
f41f0db09371280ab02a660632594ffb975de4a9694cc888539e663ef167e872,989746,2020-09-30 02:53:34 UTC,2661711201,2661708896,false,2305,989650
ee9c55d6f53e9b0bb8d1c8cca4f06df120a09ad0d2e49d8f5c60da869cda7162,989746,2020-09-30 02:53:34 UTC,542180314,542178009,false,2305,989734
325851ab5ce945d3b8df99445dfac9e4a3c0f335f54ecfb4a350c2ec321f38be,989746,2020-09-30 02:53:34 UTC,538844529,538824953,false,19576,989734
62808f8310958f5429427b57dbe9a0a5d10f194eb5c450e2b71c7140ba5956e3,989746,2020-09-30 02:53:34 UTC,2514832126,2514829821,false,2305,989734
5bc4145e9426ba6c074504353435973962c5a0340248c74bd885394fbcc45bad,989746,2020-09-30 02:53:34 UTC,319571517,319569212,false,2305,989734
8e0e0bf6abd459649ca186fc31cfcfd2a0d92e1c1cd6b935d6a5c7f015f1a171,989746,2020-09-30 02:53:34 UTC,307989406,307987101,false,2305,989734
bbbeb6aba8bf92217aca57fd820fec290feac534f1214de2918a93b5e0ef0fb0,989746,2020-09-30 02:53:34 UTC,1199108182,1199105886,false,2296,989734
d90a6e76d7d7896604a4299eea6c5b96341f7fe7b175f7ed6230d463ab0089cd,989746,2020-09-30 02:53:34 UTC,1285142797,1285140492,false,2305,989734
92923c571d1c78cc261f18c3d24cf1caf06bdffb3c412139003f41a3dc168359,989746,2020-09-30 02:53:34 UTC,2498933559,2498931254,false,2305,989734
4f34c62fc5879bfc01a6898d7d3013e8f0e3bb5b7f5dea1158f40215d5f1e0d8,989746,2020-09-30 02:53:34 UTC,488292614,488290309,false,2305,989734
b0d8514bf962811c4e561feef371f14a36c9912707772bf944582679ac8ba8a7,989746,2020-09-30 02:53:34 UTC,8838944944,8838942639,false,2305,989735
909369c9eb6891f463ef1d47a9534c333d557c15b4c1bf8584ff11b3b9c6284c,989746,2020-09-30 02:53:34 UTC,1254527135,1254524830,false,2305,989734
e53a36b0929aa7ecf47a70d4f90df4ae0bcb30fabdfdb139458bbc79cf45a59e,989746,2020-09-30 02:53:34 UTC,2715070078,2715067782,false,2296,989734
d736b0713cf572153167cf216e9db255c7c6aa734ab1d1d1ee01abd9dd496592,989746,2020-09-30 02:53:34 UTC,7002822275,7001406650,false,1415625,0
066a50e0d697f1a7bf7fa16e853e379a3695e867c529eb183f556df4336e4f25,989746,2020-09-30 02:53:34 UTC,242301416,242299111,false,2305,989734
850e50c05cccb2c68879a8e8bc95c8ff5f3e7f6032945ee28f7157d44b1ad43d,989746,2020-09-30 02:53:34 UTC,1281281102,1281278797,false,2305,989734
8421856324778cabd585b85fba32b5913fbb222d4dfeaf7808fc7ba28e952fe6,989746,2020-09-30 02:53:34 UTC,2604095147,2604092842,false,2305,989734
d478aa993140e7a61ea3fcabe140fdb85ebacf4eda76193101025b468a88a3e8,989746,2020-09-30 02:53:34 UTC,389744129,389741824,false,2305,989667
19953e929c1fab3a39c0a2b82f5337b7f1799629bd940aae518019e11fa7c29e,989745,2020-09-30 02:50:29 UTC,4444497915,4444488889,false,9026,989642
57875f0823338f521451f5be6b12ce2fbd0049e4f96e2638f1811bfce35693ad,989745,2020-09-30 02:50:29 UTC,8885290816,8885288511,false,2305,989734
3ddf882792fc3fd75c40e66a0ff57b493b034a58b237f3e0e15e381361667ee5,989745,2020-09-30 02:50:29 UTC,61263104,61260807,false,2297,0
8f18a0e1f2a2ee2e51471f32334dd5fd68eb61243e22265865187ae5934379fc,989745,2020-09-30 02:50:29 UTC,135819691144,135819688839,false,2305,989734
5d9d58c51ec4591d56b59105aba532fa83753d0a97739d2bf7e428bbe63f546e,989745,2020-09-30 02:50:29 UTC,48023529,48014117,false,9412,0
d9933f927b24e652e7a9d5ae68098cac7c282599002910149a1e22e09f57e0e4,989745,2020-09-30 02:50:29 UTC,2854206489,2854204193,false,2296,989734
1e1181332603157a7791e02e33d42fc6459a3a17585c7fb1d0b1ef3f6fb268cf,989745,2020-09-30 02:50:29 UTC,1084892107,1084816811,false,75296,0
c7fcca0a3854872a949d2836019710790519b4639eace60a37e37c8c3a48711c,989745,2020-09-30 02:50:29 UTC,9025501442,9025499137,false,2305,989734
f9d947ed2967fbef57340299e7349b8dab91aaebc3394ea15a891249be0d6a79,989745,2020-09-30 02:50:29 UTC,20597923971,20597913971,false,10000,0
2b6172ae00ab80f855ba3692a4bd238c47dd1530117f67ca35c34903c85226cb,989745,2020-09-30 02:50:29 UTC,334178717,334158717,false,20000,0
f0933176cd6df64dc937f1e4be6431ac38972fde5ed9330a345a4a7e10a4a6f0,989745,2020-09-30 02:50:29 UTC,1772732904,1772602082,false,130822,0
10c1bed5ec306ebbb2eb7756df5fc215160621a6397066a22ebe26f6d2c528fe,989745,2020-09-30 02:50:29 UTC,57397469389,57397467093,false,2296,989734
8d41dd17ca9b0a87f8665f3e49b657a7727d4a32ea6b1c535f9eb60354d65753,989745,2020-09-30 02:50:29 UTC,397722234,397712234,false,10000,0
2d97434ae797d003909171ce2bc9e6762aad4c67b926c6292a4dd51a8b17d61f,989745,2020-09-30 02:50:29 UTC,13730400123,13730394123,false,6000,0
ee027b4357e1f0a48546cf079067fac4a018a0469eaa2913459be59bcc86b14f,989745,2020-09-30 02:50:29 UTC,205045184,205041784,false,3400,0
74b2570db2be6602aa790dbf1ac199a0a70a7d33217d31fa2b58ae3d76b9d0ca,989744,2020-09-30 02:42:55 UTC,835100000,835090000,false,10000,0
a7c9e7bb6e6bd309035d7af774140a9d5627e9742a3c184986bd24d916dd6dfa,989744,2020-09-30 02:42:55 UTC,2985987202,2985982336,false,4866,989731
752c38afd8dca6405df1b9f81129c9059ab7c61e481a16405fc3fe217e07f020,989743,2020-09-30 02:42:50 UTC,3140765200,3140762904,false,2296,989731
d3fce6aae8d15dd22c8ca632328dba4e11b87a3b5346247d0c7a73690e6ccf50,989743,2020-09-30 02:42:50 UTC,3144600456,3144598151,false,2305,989731
61e7dca271e76593c70a0a48efbd775334055436ee40c650537116f2136fd323,989743,2020-09-30 02:42:50 UTC,3098900547,3098897602,false,2945,989731
fa5c27add25385e18bd5f396dc696dec56455fa03bb4047279294aa1aea63a1e,989743,2020-09-30 02:42:50 UTC,3102808281,3102805976,false,2305,989731
8aee9e83ea9ec8009618d116b8d59404f9185477b602be4ad0dfc77a47b264a6,989743,2020-09-30 02:42:50 UTC,3043225037,3043222741,false,2296,989652
2a165d9aa56559d13475147a3221def17df9c3d035decc3245744be611fd21ba,989743,2020-09-30 02:42:50 UTC,3024162844,3024160539,false,2305,989731
1e540d7e94ef15c40ae992ddaf27db91074701d761e992c8dbd15aea916ea8a5,989742,2020-09-30 02:42:37 UTC,7129435630,7129433334,false,2296,989731
c525c2bfb3ebdecdbdfc2b7c7f9ac29ced03facf443afa1640d484b56af512c5,989742,2020-09-30 02:42:37 UTC,6899888722,6899886426,false,2296,989731
796ac4b398905b015294c05c6010028566ff8437b45546b7267cf7c5c7aebd6e,989742,2020-09-30 02:42:37 UTC,6823336050,6823333745,false,2305,989731
19a53c3c867e2086740d14df71ed52b55d9e17194673f142dc3ddfd55ab2a28b,989742,2020-09-30 02:42:37 UTC,6102890178,6102887873,false,2305,989649
46ce8a4c71a5fbedda60606be9e5f4cbd5d6681d361d00df11436b7f11127dae,989742,2020-09-30 02:42:37 UTC,6888239204,6888236899,false,2305,989731
54811c1876877334d7d47514e25e399fd76f1f886d17cb27defa2ae8437cef2a,989742,2020-09-30 02:42:37 UTC,3148419093,3148416788,false,2305,989731
5fa866042071d0cb944dae79ee0330802dee0c8baf5d6df2999d6231f320d4ba,989742,2020-09-30 02:42:37 UTC,6276265872,6276263567,false,2305,989731
891bc6b11ae505f8ccda4eaace32423f645ff10c2b8684f59ea3814399617d8a,989742,2020-09-30 02:42:37 UTC,7293736196,7293733891,false,2305,989731
bbb543d44d6f565e6619fc1ec84158f55ea3874721583ecf57735a955492666c,989742,2020-09-30 02:42:37 UTC,6541451214,6541448909,false,2305,989731
f62aa763a5636152062ea4d263ab4d119b9539e4e80cb121fcf539400fcbc840,989742,2020-09-30 02:42:37 UTC,6202137602,6202135297,false,2305,989673
3a98f0b037fc3a9c93293ae8a539f38baadf560e67cf6e94e79667ca97cdf592,989742,2020-09-30 02:42:37 UTC,6514287597,6514285292,false,2305,989731
5e1fa7974b4c8b7993cac5d44564f11be831dc7f3fd3cb20b5096c3a9a733517,989742,2020-09-30 02:42:37 UTC,15188121,15185816,false,2305,989731
dbe769449cef354ccfa9822e5a3926514ded4ef917712aed5004e10344fbf62e,989742,2020-09-30 02:42:37 UTC,140222632,140219672,false,2960,0
4aeb927431cca0c654fe2b26336b8c8d61faa0bf01e8df3403324d2952b802a5,989742,2020-09-30 02:42:37 UTC,6884460691,6884458386,false,2305,989696
4e5cbf3bd17423a987f2263d06ae5dffe442e5459d8750661d070cce182a952c,989742,2020-09-30 02:42:37 UTC,1522793647,1522738917,false,54730,989731
cfd7ced622c34b3bd3e43d9de74d77577eb70d900e410877dcab850a5482f731,989742,2020-09-30 02:42:37 UTC,3156052920,3156050615,false,2305,989731
1d741aba91ed2173bd005830805bb5ce49d058fa4e2d509663fb9589dd220dba,989742,2020-09-30 02:42:37 UTC,539494236,539468909,false,25327,989731
bec1934bfba119135adfdea71d179ade1393006ff0c8e6163130989e014a03b7,989742,2020-09-30 02:42:37 UTC,4358025770,4358005422,false,20348,989690
1ac4feecb7318fe6e772700604f50eb2d2bf4e29f5407e8a892e152a821388ad,989742,2020-09-30 02:42:37 UTC,20600536586,20600526586,false,10000,0
3838332114a1f05c1b3f5e3882a37a14c1ff5552f5e26272813f9d0c51ae729a,989742,2020-09-30 02:42:37 UTC,6198394434,6198392129,false,2305,989727
cca70971d980fbdede6d05d4e42dff6e343f5cf7a06c3796c2caa7e62ed7071f,989742,2020-09-30 02:42:37 UTC,160764700,160754700,false,10000,0
5e4bbab93c460ec03a630ca32c990911308e4998e6887e701df28a43dd500e05,989742,2020-09-30 02:42:37 UTC,6929920748,6929918443,false,2305,989731
43f3f01ff86c0bc08922d9cb3e011da126bbd9fd2b0046fd67501ce93cef2971,989742,2020-09-30 02:42:37 UTC,6903659275,6903656979,false,2296,989731
6359b9eddd86ac533b014649cab3438f7a752f27bf80c9ad197544d17d40a671,989742,2020-09-30 02:42:37 UTC,6230138165,6230135860,false,2305,989731
0769d3fdb7d0f2c4e5bdcdb12dafcd98b7d34d6758d41def963dcdf64f3007f1,989742,2020-09-30 02:42:37 UTC,5909683,5905994,false,3689,989721
ebaa450807ba759bd7e0071a8c6630c5b8cb7577f0a0368d8dc8ff90871f229b,989742,2020-09-30 02:42:37 UTC,7026553241,7026550936,false,2305,989731
f2a6d7dc16edbd5be15cf46bb85a6adf216c2bbe2cb0971c1b0bb457c19cfb09,989742,2020-09-30 02:42:37 UTC,10000,0,false,10000,0
c4f021022634d887068445f26eff12f03bd55ca6edffcf99a6958be0929af007,989742,2020-09-30 02:42:37 UTC,57401306002,57401303697,false,2305,989731
ceca0b3357ae604d3823212a723901f7fa92ed55da318a439b6280c60a2d5b99,989742,2020-09-30 02:42:37 UTC,6736617825,6736615520,false,2305,989731
470cba4d2cdd1807a9e25c59a77c547f1e1739f9fcf327257b7786212d72521e,989742,2020-09-30 02:42:37 UTC,7106074167,7106071871,false,2296,989731
4ca1ee9ced4024193d5d8f8c80508df8e90b67bcc89ed3a27f4a3b06e8b4fafb,989742,2020-09-30 02:42:37 UTC,48269071,48259659,false,9412,0
a9dbce2a490a05df2d978098187814ac0e1fb7ce8d4c05fc6c42242351cd044d,989742,2020-09-30 02:42:37 UTC,6209775916,6209773620,false,2296,989666
09ea8a84b89a6fa2c07c264bfa473dc151c36d39017a7701b8161fc82db5ce39,989742,2020-09-30 02:42:37 UTC,7256372644,7256370339,false,2305,989731
89b6dd80938a5d2f7583500d2553aed2930cbd28b0e75c61658fb40fad5a1ffa,989742,2020-09-30 02:42:37 UTC,20000000000,19999903100,false,96900,0
c13dd6b01b60f7959b8faee78a9134713584333ef2861e901eda8e988dc2e7f3,989742,2020-09-30 02:42:37 UTC,7121615318,7121613022,false,2296,989731
fc8ec90e850ca3a2464d9b0514a4a41165f5413268a27b044303d70c4dd4f90c,989742,2020-09-30 02:42:37 UTC,7102197086,7102194781,false,2305,989731
f6fdcac61f4df7dad8cc652faa91c27e3ef421f7455d973f00f05f815a2d2450,989742,2020-09-30 02:42:37 UTC,6063169422,6063166486,false,2936,989731
ba283390941be94cb5b4745182dddae499870e31b4972d7da65624435cffe42a,989742,2020-09-30 02:42:37 UTC,6740412033,6740409728,false,2305,989656
0c42e14cb675edb530a23faa0fcb1c60b39e3ee3b83112eca9c5d10a92decb00,989742,2020-09-30 02:42:37 UTC,7109991657,7109989352,false,2305,989731
db853b12ac530e96a0b878c063eef252d96de890f273c7be2f55b557e09ed2f7,989742,2020-09-30 02:42:37 UTC,6959244801,6959242505,false,2296,989731
fdb9a8d4801ae3811c901d04044d1299ed690b1418d64177ee717c585891a16a,989742,2020-09-30 02:42:37 UTC,7157541606,7157539310,false,2296,989648
64af3291667f9fdc4585a6f22d9106601b93198367d6cd5e5dc7daf1cfd3fe30,989742,2020-09-30 02:42:37 UTC,6937533395,6937531090,false,2305,989731
bc61c96e139ba1367648dceb413b06abff99bbf624c7f552c788d83a94fdbb2d,989742,2020-09-30 02:42:37 UTC,7334233654,7334231358,false,2296,989731
244303528cd11e7a202b83cafe52b1679dc6ac621f2f18a968c61a16540743db,989742,2020-09-30 02:42:37 UTC,6892107677,6892105372,false,2305,989731
b9d40ad6886a00d78fffb0f98486363151e149db03d4c864bb22c7c36dc7964d,989742,2020-09-30 02:42:37 UTC,6744259991,6744257686,false,2305,989731
5b0733478a8f7e82611d02b915b4da3f0e6d17fd68eded3e1ba0f5e850051f97,989742,2020-09-30 02:42:37 UTC,6007963791,6007961486,false,2305,989731
bca9dc2998c64bd61ba6ee793b796168ec978726811844c9cabfa14d0293c8f0,989742,2020-09-30 02:42:37 UTC,7338116832,7338114527,false,2305,989731
79b4f47d788076d7afeddce44d99642bb498ba3b44ba086e98f6c2cf9cd06018,989742,2020-09-30 02:42:37 UTC,6506594341,6506592036,false,2305,989731
535e47e058c3b3232a996de526b79302557d04849628c65ed71ec1e44c32bc21,989742,2020-09-30 02:42:37 UTC,7113796506,7113794201,false,2305,989731
34d763774a90e82a32ffb6f45b6368e74ecf83989fddd6c140b6ae911648dc21,989742,2020-09-30 02:42:37 UTC,5969828953,5969795099,false,33854,989731
f466ac8c8f9cb27f742afc5d8b0e16af7cab5bbb0de6f8261d5b39c42e09034b,989742,2020-09-30 02:42:37 UTC,5306957076,5306928531,false,28545,0
6146fa155a0b25b54229b4aa2c6141a38b0a05e456e4a9310be6e8106717f156,989742,2020-09-30 02:42:37 UTC,6895981407,6895979102,false,2305,989731
26d7c7e0b4315b6fae60ec57bcaa3ae3191d2ef259ae8a080478d8c5f26bbd8a,989742,2020-09-30 02:42:37 UTC,7219066414,7219063789,false,2625,989731
11c82fcd124bd025ecdc62f733446ebdd697d7f28b76260668b2dc710ce19bd4,989742,2020-09-30 02:42:37 UTC,500044636,500034636,false,10000,0
02a0d27145461426051513c2d779ff676209bade7424ceb5750831e918cfa96c,989742,2020-09-30 02:42:37 UTC,6728955822,6728953517,false,2305,989667
fffa45dae0be6a5faa124306800ab1eb652c875696cf35c159367b99a2be6b5b,989742,2020-09-30 02:42:37 UTC,6510402010,6510399705,false,2305,989731
7f821c68e65283c154f68825c8d71efa039a8e34d566098c682f6e22eff10c08,989742,2020-09-30 02:42:37 UTC,10000,0,false,10000,0
afb7b6984ad0fec56d8b145515a6f79e814d266b66991d271f5ecad4b0a7753c,989742,2020-09-30 02:42:37 UTC,6237743303,6237740998,false,2305,989731
05f002cde48cd9eab7e6b9235a80b7446447eef1bed5125e174c565fc0a1fa5d,989742,2020-09-30 02:42:37 UTC,6933717294,6933714989,false,2305,989731
11edd498d4c344351a91d2d5fe280f8680c1028a153a0cc578002b0ddadde4e7,989742,2020-09-30 02:42:37 UTC,6941342426,6941340130,false,2296,989731
00798315c69442e712af861bcbddbb4f8d7f6cde5f5a0379375ff5c0f9c93a9f,989742,2020-09-30 02:42:37 UTC,7064175467,7064173171,false,2296,989676
f6afe79e24e5c0e6fe95c4dab4fada3995dfabb23b7d4a3c964dcc22e1d198ed,989742,2020-09-30 02:42:37 UTC,6144638334,6144636029,false,2305,989731
d152c513cd30eb33e9465ace58e568906e41ca4426e219cd8062c64ee7f38768,989742,2020-09-30 02:42:37 UTC,6156242381,6156240085,false,2296,989731
a8476cf5a546b12c26796f840c04f3116a3e6e5d4e5252bc28572ad143e421a2,989742,2020-09-30 02:42:37 UTC,531715260,531704040,false,11220,0
31d1b331846a839f34257a1aceaad0eabab40ed3c2ad9333502fb2d5740c424d,989742,2020-09-30 02:42:37 UTC,7117683787,7117681491,false,2296,989731
1b0f32d93b2a0421f00532a9557dde562af5601a934833c22b2ec4e41ce32169,989742,2020-09-30 02:42:37 UTC,7153632834,7153630529,false,2305,989731
a675cd38c3e6bb2c74eac556cf58e81651b590ff4dc8363b26cc5a5276c9477a,989742,2020-09-30 02:42:37 UTC,7022704218,7022701913,false,2305,989731
d27efaaa256f7785250e0ea1d691d039af44fb7e19840c279231d8d16539894b,989742,2020-09-30 02:42:37 UTC,8889086355,8889084059,false,2296,989731
f991d84c4d7101670acbcb83768ad874f747a32dabc1f056aa759a116c3180d1,989742,2020-09-30 02:42:37 UTC,7534204,7531899,false,2305,989731
51db07e09c7794d5a514e9d6108381d55292bf2081f40c7ebb48247e21264835,989742,2020-09-30 02:42:37 UTC,6206015167,6206012862,false,2305,989731
0676efa2cedb38e5348c1eb196fe98b740efe0ea38e43f45b80e7ffdde40bb08,989742,2020-09-30 02:42:37 UTC,6537637560,6537635255,false,2305,989731
87348d7cc2eb38e638d4ec74ceb09dd8286fb798c3c0d74a6c45c9eea7c03dc5,989742,2020-09-30 02:42:37 UTC,11350473,11348168,false,2305,989731
ed81e54186163504666cc3edfac3c723ff6f2e2a2d13f7aa4a18d967e23c335e,989742,2020-09-30 02:42:37 UTC,6827326761,6827324456,false,2305,989731
adc984ae3a66a812d168ad06b828bf2ab007355125020e9779704c5fb369f3d6,989742,2020-09-30 02:42:37 UTC,6865766522,6865764217,false,2305,989731
62e1b6072a10a2524f3ec3e9592986d8359c84af19bd4ff2c8c13605612f3d1c,989742,2020-09-30 02:42:37 UTC,7176152287,7176149982,false,2305,989636
abdd917cfed1483defaa8662da67614e4c655a5719ab6c25f7183ec5d4cbde32,989742,2020-09-30 02:42:37 UTC,6175367855,6175365550,false,2305,989731
8183bc7307168814d86d70eae8fcf6957dae462eb45055ae6acb89bb7b89bf58,989742,2020-09-30 02:42:37 UTC,6106739321,6106737016,false,2305,989731
4e43336d18c32c2dce1a948206d8f7c7648516f89ec91eafee8f39b918ea7ad3,989742,2020-09-30 02:42:37 UTC,6148446685,6148444380,false,2305,989731
c0b1ac1caebe9e0fbd457216ee4f21e2b3de7e24419984bd71c8b8862921560a,989742,2020-09-30 02:42:37 UTC,6067005010,6067002705,false,2305,989731
547050d5acab13349b287e9f12571988f2c32e77806fa05059258b1da564d1e5,989742,2020-09-30 02:42:37 UTC,7125547160,7125544864,false,2296,989731
cee24e01f277ef5e828895f179d58c853b87c7c8d9f546c4f81e8edd5aea9a02,989742,2020-09-30 02:42:37 UTC,6781679199,6781676894,false,2305,989731
46dc518ae80ffca78af8893b20356f8209f5b22a522e3609434a022637583892,989742,2020-09-30 02:42:37 UTC,6926103455,6926101159,false,2296,989731
c8c50c152b8254387a14715406867e68695f73eb7cf9248b2e619f993cf01fdf,989742,2020-09-30 02:42:37 UTC,9029370848,9029368543,false,2305,989731
311c5e941f1a0c77b1d5203a3bd1efb908c09df1793831011fdb85356b681909,989742,2020-09-30 02:42:37 UTC,6533746204,6533743908,false,2296,989731
ecae8cd99827ba040db257564367f59e17a4a10ed146dcdaabed80b36e13fb50,989742,2020-09-30 02:42:37 UTC,6732812026,6732809721,false,2305,989731
9e9dddf3052386ecffe7b68ed6981dbee5fc033902c5bb665461a22a7deaf657,989742,2020-09-30 02:42:37 UTC,6233960873,6233958577,false,2296,989693
2685152e92d8368aeb76352d8eb3b66547db9d808b35d0e382ea58ec046605f8,989742,2020-09-30 02:42:37 UTC,7001485174,7001482869,false,2305,989731
ad4c649759f75f58467df1bd5b7ab128548fb5d33a749071b621c6db719fedbb,989742,2020-09-30 02:42:37 UTC,6785533492,6785531187,false,2305,989731
221944ca09084c1f7d143f9ea63818bf8217a30029e4476613045239bba89590,989742,2020-09-30 02:42:37 UTC,500000000000,499999997370,false,2630,0
9f4fd820d016dd0dd8a682a81e11d299451f426527d5168e48de3686dbf0c938,989742,2020-09-30 02:42:37 UTC,3152247197,3152244892,false,2305,989731
4fb662c52f7e719c4d5a0530e21965aa19289bea66400b9f2e1697220143bb03,989742,2020-09-30 02:42:37 UTC,6194535921,6194533616,false,2305,989669
e988f26a0e487d88883c111f2997323ffb47cbd14cb2b4ca00f9f433ee383a75,989742,2020-09-30 02:42:37 UTC,6922323729,6922321424,false,2305,989731
9f894ece837d8a588955cc975b60104bc1c598e35594829244565f490c725ad2,989742,2020-09-30 02:42:37 UTC,7149757729,7149755424,false,2305,989731
7d31a5d9d602d704b5d1ba7f1c3e60a22f4613978e93875d0b477fc0d7d79c7a,989742,2020-09-30 02:42:37 UTC,662055159,662011569,false,43590,0
20e615f776818d8385044dfbdb968e0f68b13b23b8818ef86db49e5beae005ee,989742,2020-09-30 02:42:37 UTC,6152375140,6152372835,false,2305,989731
a2bbaa7f9eb764544818aec638c5b0f837dfe521fd3056723869ea3c372c1d02,989742,2020-09-30 02:42:37 UTC,6469746288,6469743983,false,2305,989731
be7baf4e5c7958b8fd3c9eb2dbd101db1ab36b6741d28e84a9da527606517940,989741,2020-09-30 02:38:36 UTC,22920873,22918568,false,2305,989729
e8588cd36e87dcf5507b66ef227e14de53e001e024d3e9ccac2ec4039a4da1b6,989741,2020-09-30 02:38:36 UTC,42111788,42109483,false,2305,989688
709f58f350df50034cf956005208fa1a48ce13e0cdde731e3a3c5182299c3c4c,989741,2020-09-30 02:38:36 UTC,7471416337,7471414032,false,2305,989729
7fd9946b8f94d76d7fc586129e7d630a62daeba45896ae015e446740d8cf006e,989741,2020-09-30 02:38:36 UTC,7433941742,7433937206,false,4536,989729
739eb012ac67f832e04725a1213459df455bed1a5817f463b60f9c292db7ea02,989741,2020-09-30 02:38:36 UTC,48411081,48401669,false,9412,0
93f59951251e0412878758611aa9fe09e3c981d2f7053351d5a8d61b9ec5043d,989741,2020-09-30 02:38:36 UTC,19047684,19045379,false,2305,989729
006e8f615a793eb9baade6228e784863303a2e28e54bf672b73b10bad2d53f74,989740,2020-09-30 02:38:25 UTC,30620789579,30620773999,false,15580,0
2bdf9ea9367559901d01dd17f64af61d2b027e19cb554114c2c5d71378ee8cd8,989740,2020-09-30 02:38:25 UTC,7660112032,7660109727,false,2305,989729
c1793718559083ddc707933e632a0694085e432c05a4ec47fedd17a4b4135071,989740,2020-09-30 02:38:25 UTC,7664011612,7664009307,false,2305,989729
8be3ef9508c607eafe3b4ddbb458feee743e97eccde13f52a6a2d61959c2ba06,989740,2020-09-30 02:38:25 UTC,57405248582,57405246277,false,2305,989707
0e521cd0fc44b6923745842136ccf00368c0ba0c2e211ef246a6ae96e26f6ee2,989740,2020-09-30 02:38:25 UTC,45927673,45925368,false,2305,989727
361060161107c4be8b4169f2a654ab66bd42e1571d36fd5ead8811eb323d76b6,989740,2020-09-30 02:38:25 UTC,8892907042,8892904737,false,2305,989728
e6349f2104fa89a55aadc3799366e5147e1e58be5339074a0956868eac18fa07,989740,2020-09-30 02:38:25 UTC,9033235845,9033233549,false,2296,989728
48149d7acd3cb224df1ace897e5aa43ae2dadb40bba8768be31c004381bd39c0,989740,2020-09-30 02:38:25 UTC,141104061850,141104059545,false,2305,989728
b39cfd4fd60d12e3edb74b09388b07eca60c0ef2b033b674a5f94a44406ab499,989739,2020-09-30 02:38:08 UTC,140815375,140813070,false,2305,989727
7d00d36fe8bf183979608dd1a4d4cd1dce9a00650b420b8081ad69f894a57e1f,989739,2020-09-30 02:38:08 UTC,193064381,193062076,false,2305,989727
40d496c26a567991c1a11f742b6fa5654fda6f5a847e1a57542386dbe3838009,989739,2020-09-30 02:38:08 UTC,25672938,25669198,false,3740,0
f9aa2443b8d0ee8096ad8ae57a22cd70afcb486ffce31636b2d04f3a9f39c83e,989739,2020-09-30 02:38:08 UTC,144708878,144706582,false,2296,989727
042ab4d884127b10caa38adf8434723ec2e3f98daa757dec56687b22a99041ec,989739,2020-09-30 02:38:08 UTC,95098972,95096676,false,2296,989727
e6b27f99969c5157484c5016306aae0863c8d2f222f4a197515afecba361c125,989739,2020-09-30 02:38:08 UTC,189288470,189286165,false,2305,989727
5fd0ae86b232e6f034101946384c29c4da07b6605e36e2f8d56857965ee36a54,989739,2020-09-30 02:38:08 UTC,87513837,87511532,false,2305,989727
8672aace660953f45d945b6889cfb849d8fb72e6140f5840d1b0fd1550209f17,989739,2020-09-30 02:38:08 UTC,83742085,83739789,false,2296,989700
a6a57400760c56657ba421cbf3f6266a74d06f916857f4bc9e3f49fbeddb7c1e,989739,2020-09-30 02:38:08 UTC,91318926,91316621,false,2305,989727
3c3d76536c1b35b7e8cfc365097dcc590c23aad53577d5c67c414de1ab13e821,989739,2020-09-30 02:38:08 UTC,8439408114,8439397808,false,10306,989727
29f3d269094204d950c35962afc5aad1305efef3de0532c547bd817af30326e7,989739,2020-09-30 02:38:08 UTC,136920172,136917867,false,2305,989727
1307a681c61554979e1e29a83c80b8b038bbbad64c79d25b57f5578ace0d48c4,989739,2020-09-30 02:38:08 UTC,8076215125,8076207389,false,7736,989727
9327c402a8ca46549ae2e5e287153af9e9d2901058ac8bccbe52b5d686d1250d,989739,2020-09-30 02:38:08 UTC,99005348,99003043,false,2305,989727
f0603a5796c370f1c8dba760cfa2c5c65bb2c70b30b1afdec7166e7f80ce8e74,989739,2020-09-30 02:38:08 UTC,148512451,148510146,false,2305,989727
308a70a7a36414cd97d6d5fe45d0016f25f9a9d57d79c142acfffc6ba3d0ca89,989738,2020-09-30 02:37:33 UTC,500010000,500000000,false,10000,0
940bd3ccff70452df7664623534d1d1f6acebe0e2ad17a08de9a74ec42de8ff5,989738,2020-09-30 02:37:33 UTC,9037094099,9037091794,false,2305,989726
28c257dfe434d76c003ae3333b52fe3b8adb30f2cc9a8e69c87f7c0059fc9cee,989738,2020-09-30 02:37:33 UTC,48453531,48444119,false,9412,0
c08ac230b050d8c1748ba7795079189dc29c06203f34c9a21267c89b7888226a,989738,2020-09-30 02:37:33 UTC,298400971,298398675,false,2296,989725
72dd1d5e574f2cb5cd75a3c8ac3de93bdbbb44b60441565a9128d2486d3c1e10,989738,2020-09-30 02:37:33 UTC,215777440,215775135,false,2305,989726
a1dd2cf3dcbcf57cc0153c16601aead633e803e443ab1ff8e912d379a0d65a10,989738,2020-09-30 02:37:33 UTC,57443334005,57443331700,false,2305,989726
8f3606dd8850b80347e725d9c136d2b69772b2f6e15902119606ba88f7bd4e36,989738,2020-09-30 02:37:33 UTC,10000,0,false,10000,0
b860edd7b485481615184e04f86d225dcaa1917495c4f7ca6825840a0aff9f8f,989738,2020-09-30 02:37:33 UTC,294519716,294517411,false,2305,989726
aebbf46a1f4507c11abb41ba79b87f2067fac424d73f8fb5dac1a7f31961d13e,989738,2020-09-30 02:37:33 UTC,8457516641,8457513376,false,3265,989726
9585738f642ca748d16d851e688515a14d61c368ff4a0729d137553abf98545e,989738,2020-09-30 02:37:33 UTC,8896737485,8896735180,false,2305,989726
c5e40af6be95d6f163ce0301794fc14f6760514ac725646bd31378359b98b064,989738,2020-09-30 02:37:33 UTC,257743269,257740964,false,2305,989726
7aa6c812c1adba5cab6b98d57155dc8217c80b6229debcf0265bd14fa8a9ed6b,989738,2020-09-30 02:37:33 UTC,196966344,196964039,false,2305,989726
9f236c75da272154607fced7dcfd6521e02672a91f73cd215b23fde84afe1eed,989738,2020-09-30 02:37:33 UTC,219610299,219607994,false,2305,989726
96a038bacff5c67b0020a2ad07c20f6bd0a4cc50c96009f2ebf2f3edc3484d35,989737,2020-09-30 02:37:08 UTC,302325880,302323584,false,2296,989725
5429a9b0927d9c84dea3e16ad17ece5ec5c185254dbdeb2d03356423722cf1d7,989737,2020-09-30 02:37:08 UTC,339442240,339439935,false,2305,989725
e18acb3239011bb1dab954e26f523771996edc75007b734309a3968067cc3b9f,989736,2020-09-30 02:37:00 UTC,372872568,372870263,false,2305,989665
61db0826cf189b5837bc40c13bbff36aeeb706c356c40b00a85006d43a7eddb2,989736,2020-09-30 02:37:00 UTC,343371109,343368804,false,2305,989725
088b4fdf5b59ef7dea3cb2c583448a5eec6da9fa0e2646f609d04edce30e4445,989736,2020-09-30 02:37:00 UTC,556812349,556810044,false,2305,989725
622fb5cf1488a7a07d58e203c62372e82a4c31423accc0e98bb0748d049a0fa7,989736,2020-09-30 02:37:00 UTC,621313924,621311628,false,2296,989725
82e3c3283bf400a8c5f6b8165ef92b820a54463718c7d9d9c4a2e423f1503719,989736,2020-09-30 02:37:00 UTC,8900469058,8900466753,false,2305,989725
8cde38daa961c77051e7855fab0e2de0b0ad60529260b1563135e4647a05814f,989736,2020-09-30 02:37:00 UTC,500010000,500000579,false,9421,0
8828ce125aadf420dbd2066361233432f1e0e7f72a678f52e60f3e19b3dec0ea,989736,2020-09-30 02:37:00 UTC,425096860,425094555,false,2305,989725
ca91570fcb6a982efaacbe320b2960add09f665cfb652ee80ff93a1216e8295e,989736,2020-09-30 02:37:00 UTC,351248187,351245882,false,2305,989725
af7fa237a9d9a27f7a7c548b0bc31ca3535c0ca294e6a63d688bfc85872e443e,989736,2020-09-30 02:37:00 UTC,445514015,445511719,false,2296,989725
fa90ab7951706fda6a3fb60923b1f31626994714f05d13ed35d20584941bf725,989736,2020-09-30 02:37:00 UTC,428746311,428744006,false,2305,989725
396abac5d206923555b926aebcb551d79a39954f8f352902ba02f9e985c35051,989736,2020-09-30 02:37:00 UTC,575876350,575874045,false,2305,989725
71137a8b4c23059545865de4ce4d19e90fb04cb677ded4639c3c1401fc07ab66,989736,2020-09-30 02:37:00 UTC,380636886,380634590,false,2296,989725
28018804fabf620a557e2b35d66b48b0e70ba7184b6216a4fb98c3f6890000d8,989736,2020-09-30 02:37:00 UTC,502626753,502624448,false,2305,989725
36af2c3270aabaa53cb872cbbcefc7c339bf150076c037bf45ebd76c512af3c2,989736,2020-09-30 02:37:00 UTC,464626145,464623840,false,2305,989725
825a710a20b261c9d79923ac05d1b55840f9954b2fa6b5adc074259b983f4dca,989736,2020-09-30 02:37:00 UTC,540592650,540590345,false,2305,989725
2776415561a5c7512cd3e6ab8801a84f9388420d1d4f65b946a4d656e5d83f73,989736,2020-09-30 02:37:00 UTC,8478376481,8478374185,false,2296,989725
640d056e609889180a83ad628672e734bcc60b2bef761b2882251cddc5949dd3,989736,2020-09-30 02:37:00 UTC,617472464,617470159,false,2305,989725
2bda7f8c2044ba7749eae24ca6e8b0749037462d167226e2a91e8d22c823aea4,989736,2020-09-30 02:37:00 UTC,579663029,579660724,false,2305,989725
a411ed62f097626ef06e73b5bded8526d83dea4281b0eb1a6ae21e941ab15181,989736,2020-09-30 02:37:00 UTC,9041040605,9041038300,false,2305,989681
0fc1cb74c64fd08cb7e1bb6d1085ea3e12e70533d8c01a494b8337cf8fc07943,989736,2020-09-30 02:37:00 UTC,384519828,384517523,false,2305,989725
b29bb985800ebe4fb1df53d586e33331f2cdb637baef34855b50d7da642dceca,989736,2020-09-30 02:37:00 UTC,376716139,376713843,false,2296,989715
fa1bbe6dd300b441a25155dc1080428400e91e24d2e1ca68e76d6bdca5b0fbfd,989736,2020-09-30 02:37:00 UTC,57447274204,57447271899,false,2305,989725
2d26efd6c0cf8ab6acb1bffd29ff60f0386478579516e3355190f676d0a18b2b,989736,2020-09-30 02:37:00 UTC,347355670,347353365,false,2305,989725
fd77dba5c41b71a4003a2f88d4401fc887e059157662870ca5b54d3baa9a24c6,989736,2020-09-30 02:37:00 UTC,355039451,355037146,false,2305,989725
a42b8854ba55e3195e423376d9c4f2b63a8ce9a7df018126a45d20d24d6d076d,989736,2020-09-30 02:37:00 UTC,10200925377,10200918921,false,6456,989725
2246b5953bd6ef47c7abe0f1fc9615153c1949c07a29e57beffdb3fddab2e6a3,989735,2020-09-30 02:35:12 UTC,10000,0,false,10000,0
06798a7f044accaae548a7dfd7d7d650f44bd142b448559ada93a8fe9a67fcf1,989732,2020-09-30 02:34:08 UTC,10000,0,false,10000,0
698eebf8509491ed7f4e5058735b301d5d1d6d10a4c8e6ac41155feaf2fd170f,989732,2020-09-30 02:34:08 UTC,1031631371,1031556075,false,75296,0
84cd22ad6efd6f7c83769671d96d4f65fa2f86e26d3745f299907dac9b9b8768,989732,2020-09-30 02:34:08 UTC,65989,43349,false,22640,0
e4cb5d644b43031973b044df1ad0f99a96edb9c2b7bd78593c5c69a88e160b7d,989732,2020-09-30 02:34:08 UTC,1403893634,1403891338,false,2296,989721
2886eb174f33bf4c4d355353041bc84e7b49e34dac9d3629a7ce85f8df86d0e7,989732,2020-09-30 02:34:08 UTC,192960870,192957910,false,2960,0
57351767554e47d9b3d698af93653f87823f917b3b6fd005fd9e83cc00134007,989731,2020-09-30 02:31:30 UTC,540273752,540249366,false,24386,989720
8e7386e810ad031fe96339700d9b4456381851a80ec1f4d6b7642c56d6a81312,989731,2020-09-30 02:31:30 UTC,10000,0,false,10000,0
6cb8baff57ba03bf59c79d01e0a30f05329628545f6056ee890b306a4377f4a6,989731,2020-09-30 02:31:30 UTC,1524047953,1523983011,false,64942,989720
a9c2d0dc1b47e3009fac8aaa1a6f633fa2e3175cf7f53cb2313c1695e07135fd,989731,2020-09-30 02:31:30 UTC,60430925,60330925,false,100000,0
09d6b1b7e0c6cd60cd4e7ba94c1aec5006cd35d85c80d19d459a96bc89839891,989730,2020-09-30 02:29:11 UTC,146568822,146565862,false,2960,0
619078024bbaae455424b76b8fb0d2ef01857c72a709c7c2be5710dfa50139ef,989730,2020-09-30 02:29:11 UTC,10000,0,false,10000,0
36e7006e78357b2ab4969c91bfe2aaa39a444ea313503c5d17095e6cdd1fd927,989728,2020-09-30 02:28:25 UTC,6039988000,6039982000,false,6000,0
07a076f851c4f1b8618ec8e300a91b32c8231fdede930aced16078c9b34a6adf,989728,2020-09-30 02:28:25 UTC,281852,250000,false,31852,0
38a8a3fe8bd7873f3abe4534c406c5ab2dcfe5af5da40ec4f6487362076cbf0f,989727,2020-09-30 02:27:17 UTC,10000,0,false,10000,0
f99f276c9b3f609414b590538ac31a90701cd5ef2da2c1c9cf8b03e6a834a354,989727,2020-09-30 02:27:17 UTC,140387013,140384053,false,2960,0
3855fa84a4e513ae20456740125e895585f1631c53f139d6d272871f089cb70f,989726,2020-09-30 02:25:46 UTC,3769220898414,3769220852752,false,45662,0
ba756412884de9b33551299a809a7858aeef0b46991fd3a3c1a9697ba633a673,989726,2020-09-30 02:25:46 UTC,26185384,26181685,false,3699,989715
33912d7488f97d76d56f176e27ebfe09427267e9c50543c5d6185b6c61010f66,989726,2020-09-30 02:25:46 UTC,39481047,39475047,false,6000,0
395842f57351e1e6018b0e4206c80b7031efb4e1c63ad844ca90c63c9f3fb6ca,989726,2020-09-30 02:25:46 UTC,142400000,142398080,false,1920,0
092a41bc855272aa19c467233656e8fed1a6a4a85cd80704abd9e1e425013c03,989726,2020-09-30 02:25:46 UTC,193145104,193142144,false,2960,0
b0bfd05fa4601b927c52a5fa69a1db7a199bf0db39fff0ce2f6ba0e2357115ec,989726,2020-09-30 02:25:46 UTC,2000066808,2000017608,false,49200,0
05a5ac191821a0274d286cf5bab07b2ed45d4993d5095083081ceebb9e3931a3,989725,2020-09-30 02:24:21 UTC,10000,0,false,10000,0
8d695b1da834b4f56882b6b57f8d251c436aa634299a79d6c5a1e3bfe8e26ba5,989724,2020-09-30 02:23:55 UTC,51131602482,51131402482,false,200000,0
c816a21f4bae7b10b6d2cda1c1f06eba48dca84fa98d4f32b985157a272f1baf,989724,2020-09-30 02:23:55 UTC,146750061,146746794,false,3267,0
7b50a9eca7c6f169d85cdfcdc6f85b8a4e19b94b9e27b78ab2d3f46e4f62c2c6,989724,2020-09-30 02:23:55 UTC,39385,29385,false,10000,0
07845738370b60ae4e12c5c7429733aee2e1f490bdeea74f50f9624d7477bfa1,989724,2020-09-30 02:23:55 UTC,50010000,50000000,false,10000,0
5b8e5cc104c7d30543b29ce6669705e23956ba39cf3b338621b19032c4235ed8,989723,2020-09-30 02:22:19 UTC,500484960,500474960,false,10000,0
3eddb2e4d36aecfe45ecb8c355f081b4a975e502ed38e8422f9967938856d61d,989723,2020-09-30 02:22:19 UTC,296343998,296341692,false,2306,989712
9df207ab3e9192a6fee30b913199645b1e443b224bf85aeb6973682852faef24,989723,2020-09-30 02:22:19 UTC,10000,0,false,10000,0
1315c7820cff2e57c52cdbe7716cd38aae29239bc4bdaf190e93b7114174522c,989722,2020-09-30 02:21:25 UTC,10000,0,false,10000,0
f39f6b2f2a8cc5ad5fb1ad74faacb0b8376e999c2a5ea09ad162d5e52fed3169,989722,2020-09-30 02:21:25 UTC,1525145198,1525088862,false,56336,989710
2c659c7bc4b43b5d0aea685ddc1c2b1828fea2f195444e7d34e7f61daad95673,989722,2020-09-30 02:21:25 UTC,98596325,98594035,false,2290,0
759731e1b7801cb826fb5d12e2ebb4dbfe57f50fce0b7b92578d9a5d5082d0df,989722,2020-09-30 02:21:25 UTC,540797279,540774509,false,22770,989710
1fce5813786cba78e39c88089f757cb70a4ed50f6007db4da60760a30d8b39bf,989722,2020-09-30 02:21:25 UTC,163241438,163237698,false,3740,0
6d3af9bd68c2c53b401c55d7377743a0c9fba3190b5a410b696f614fb09c70d2,989722,2020-09-30 02:21:25 UTC,546746921,546726497,false,20424,0
5b334a87e14327d903bf3434fe593a0949131bf7db1e99849b2d2dbf8b17a630,989722,2020-09-30 02:21:25 UTC,199989880,199985380,false,4500,0
988433fe8a84bccf1a75ea93cc0b70225c7883c58dd0ef8556cfda1670a901f0,989720,2020-09-30 02:19:20 UTC,341734151,341732569,false,1582,0
f3c33674703772a6d81683cbf6e3fc5e4d691c77d9f31c8c63f0ae835e225271,989720,2020-09-30 02:19:20 UTC,10000,0,false,10000,0
413ead208d39e85fae5ce8f81d0bc4adc76c02a7c43a088b0e5c2bb60f4597a0,989720,2020-09-30 02:19:20 UTC,7124615615,7124323622,false,291993,0
587817813a9670d8395f28f8ab446bbb9b584040d960190012b6cab502250781,989720,2020-09-30 02:19:20 UTC,141246464156,141246461850,false,2306,989709
a5f887977dcf4bdefa9c1c965557920a3f6febd923f47f240945bb7c028f741c,989719,2020-09-30 02:16:57 UTC,10000,0,false,10000,0
cf4e0081a5bb5005e3059dd8c31af42dc0e691833a955df62ab45880b933a480,989718,2020-09-30 02:16:34 UTC,75198338190,75198335840,false,2350,0
a3557508f61794858c4182da1d09b160de9df99d88a5325cf886d33b67b9a153,989717,2020-09-30 02:16:10 UTC,10000,0,false,10000,0
81d53ca7c9e21d52772be54098225abbe3c8bcbc49c84434235308014f0bbf6e,989717,2020-09-30 02:16:10 UTC,140557240,140554280,false,2960,0
454a0bf7215b908d21b874e43629bf1857edb44f3b63c12d2acaa0b0a9343d62,989717,2020-09-30 02:16:10 UTC,288794,261714,false,27080,0
a31e5cfa5a7ba2400b885651738bb2c904fbc99a1dfb21f38cfb7e63f15fa9c4,989717,2020-09-30 02:16:10 UTC,917790955,917715659,false,75296,0
adc910c18e32edde3333c89d3e65648590e44ebcc7b55303c71bbd41ba785901,989716,2020-09-30 02:13:30 UTC,541482825,541460733,false,22092,989705
23f15ffa8b0bda257b15acf96de453cf76cf7623a441317e1b9c2b15cf73dac8,989716,2020-09-30 02:13:30 UTC,741329231,741326925,false,2306,989665
c6b47909b420d14950a360e6e09156a051ed0e7319396cd106f3d0707f08869e,989716,2020-09-30 02:13:30 UTC,1526445561,1526380941,false,64620,989705
503469d150f55f4d5a81ea626cf74f5400c68cdd47e2769497567384a62efcc8,989716,2020-09-30 02:13:30 UTC,196904131999,196902631999,false,1500000,0
97c49eeb2b6552c7cf47710808936c114a0cc5a0d5781fbfe8f2def3fb6189de,989716,2020-09-30 02:13:30 UTC,1007949,1005499,false,2450,0
eb95e3e6ac869334a25126337b4d3f8fb4a145b119b11510687a6f1c71a6eec2,989716,2020-09-30 02:13:30 UTC,10000,0,false,10000,0
f6e684dccbe16f8be57868aa2b5effeff6d8c76c066b69cb880f18ef63d26585,989716,2020-09-30 02:13:30 UTC,75492590260,75492587910,false,2350,0
2c172d2f41c9466147bd8ee1fd61eb214498bd781c18922f92dc8e94dcd555a7,989716,2020-09-30 02:13:30 UTC,20600546586,20600536586,false,10000,0
665f6abedeb0ffee6a4db0429d0bf43288949e42a35304b5dc521594046bc867,989716,2020-09-30 02:13:30 UTC,10000,0,false,10000,0
7918e8eec72c40aa45456727806129042b4c0797b3774e4f932c0785a31766e5,989716,2020-09-30 02:13:30 UTC,44325928593,44325924293,false,4300,0
8493a5e9ce7a5eeabca7f5693654789144389ffe71c8e6601e15c5a57964a1b7,989716,2020-09-30 02:13:30 UTC,161251781822,161249981822,false,1800000,0
7fa805e17dc27f82a3cb76f84048d95e25750899ed0b194dcb72452f28e57176,989716,2020-09-30 02:13:30 UTC,10000,0,false,10000,0
817bfb071b8cd0da2a9e6f0b69a11536135e90484791cafa5a5d19755b24b782,989716,2020-09-30 02:13:30 UTC,10000,0,false,10000,0
d2616258e6d71f268b2793bf34d9902ef9335326fee123b6e44f1e89b15a769a,989716,2020-09-30 02:13:30 UTC,193354854,193351587,false,3267,0
31e10173ca5c40823c6049d55d65488386f4193c46f7d80d55a4d855683190f2,989716,2020-09-30 02:13:30 UTC,50956645361,50955345361,false,1300000,0
f51d030d8c1549f9517e619e32cef79783cbda7fde0cd7ae6c4e5de10e2dd218,989715,2020-09-30 02:08:19 UTC,500000000,499990000,false,10000,0
1d5f2aec3c662deaf136fec0df5cd3a647b7e3dc19c369d26c59cea4d6fc1f7e,989715,2020-09-30 02:08:19 UTC,10000,0,false,10000,0
d068124c67a13d683db79c388c1607f1fc16b3b4c1ff9fe5f6ab15af80a31ccb,989715,2020-09-30 02:08:19 UTC,20868066484,20868056484,false,10000,0
46a0233386ac93c2545c01a73e6bb871ae3c1f3e960d2a3c2fff27d6b668ab39,989715,2020-09-30 02:08:19 UTC,46556040,46552797,false,3243,0
d4f34ba0db9139a4ad94b6703f4fc044cf082716f1393593405b43c90425e756,989715,2020-09-30 02:08:19 UTC,32951,8951,false,24000,0
9491b07473074cf5237208d650fe945ad3c269419fdc0d509c625a9bfaadc9d0,989715,2020-09-30 02:08:19 UTC,6000000000,5999997464,false,2536,0
4cb8953b20e4ed29fb0cef625c2ed8e49ae747711dd9b3639da41d0848059621,989714,2020-09-30 02:06:38 UTC,334227453,334225147,false,2306,989696
2a52310803c3454596f85e7eaa2ad834722f2e8636754f23f28016974b331b16,989714,2020-09-30 02:06:38 UTC,12039994000,12039988000,false,6000,0
7ad5c5afdf68c3e985ba3712b4083314d98580cb5ae8c8ac793d8578abc6ceda,989714,2020-09-30 02:06:38 UTC,35025,25025,false,10000,0
197517807c93e67c854c731b74bc9c7ac05f188a723e58f5f499212eea465cf7,989714,2020-09-30 02:06:38 UTC,4000475615,4000465615,false,10000,0
bd065076da7b0b347d3b008fe335da1c176cb30bda72dd5ba8f0dfd00b4487ed,989714,2020-09-30 02:06:38 UTC,2000084776,2000074776,false,10000,0
0ad5c73f37c21596d2e4cc805e2ac896a8274058a18d4cf969df497f2e5409d1,989714,2020-09-30 02:06:38 UTC,500494960,500484960,false,10000,0
45d594b4f9591535cd374c7af917a1618660361bbb0ef6ad12cf2a37d9ec7fe1,989714,2020-09-30 02:06:38 UTC,21778,15778,false,6000,0
51fe411bc2eaa568a3020e05e6c525288a36c736d27425c381e4f041e4ebc898,989714,2020-09-30 02:06:38 UTC,48503303,48493890,false,9413,0
9b69aaf5f041985991c6b870ef36d319ac35088e90042e7538942d3b2ac78420,989714,2020-09-30 02:06:38 UTC,146909752,146906792,false,2960,0
9ab9caaf1dbf9937e68693d0bb262c8dc0dc6aae8821840723f4646395237a30,989714,2020-09-30 02:06:38 UTC,403934772,403932322,false,2450,0
ffbac098c14841813f748f22d7033081e852b1818a278555ebcda3c2d42bdbca,989714,2020-09-30 02:06:38 UTC,244024463309,244024453309,false,10000,0
377aad194a1879e1328ae59a4b78b1fabd7033d27cb3449123a655267a336d77,989714,2020-09-30 02:06:38 UTC,10000,0,false,10000,0
e43afed031f612d0db798c443e4ac530880aa5b9a8ac0a9002985efd24b07c69,989714,2020-09-30 02:06:38 UTC,1499998677,1499988677,false,10000,0
cfbdad0fafb61ead906d73c4c3fbf411ab6e2931c93dabc2c513266f083e6065,989714,2020-09-30 02:06:38 UTC,22009890000,22009880000,false,10000,0
531ad369ec7e6ff8052d0a13645d1c163792d8f91ff9c9cb86575f0e68a7c5a5,989714,2020-09-30 02:06:38 UTC,16389000,16379000,false,10000,0
a0c28198d906e83b957d8b897cd95865ea2b05e63bbe9a5cc3abc05a7c92ea3a,989714,2020-09-30 02:06:38 UTC,10000,0,false,10000,0
16f6010035cd2c262894181bc12706128bf2316024696478e049984e080d5181,989714,2020-09-30 02:06:38 UTC,70009380000,70009370000,false,10000,0
525c7dadb5e2f4f99e28bdd0160c23d0b12fc9f998fe368777bb45ff7cf27714,989713,2020-09-30 02:02:10 UTC,15012563999,15012557999,false,6000,0
8ed8b2e113c7fb56b612bbacdf432fc0a9cc655c110052099bbacbf28bc44816,989711,2020-09-30 02:01:50 UTC,10000,0,false,10000,0
7cf69441aeb625cc931d8efa243e818e872f03a6db85e70d358c01ab83c173f8,989711,2020-09-30 02:01:50 UTC,141349566462,141349564156,false,2306,989700
fe70a79b3c5d07d90957d7537626b9cf6eaaf41782ea7d666ede232446f2bb4c,989711,2020-09-30 02:01:50 UTC,13396988777,13396984644,false,4133,0
a62b9e5fe7fab3583ce5cef5af5d6fd99493774e40e61fb16130064986a4e04b,989711,2020-09-30 02:01:50 UTC,20868076484,20868066484,false,10000,0
facd5374b3b816dab9127880e8bc53d0718c0fb01e7eac4a09a6ddd710d37a7f,989711,2020-09-30 02:01:50 UTC,152033880218,152033870218,false,10000,0
15596ebd2028508486d441b7829c64364c392d5a1395ba475955851cdf10937b,989711,2020-09-30 02:01:50 UTC,6241669999,6241663999,false,6000,0
c733e7f4ccb36e24e33501c0acbc381ee87cfbdd764f380285009479b13a0b7d,989711,2020-09-30 02:01:50 UTC,486391603,486388667,false,2936,989652
d4d542735b8be15e1db19087bb4328866d84835d86f5001346f2c0824973f1fb,989710,2020-09-30 02:00:19 UTC,541941996,541919876,false,22120,989698
8d77b5a217681cf9d287834eacf02bb273fa3874b9e4dc96b77b4b69b83dd5d6,989710,2020-09-30 02:00:19 UTC,1527423894,1527367539,false,56355,989698
891065b0bcc5c5aefc30a88438e90a4a3deba93d9e9a3af8f20223d75080bb75,989710,2020-09-30 02:00:19 UTC,128061505,128044811,false,16694,0
eb0558b292a9955921a326e3c60a8e104750d61716af8879ae5f9c7099f5328f,989710,2020-09-30 02:00:19 UTC,1544754313,1544749334,false,4979,989699
a7a139e5250165bb76844e239f2916f212c160cccfb80b0b83151986ed774be4,989709,2020-09-30 02:00:04 UTC,499983740,499973740,false,10000,0
eb4f68faa6fc1f01644cd104e844458a958bd85aaea3dbb9425dbba8fb699518,989709,2020-09-30 02:00:04 UTC,7032672708,7032636078,false,36630,0
7a37219f2634adf68c88d587e7015ff42b954a4206becc95ffb5f6232a11e0d3,989709,2020-09-30 02:00:04 UTC,152033890218,152033880218,false,10000,0
902ed15150e0a4cb6bbd8cded698365494609e110324672c84bfa43040f3a2c6,989708,2020-09-30 01:59:27 UTC,10000,0,false,10000,0
d4168f28ea6f65c86f3067dc51048267a92ea2977d95138bb3b217002f5fad1c,989708,2020-09-30 01:59:27 UTC,502990096,502986356,false,3740,0
4737e62b909d74a91b0ae172dad94eb76b79fcb803e9732adf5057d6753ad172,989708,2020-09-30 01:59:27 UTC,62193618,62183618,false,10000,0
7b75dcc6524c9778568ced589e94152db1e6021c343b962d3bf24caaf0badcf1,989708,2020-09-30 01:59:27 UTC,84186,74186,false,10000,0
28b985c250f5ab83330fa0a65a4e3cfba526110dbfa30d0b9b7c259556094e5e,989708,2020-09-30 01:59:27 UTC,146112635514,146112632889,false,2625,989697
eb4fa0efdd110617cd40fbd695d623c0ebbd39f985a9ee7f95a154fd98a58b7d,989708,2020-09-30 01:59:27 UTC,6519505375,6518403188,false,1102187,0
15466102416f7fa2d6b4fbc387a605973103d92c5dda81253da7a32db0e806e7,989708,2020-09-30 01:59:27 UTC,500728283,500690423,false,37860,0
75549eb50da3cb63fb0b2b3f4e08ae09c252070bb164fd7bf2f9b023cd2c48e1,989708,2020-09-30 01:59:27 UTC,151103148956,151103145136,false,3820,0
623cf8ed5353a950a05d7e947f58b97b58f1a17870536cac1e9bfdecd78f42b0,989708,2020-09-30 01:59:27 UTC,623910058,623834770,false,75288,0
4e81dc1b4dd40d8dc7f101f47ed501ef5c8ca7be71e542572dd9db5cc2e2f617,989708,2020-09-30 01:59:27 UTC,10000,0,false,10000,0
38ae4c7e03ce0321abf8eb6906966a3881e9f0082c666690dfc2ffe66ba396ef,989707,2020-09-30 01:55:06 UTC,4591,2151,false,2440,0
fc2f98a203042042a1083ff496dc048d768d016f01735cf2999eaf82198b3fd2,989707,2020-09-30 01:55:06 UTC,499993740,499983740,false,10000,0
d7e5c0c8fcb7b880c9098740b72afc0e81f0eba7960229762adb07febdc231ad,989707,2020-09-30 01:55:06 UTC,10000,0,false,10000,0
e734a0ba9f55093201cb4d05848bf2b2d76d2c9ed26fa7bf5f90e4895dba87f8,989707,2020-09-30 01:55:06 UTC,140738263,140735303,false,2960,0
dad369de4f2378c670b49e11ca5694c800c41fa710b628876b34c608194ad3ee,989706,2020-09-30 01:53:35 UTC,3244184930,3244178659,false,6271,0
adda4e916ff6bff139525736d323d1cbcb8f145eae31c0ac2dfae578a7f08162,989706,2020-09-30 01:53:35 UTC,10000,0,false,10000,0
e9aa2ef535212c8b9955a9666af40df499b0238998acb8eb68b47eefacb3fd76,989704,2020-09-30 01:52:22 UTC,384320248,384317943,false,2305,989608
32fd2b85d4c19248459004e3c51c7e27e01a654a6dee8097615f8448718c5d7e,989704,2020-09-30 01:52:22 UTC,146612637819,146612635514,false,2305,989693
200bbfed437c21d0d051b703e454f0e7d5ea0c8d66a46825b0b1a179f9990c47,989704,2020-09-30 01:52:22 UTC,10000,0,false,10000,0
505b17d3b63fd1923d7d2db9823730c4f84a6f0c418d178919641f8399f313e3,989704,2020-09-30 01:52:22 UTC,500003740,499993740,false,10000,0
bd0bfc36da3ceefc616f9dab6461eb827d3f743c741f711085389b7d033ab082,989702,2020-09-30 01:51:06 UTC,114834,112384,false,2450,0
71f2326faf640860d16b05e68d7ab2d5c5b75145002d4a1f354743ec5d6b9c9a,989702,2020-09-30 01:51:06 UTC,14558684,14552218,false,6466,989690
34da2b6413730debfa0c59fdb8c3722493ab7af668034c2783c734c375e85e72,989702,2020-09-30 01:51:06 UTC,4884404,4882822,false,1582,0
1aec6de277884de26fb66a11f8c6f1e8d3c61691c0d0ad675ef61dc1ae21cd76,989702,2020-09-30 01:51:06 UTC,20380816335,20380806335,false,10000,0
069bd1d1cb8781c5a92f07a1641cc70a3ba6c71a38fd6d155594cc108932a2eb,989701,2020-09-30 01:50:22 UTC,542465717,542446451,false,19266,989690
3e3edc03900c330caf699ab6e7c51b9c0e9a08ca661cc7b81db8ed4842652867,989701,2020-09-30 01:50:22 UTC,10000,0,false,10000,0
2fcac1c41b34b3a1ecae40e3a948ec281894692c5538cc2b81d0902d7547be17,989701,2020-09-30 01:50:22 UTC,193526992,193524032,false,2960,0
df0eec35a5a35cadfd5004c171c5122292a2ed780cf165f9424c296bc357584b,989701,2020-09-30 01:50:22 UTC,33530566,33520566,false,10000,0
7f7e0fa4b1e6d6035414b0599f6f31ad8d753b1219d5fa6b9d0f5d294e8b852f,989701,2020-09-30 01:50:22 UTC,1528480610,1528422040,false,58570,989690
2dd88e35bad7425fab016900eb3a8181387e33ea53e03360bdbd6de20df84393,989701,2020-09-30 01:50:22 UTC,146617445995,146617443699,false,2296,989690
e1e002bcd7ebc034f97b8fdb2832e9e0531f9e2d18dae92fb55a62bf4ee6a59a,989700,2020-09-30 01:49:30 UTC,48554971,48545559,false,9412,0
c18decfa60a6a7316fd74d6e0d849df3ffe122c5e1f0c62f47d24b635608625e,989699,2020-09-30 01:49:12 UTC,20584603945,20584593945,false,10000,0
0679defd5264f729cfc593a57c9cff390ecf455f33ac7ff8ec4fbdb14f80f1a5,989699,2020-09-30 01:49:12 UTC,48583484,48574072,false,9412,0
8b820043d3a830aeb58a377d9080a1d7310815c837fead1dfdab9ce92c03075f,989699,2020-09-30 01:49:12 UTC,147078814,147075854,false,2960,0
5603af2bc6edae510ace777305966778602c5208434937a7accccdeda7f40d95,989699,2020-09-30 01:49:12 UTC,10000,0,false,10000,0
ed7141a7738b460ea7faa62eb0fd1bcf0d04b1915c578dcb6486351e8dd944db,989694,2020-09-30 01:46:32 UTC,10000,0,false,10000,0
4595144960623416c695431072958570516c54d17b7f23b7477464740904f2bb,989693,2020-09-30 01:44:50 UTC,20584613945,20584603945,false,10000,0
be9563341f29f66f811dd429a5ffa30616d52885b74ee49f28255ac56f5083bf,989693,2020-09-30 01:44:50 UTC,395472153,395359133,false,113020,989682
6f88eb6e4fcd7a165d5d2d6ae55cb8606ba5cdd1a6c9ef58fc072c9ca02006bd,989693,2020-09-30 01:44:50 UTC,275424305,275414572,false,9733,0
6ef97c8da100b02c6b2b447e01520bf3f30b0dcb5d28b3c4829692570db863c2,989693,2020-09-30 01:44:50 UTC,10000,0,false,10000,0
1c99528206b80783beffb38b3001e623bf2439f625c0efffc7d2c2b4a27e2839,989693,2020-09-30 01:44:50 UTC,42928,30928,false,12000,0
72d6eabf593a07a3856582db3666f538e45d26548e2fd90471c7390403339056,989693,2020-09-30 01:44:50 UTC,36810314977,36810302602,false,12375,0
6b11450f2eb45e572c3674bc9554982d20e40fdbc47fa89153bc8065d37de90d,989691,2020-09-30 01:42:09 UTC,10000,0,false,10000,0
af1cea6280bf6ba1b21136327a8da99bcadfdbedf1b56678c517a5dd66f3e02c,989690,2020-09-30 01:41:23 UTC,100000000,99997550,false,2450,0
2099581cd66d1094ed15c27b328bf2ae709557df7f4b04736121b2f8e9821044,989690,2020-09-30 01:41:23 UTC,10000,0,false,10000,0
f6580dd5cfac55df59fcc3ffef9c2ab59e0ad7fc6b6886a94b0d6847566cc564,989690,2020-09-30 01:41:23 UTC,1000038660,1000028660,false,10000,0
f5949ee11b1974d788bbb3bf1601d9864683b8d52ea2d7f7cb8a575d296535c2,989690,2020-09-30 01:41:23 UTC,542936819,542913137,false,23682,989679
5c05a1f7b60439a28b5b963451d3f0fbb61106f682cfff492ab0f0dc94e6ab1c,989690,2020-09-30 01:41:23 UTC,1529439757,1529386634,false,53123,989679
dd982f25614482c7c19830a362f69ee42ffb0a1b9fa6ec2b728b909ff22aee5b,989690,2020-09-30 01:41:23 UTC,250,0,false,250,0
7b311f59434bbce1c4730af758827ab1bfcbc4882692c71bbf9ebf9a80c29228,989690,2020-09-30 01:41:23 UTC,140954632,140951365,false,3267,0
4d8a9897cd5d1e0aa73b7bdacd0d8d8a9f07143359247f826e373e4617afc1e2,989689,2020-09-30 01:39:35 UTC,637572,627572,false,10000,0
f5d12f6f2b652b4b4fdf2523eb193aaf251443236cf1b17c6f89e4cf5a952049,989688,2020-09-30 01:38:53 UTC,10000,0,false,10000,0
de766d9b91aaee70cbacb82203c34cd74026dc4692df5a8fda2c82ed0fb390a3,989688,2020-09-30 01:38:53 UTC,2153425542,2153417559,false,7983,0
9e048e57fbd62cd4fa83e7b203d1c05eb31ee64afe937d5eb63d351f76cf95eb,989688,2020-09-30 01:38:53 UTC,989555561,989545561,false,10000,0
654e7996fa74aff7da559558ff0a5f5fdd77a22168f3638552882d87f42c7018,989688,2020-09-30 01:38:53 UTC,750961938,750886666,false,75272,0
410bc52e7a2f4eae2aaa5ebac4cd5ab7fb95fac12bde2d036470cdccc4ab2adc,989688,2020-09-30 01:38:53 UTC,500068660,500058660,false,10000,0
ad6694cd610318fc32c62d2994159e7b13dcf3125728816ac877c81d5a9e4911,989686,2020-09-30 01:37:17 UTC,16241675999,16241669999,false,6000,0
a64cfd588620bf5640a14764c1803ea01ad97fd4e658704d169b4cf5383126a3,989686,2020-09-30 01:37:17 UTC,193674113,193671153,false,2960,0
48f0aee6d2555c0c185dc805113418b8fb35ee96cfadea1a077c7b8dfd36aca3,989686,2020-09-30 01:37:17 UTC,293853051,293850433,false,2618,0
7addb0b4cb372f01575ac105ebb2ce74caa6b619c63ebd53b2345b1083d33b13,989686,2020-09-30 01:37:17 UTC,10000,0,false,10000,0
afe5486a6e9abd1f061481e2ec6361dbfe061805f6b422971ecab736e6bde518,989686,2020-09-30 01:37:17 UTC,75602367993,75602365643,false,2350,0
0f76d5b80f41be392d76143ea5e847fa8bf8beca66607bf00a6a93040b8462e5,989686,2020-09-30 01:37:17 UTC,6120000000,6119990000,false,10000,0
9ca1b297d953013ac0bd41f8f1dca7b25d35bd5c0ee11ee702bc73a897b517fd,989686,2020-09-30 01:37:17 UTC,34200,31750,false,2450,0
687889981aebf6e4a705081cea90792d87cad610141951ee31f3b9c56b72e8d1,989686,2020-09-30 01:37:17 UTC,500078660,500068660,false,10000,0
2718acd803a135ecba51db12339b59bc8b33e205d1f52dd2202354c42e8e76f1,989685,2020-09-30 01:35:02 UTC,50866766,50864506,false,2260,0
df0c9356912ee3300b90b46c50ac3f748e12936239f7c38f700f1e9b1f2715fe,989685,2020-09-30 01:35:02 UTC,10000,0,false,10000,0
5b75392f35c54732d7c6dd6fd68f91bf7c086083d1cbae2b9809f665711fcb39,989685,2020-09-30 01:35:02 UTC,499990000,499980000,false,10000,0
831f67e89649f899b4931164a02cf3f5b09f31f7b2f05d3479e11c88f5312336,989683,2020-09-30 01:33:49 UTC,16685439,16681751,false,3688,989672
a5a4a7e7df42dfc4d632355f9c141f1481beb146b9d9d6cd9349dae7a4b059ee,989682,2020-09-30 01:32:42 UTC,10000,0,false,10000,0
546ff6ce6112055c2a7462962b7bb9e9de8050d3209ac8910f654bc97bd66a11,989681,2020-09-30 01:32:19 UTC,500000000,499990000,false,10000,0
4a8adcdac0453aba74be946aea7f54a293a17c7c193fced299f05a3fb5ce0238,989679,2020-09-30 01:31:38 UTC,2695843957,2695833957,false,10000,0
71611a35917ef6c8f0aafcbdcbd5952bc0c019cb0bafbf609bd03a675d310cfd,989678,2020-09-30 01:31:18 UTC,145628880,145626430,false,2450,0
62083052e52745dcf75190ca9ac49af94e2e171ad065efe53933ee56461aa64f,989677,2020-09-30 01:31:16 UTC,1530757767,1530694106,false,63661,989666
c8ebee5ec661b686f7dee6a27c2d1b512a41600330158dcd7305b91403579d5b,989677,2020-09-30 01:31:16 UTC,10000,0,false,10000,0
4794a000810960bc14aa6cabaa6cab6663f5c90590cdd763e32b397a804ea63e,989677,2020-09-30 01:31:16 UTC,7995981999,7995975999,false,6000,0
815863fadf33e912f1a3d463fe8319625e1d29fa3d40f22c61ecec3c36b9bbd6,989677,2020-09-30 01:31:16 UTC,696699100,696678987,false,20113,0
d1eb10563986b0a330c6f0779477c9b70f248ca8e62c40d0d7f00fa64a0a453c,989677,2020-09-30 01:31:16 UTC,543423622,543406319,false,17303,989666
9496a83cc95ce0645e59ce41a739213c5b9d4345f5554bd61d5e6a928c02bf4e,989677,2020-09-30 01:31:16 UTC,48960141,48950732,false,9409,0
d1f5a0320eac639d578d220007dad936333807b1d3bd8e1fa8d5296f46aecd26,989677,2020-09-30 01:31:16 UTC,147280483,147277216,false,3267,0
c9539e11a6b0cf2878238f84fde034531e9f69852359395c12fc85f7a75a4286,989675,2020-09-30 01:29:32 UTC,141117269,141114309,false,2960,0
4b317a08fee97f495726f00b223f446c3af1998245a3301ca2a6441a373b592a,989675,2020-09-30 01:29:32 UTC,6120010000,6120000000,false,10000,0
85a5f0c1c0750811cd6c5fee60ac475a5e96b73e4183f8973bb12afaf1df02b8,989675,2020-09-30 01:29:32 UTC,10000,0,false,10000,0
766ec18eabba9cbe73908bfe4b6ba7dfa329247b3bb821d55b65c6a0efafe446,989675,2020-09-30 01:29:32 UTC,1237784250,1237347852,false,436398,0
1425a6a42f9a6866a63db7e4ef9902f1b03f49ddb0f0fd74c53460dfa4d8589d,989675,2020-09-30 01:29:32 UTC,108196911,108171009,false,25902,989664
1018bb6245fa074b575bb4546d63832330a8a5037260c2634029ebf0bd845ab7,989674,2020-09-30 01:27:02 UTC,10000,0,false,10000,0
3ae1a5392a720e1d7859e3366075167ded96fc2e28808803d217d10acb30c5a3,989673,2020-09-30 01:26:06 UTC,656405,644125,false,12280,0
d61b4a0da95a71eeea332c6fa8d70cd04730fd0d015504d6c7d03a132e6d4ead,989672,2020-09-30 01:25:37 UTC,10000,0,false,10000,0
d3472047cc1d55c3ddd6be4fad4e1c60dec5161135615bb47af6667ae3c3325d,989672,2020-09-30 01:25:37 UTC,10000,0,false,10000,0
8bb35d67d952d9bc211e2fb28d1ced1cf1194051b146cc2a6095787e51d695dc,989672,2020-09-30 01:25:37 UTC,11560874261,11560864261,false,10000,0
d886c8107352edb83a8d13dd32851649eae14b2f83d7a3fd9c1e0ec798e8030a,989672,2020-09-30 01:25:37 UTC,11452644055,11452516846,false,127209,989604
a388cd8ee7d3fd122155f8ddf3582c366334ab262b83e310dbcc669a6af28dfe,989671,2020-09-30 01:21:08 UTC,235641317903,235641156840,false,161063,989659
f04db547e00ba247088b40d10ef93f82f62c929bdbf9311128afd8b1c07e8de5,989671,2020-09-30 01:21:08 UTC,843936363,843932478,false,3885,989659
da8543bb14e956ee28f39ffbdbb4da5c6fb69441ffd702b1f7a3851e4da80c3d,989671,2020-09-30 01:21:08 UTC,10000,0,false,10000,0
69b84a95dabf4b8e914c3d34a2987b43c3bc4e3dc041e897d7b5cfea5308800b,989671,2020-09-30 01:21:08 UTC,4795932,4788432,false,7500,0
f1e36f97bbf0d3331b2f5b125b0a57c2f0c070f6a2bc958b3b7a72a20a386856,989670,2020-09-30 01:20:40 UTC,1531799875,1531737475,false,62400,989659
9ce0c95f88e1db359d33e858f4b61077e60e72a1d8c7632ef71c08e513063976,989670,2020-09-30 01:20:40 UTC,20267821849,20267811849,false,10000,0
f8b56d63b2ec22d6d1d57228cd835f8fc71ce4e492610091639a89eba54e88c8,989670,2020-09-30 01:20:40 UTC,49007156,48997747,false,9409,0
130d888a10b9bc174c5360860a3d2ae73d78bee9bb17d494bc77f40f7002be10,989670,2020-09-30 01:20:40 UTC,544119798,544097659,false,22139,989659
7c651bae98387e8ba2dedf1e97f185aedfb7339e71a8e88b1c3eb4fffd851668,989670,2020-09-30 01:20:40 UTC,193814998,193812038,false,2960,0
28934a5e36b9db493fcdfe4b3c5ef3e03044bd2b83a94c72c267c45e328996b5,989670,2020-09-30 01:20:40 UTC,10000,0,false,10000,0
b46280f18a4b1ef2f7d64087237631343606d1ced97a1becdb9a6780e61d0cf2,989669,2020-09-30 01:18:59 UTC,147947716200,147947713895,false,2305,989657
036072dd6ac067e3df98ae5cddd1a97c8cfb19655bd36b72cbf5fdab64af823b,989669,2020-09-30 01:18:59 UTC,413110431,413108126,false,2305,989657
6cd8b3c26caec87e3886ffafee767abf580255aa5dc408e9319a6809aa15dd15,989669,2020-09-30 01:18:59 UTC,1027199428,1027124164,false,75264,0
f78b6bc99afc7b247477a42c63a2414cc0e0ced41a195705fb64ce453922bf99,989667,2020-09-30 01:18:09 UTC,10738687302,10738683562,false,3740,0
f78ed5e858f24467906dd91bc31384594d9d30fdc04c9b99dcc3bd8eed2edec9,989667,2020-09-30 01:18:09 UTC,20887073877,20887063877,false,10000,0
573adb0538c6f77fba7cd953327f7e1aceecd39e3c92e4ac6451c88c692d5d14,989667,2020-09-30 01:18:09 UTC,10000,0,false,10000,0
7e2474fa8d8c4fbdae7c0906ce576cc3eabe9649b2218351a3d606f26bf834de,989667,2020-09-30 01:18:09 UTC,10000,0,false,10000,0
d97292b06b3685b1af0051087f1b8c767d142c5f5178aabff4f3761e63a4b37f,989667,2020-09-30 01:18:09 UTC,86710327352,86710314977,false,12375,0
9033cab82aed6fbec1b8e5fc2fea85bdcf7f06792f3c7e1671c727b696e13332,989666,2020-09-30 01:15:00 UTC,158665560619,158665558324,false,2295,989655
aa7a42476dbae5f5d2ec371bb8fd3b131512bf111203807fdc16fbb1ace5aa88,989666,2020-09-30 01:15:00 UTC,2348862,2348862,false,0,0
29ea6049dcdc32e5f348df4d26346b15268efe6f5d4122da4288af828c3b720e,989665,2020-09-30 01:14:24 UTC,117579806,117577356,false,2450,0
cdc75f69ce8ec1714f15180fcac0bdf9f8c1f7505927337b7193aa0a9ddd0a26,989665,2020-09-30 01:14:24 UTC,15470696,15465606,false,5090,989654
b260912bd1eb7c1570a1185acb2ecc9c395dd467603534c9dd4c43c1f3f98ac7,989665,2020-09-30 01:14:24 UTC,1533032460,1532971405,false,61055,989654
c3e892b38e873215be06a6e7e54c1cfc3f9b20a8534ac132d3a94894d58d5a90,989665,2020-09-30 01:14:24 UTC,10000,0,false,10000,0
43536e50a615beb19d0120479a77bec0ad8d332922503f1abb960c59c966f350,989665,2020-09-30 01:14:24 UTC,500002305,499992305,false,10000,0
8cb9e6504c3a8178a219856c4e08be98a3d295c8f6ec51a2668a2878159a1a11,989665,2020-09-30 01:14:24 UTC,10000,0,false,10000,0
456ea0524cfce78f46602076f2631cec1def2ecb7c06f3c184e40c9b1e752942,989665,2020-09-30 01:14:24 UTC,49040217,49030808,false,9409,0
2c9ba17d9e5fef927ac40c0f9d5ae47e6b4ef12845bc6e5d92ff76325f6815ba,989665,2020-09-30 01:14:24 UTC,705767201,705759218,false,7983,0
37d6c704490a2f43b1d19f01694c59132108313fa1758d5ed886ade452951755,989665,2020-09-30 01:14:24 UTC,49101532,49092123,false,9409,0
ba497476ae8525600b5d26405e0ee2c6270961e0a0427e46e0cb6dbb8bd5321e,989665,2020-09-30 01:14:24 UTC,10000,0,false,10000,0
42513a1717ab7957debb6567e4d8a03ab2a21d168adfc9f07080c2a1ea37732b,989665,2020-09-30 01:14:24 UTC,151305284411,151305280591,false,3820,0
d7e6c7d7968544c8ee75957ec509861981c7ab777ae489618bde1d634371b686,989665,2020-09-30 01:14:24 UTC,10000,0,false,10000,0
c51f4e6aaf0fc3c63caf1e0d6c77ca5c46c669ec90f8d9e1d896368a3a67792d,989665,2020-09-30 01:14:24 UTC,357995,347995,false,10000,0
b4d210e69d4b6ff1a37bc17a187448dbaf8a874d6153f5a75a71e170a1c65dc9,989665,2020-09-30 01:14:24 UTC,136104465,136087460,false,17005,0
7d43eefd7899589e2d17f7850ca49945b503b3a66a8dcec87cf6ef56b78205d3,989665,2020-09-30 01:14:24 UTC,141309964,141306697,false,3267,0
02e87e16f84df3c3d2eeb7804e1d9d305fee664a947342cffb10aeb4b026f194,989665,2020-09-30 01:14:24 UTC,152032904078,152032900258,false,3820,0
a4887970486201b50f8b4e655d72f83835d03d69c22b00752c5036214ddeb8d9,989665,2020-09-30 01:14:24 UTC,175574,144054,false,31520,0
4348427c9851c9091c4958d9f622d6c26bf05a37aa1d36951ee34d81ceacd50d,989665,2020-09-30 01:14:24 UTC,147426140,147423180,false,2960,0
183c4ce6278796b834dd6ed102ebfa67aa06f0547afa2351cda86f47f552281f,989665,2020-09-30 01:14:24 UTC,419304330,419301395,false,2935,989654
6c0f8518c8623a5c339e3ccb34baa0030b7dce0abf8e172de72ce0ca31011752,989665,2020-09-30 01:14:24 UTC,544584008,544561888,false,22120,989654
492592fa694725a8c5342a138221d1f636dac1391829f44be51662384861718d,989664,2020-09-30 01:07:20 UTC,10000,0,false,10000,0
7b7ce3523db858f19b5fe4ba6dd3c8d832aa5938cf97887b25ec67a692a65f13,989664,2020-09-30 01:07:20 UTC,2007780,2007780,false,0,0
120f1fbab6e804e086bd4a6f0a9704304155b208e4e49200dd094d1acbf2b261,989663,2020-09-30 01:06:33 UTC,20887083877,20887073877,false,10000,0
4ae967bf3fd66b6982ed9b3ef13ae86932a84cbe93100e8173e666829f003092,989663,2020-09-30 01:06:33 UTC,49140638,49131229,false,9409,0
30b856767580140092ada933ac57272f10bd04fd3bd5defaa33098f4612288d7,989663,2020-09-30 01:06:33 UTC,1500008677,1499998677,false,10000,0
0e8125a16abb63aca8b5929d79371595a6407236267c8cd6605338cfcc16193c,989663,2020-09-30 01:06:33 UTC,5500339291,5500329291,false,10000,0
b486404337d0a53f923b3f26c6612907906d0f186e2fc6f93f75e8503e679087,989663,2020-09-30 01:06:33 UTC,69040802966,69040787386,false,15580,0
48da1ece17ad4eaca870e5dfeb71560294fc7235fc09bee2773dd53936c601d2,989663,2020-09-30 01:06:33 UTC,240256743278,240256733278,false,10000,0
a6b6ca4e78b9ff0d9911da94908c7a542dd643137ad41721cda7477d72e22bea,989663,2020-09-30 01:06:33 UTC,500000000,499990000,false,10000,0
1cec03f1f58e782b5620c1fd77372ffaaeabee2a961d8a6f325f2858faae8c54,989662,2020-09-30 01:04:24 UTC,10000,0,false,10000,0
21b413ca80c4162c3d8d567f16b0044f1a4d33437ac93a8b445ca9b088f0c9bd,989661,2020-09-30 01:03:55 UTC,23236944274,23236934274,false,10000,0
7b0f1fb9afa813ae02da9ac9d1bfbb58afdf9c3a3b06419b5b5c4d520916cf6b,989661,2020-09-30 01:03:55 UTC,1307100,1307100,false,0,0
80271abf915d00afab9a3774dbc9e9ea19a2854f1e4da14af5baf06e01a8c1ed,989660,2020-09-30 01:03:13 UTC,193967561,193964601,false,2960,0
f8a79091933b03a1d5785c29a0c042089496bc509e34c4e9605f19c6644c6f86,989660,2020-09-30 01:03:13 UTC,10000,0,false,10000,0
4047ecd41b8a0271431bb395e7f82e1214cb9dc22fcf595632a09c750c4bf44a,989660,2020-09-30 01:03:13 UTC,12061382,12057695,false,3687,989648
34c39c71d2adcec6ab37553a07fcce3170e4347dfa4d607a103f8cc5c8a73e1a,989659,2020-09-30 01:02:33 UTC,22736964274,22736954274,false,10000,0
3f26bae792ea0ce67578a5dcc01d715daf508d9954c6e05ec6257c67da8cca75,989659,2020-09-30 01:02:33 UTC,629422366,629418462,false,3904,989648
21e09aa60183bf6553b6e27a1ebd9effa29357453a1ee46a063d0bf62e334a9b,989659,2020-09-30 01:02:33 UTC,500000000,499990000,false,10000,0
cb53abb9373c251172560428139bbf0a356f2ea86cc82bb25af6fdddcdb19fa2,989659,2020-09-30 01:02:33 UTC,544988165,544967336,false,20829,989647
3e0af008912bf3af3c00f092359dba311176ec50ccdeafc9d68343ce62b8616a,989659,2020-09-30 01:02:33 UTC,200700638,200698334,false,2304,989648
2e631ed76318ca2858229ca14c3957e28ba1247cace6e0d2131c4c59d9e3595c,989659,2020-09-30 01:02:33 UTC,1533938524,1533884739,false,53785,989648
448b73ebd1bd20059d805068971e4f7de6d7fbc6bc02904815d4ffbb20645b40,989659,2020-09-30 01:02:33 UTC,10000,0,false,10000,0
370616a4d478201029884d8cefcf11951516f2b3b16421fd02280703d2488069,989659,2020-09-30 01:02:33 UTC,10000,0,false,10000,0
d00e81e6e3141bb387fb12bfe1acaeb4c383d34fded81c5152601c98e79e4784,989659,2020-09-30 01:02:33 UTC,3600705246,3600702942,false,2304,989647
6e90e62330ffefaa5230805b2ec15304b281d2018022012de8ef58eba8109d52,989659,2020-09-30 01:02:33 UTC,17344416,17342112,false,2304,989648
9a80a9c5345aaac151e334018dcf81cf712198d9c9058b37778329febeaaf019,989659,2020-09-30 01:02:33 UTC,609073192,609028136,false,45056,989648
82d49a224d4e5dc066583db4bd29db8f0232c999a2c37a6c48beff296da921bd,989659,2020-09-30 01:02:33 UTC,590805314650,590805312300,false,2350,0
973d5927ea679d23753bff6e48fadd3d26ba2e659e9ebfeb64058a06cca95339,989659,2020-09-30 01:02:33 UTC,430650612947,430650610643,false,2304,989648
4400c85c6c59388a94697c7216e5bec9215cc55e84ec84b00b8a14f00054ea95,989659,2020-09-30 01:02:33 UTC,800702942,800700638,false,2304,989648
48597606ebfdabe0a094f867e0c205c00e73acdd63a46323b03892aa47fb1a4a,989659,2020-09-30 01:02:33 UTC,19215575,19204944,false,10631,989648
9b0c10da39e6fda929bd79d453b350c706e5e8f5d6fbfdc87704deaa0171003b,989659,2020-09-30 01:02:33 UTC,165396462923,165396460619,false,2304,989648
3c83b885ddc2ab3edad9e8a2fd2b81a7f74a1bfb35e32efea8b871b3a3bfb8ba,989657,2020-09-30 00:59:39 UTC,561990594,561915330,false,75264,0
04c144900b16d080980a5bc0eb4e51350569582ff374b9370c85ede06415be48,989657,2020-09-30 00:59:39 UTC,49416268,49406860,false,9408,0
d1572d907372c2dd1a5c48dc1947047818d9e5f6675e6e3bb1f1f325b4225ef2,989657,2020-09-30 00:59:39 UTC,14357653249,14357553249,false,100000,0
f34da47c53c9450df7d1034799361e049d2eb635b87a7b03e9ecef6aa2cd72b0,989657,2020-09-30 00:59:39 UTC,10000,0,false,10000,0
b675947e8244c5206499af83b4f7aeec85e0418070d851e987dfb58143ac24ee,989656,2020-09-30 00:58:52 UTC,22964222559,22964212559,false,10000,0
224a0a16c056819e19e9ee97a4d9013e6880dc0e984872c64b90263a94e9470b,989656,2020-09-30 00:58:52 UTC,500010000,500000000,false,10000,0
830b1e8a2af5410eec6bca44e8537226116ddd53d3478869cfbfd8de2f20a31b,989656,2020-09-30 00:58:52 UTC,2876899178,2876889178,false,10000,0
08f19054555f7856a96d2e61eac30f8b01679cef0e49030dbde27523b51892f9,989655,2020-09-30 00:57:33 UTC,148136260,148132993,false,3267,0
8ed9354c7dc4496107773ff0427c6ef8cc0a3bc45a49da11eb9a22904a9c56b9,989655,2020-09-30 00:57:33 UTC,325163084,325063084,false,100000,0
615c9653c6d84c5cea09a59162e6a4dc14f0c075f9dc8db7a5ba24682631908a,989653,2020-09-30 00:56:43 UTC,8366548918,8366545178,false,3740,0
1237c46fc8cc667684f34e21032e97fbe00c52eddecb4b4d785886ff5b6ea630,989653,2020-09-30 00:56:43 UTC,37558857,37547637,false,11220,0
e177b5df1f69a401426ad8693d58150bcc563bc4015e0ffe46a23dd9f69ca84d,989653,2020-09-30 00:56:43 UTC,10998,6324,false,4674,0
a2311d3e7560f7c878c84b5dbfabbbc4bd480c3ab42846b524a0f8a6e796c652,989653,2020-09-30 00:56:43 UTC,22964232559,22964222559,false,10000,0
4d50d2bf363903321f2abd7f1d5c74f52f6a473a9a7fa2e58b163ff987fb6678,989652,2020-09-30 00:55:14 UTC,141874176,141871216,false,2960,0
58c5d258921ac4381f3fa9560ec033de962a03cfc9d31f7a7243d084a3e430d9,989652,2020-09-30 00:55:14 UTC,999960000,999950000,false,10000,0
e3ff44316a6815a9e2603c706813751cc7fedc37b1b38d040e52a6d12937435e,989652,2020-09-30 00:55:14 UTC,49666046,49656638,false,9408,0
fbe749867b4df90f7c0037f802ebdf807970e6403674eb2cac79e6d690ee8abc,989650,2020-09-30 00:54:26 UTC,3621000000,3620974401,false,25599,989573
2840efd9c14df5ff15cdd447a55589ea8e6a1693c90e31123d841d3919915bdb,989650,2020-09-30 00:54:26 UTC,47199040000,47199010000,false,30000,0
1068d7c21b773332f55868b4c11f03f56666f060716ac7091c45775fd9769b04,989650,2020-09-30 00:54:26 UTC,2903549340,2903542877,false,6463,989639
62b42320e73c44f2b20ecf8718e4a73ff4b13d802bd139a9cdc6b687f0b7ddf1,989649,2020-09-30 00:53:45 UTC,5821903,5815203,false,6700,0
299070af00aa0bc794a00229f8c69f0c3b0fa51dc8f13a29771cd88059f08f64,989649,2020-09-30 00:53:45 UTC,76903504721,76903502371,false,2350,0
6e90a61712c1b89ecee6ae4256f42ea06494a5847a4c74c300e5681147ed517d,989649,2020-09-30 00:53:45 UTC,499990000,499980000,false,10000,0
84e7783f5dffc73f9789c0985657f2d1b863fed0007069f855ba1d646b488f95,989647,2020-09-30 00:50:31 UTC,1535077994,1535021995,false,55999,989636
87ceff2cf7b888e43dcfb89ba878dfb6f3f671f19cbbd44b6fc5fa742f7907c8,989647,2020-09-30 00:50:31 UTC,499990000,499980000,false,10000,0
3712513450dedd9abda6970efb16788da78fe83c173518f8bc1e4b10f82b05bb,989647,2020-09-30 00:50:31 UTC,138871177,138851375,false,19802,0
8297058183bce44a73675e026b07e109d9adb03b69ea024aa9f67d3bbb826474,989647,2020-09-30 00:50:31 UTC,545598158,545575093,false,23065,989619
3c8c9231ef84bc74f2d1292ffcb1bb9ca1fe58463a3e22a69c9c206e7bda6c25,989647,2020-09-30 00:50:31 UTC,202063125,202060675,false,2450,0
0df84eb49dcd729d348bf5b250449eef780725853ff7efcd17b4f792f5cbe71a,989647,2020-09-30 00:50:31 UTC,800000000,800000000,false,0,0
dd1d9f528875bd732b5d3b133b2ac34db5824c571ce616ac5384251acec75b8b,989647,2020-09-30 00:50:31 UTC,500000000,499990000,false,10000,0
1c8f0ea32d706ad2d12140a400f370242a9ad6714535bcf7947ecf7ddf8a0bb8,989647,2020-09-30 00:50:31 UTC,104590534,104586794,false,3740,0
54e6873ad8e76cb75ab6ea0812a03f59daaad0aee23d1591f9d65dad646ec4cf,989646,2020-09-30 00:48:33 UTC,500000000,499990000,false,10000,0
dcca97febf199cd5b2931dee9bba66dba833009e8ddbaaab42f85cb97a07dfe1,989646,2020-09-30 00:48:33 UTC,194175542,194172582,false,2960,0
4facd74e48782117601d227a718d99f94e79b36296c2311a99b7e5d375af710b,989646,2020-09-30 00:48:33 UTC,22260,19830,false,2430,0
4292bc6added6fa32f373949da480d96f1ff614abb98f575bed2155f6325cade,989644,2020-09-30 00:46:04 UTC,1543865,1537865,false,6000,0
1dd0687fc236d2e4d74346982a0efd75a8b1a53ac29227ec041686b7052e30fd,989644,2020-09-30 00:46:04 UTC,49707312,49697904,false,9408,0
18800c8c06633f1f38a3af11340d0b888fcd5ec73bcb7bb74456c0a6bb3604f7,989644,2020-09-30 00:46:04 UTC,22510932974,22510922974,false,10000,0
2ce209c339b50098060f9525ec6f477035b50a97c71785fe5e6edd7c4de430e3,989644,2020-09-30 00:46:04 UTC,148335730,148332770,false,2960,0
9a3337a631eaa44ebd4f46099cc30bf16212fa6e044f0be989883d4bcb2e6810,989644,2020-09-30 00:46:04 UTC,430345394,430335394,false,10000,0
a707748d8cc6e58b68c8c74988c580935e81b88e4ef812d2fb66b06d552e56c3,989644,2020-09-30 00:46:04 UTC,400000000,399997740,false,2260,0
c29444c766040805d336708f82739068b336b6d6936ca3f65f279d13499f7382,989644,2020-09-30 00:46:04 UTC,49737322,49727914,false,9408,0
f15a3432338d32a3dc90592dce8a9c44bfde901939d487073b194d32ad04f2b2,989644,2020-09-30 00:46:04 UTC,442425662,442423358,false,2304,989633
be713cfad05d08aba0ac09476f398117df37f0b6e5430009d9b7e87b4b09d888,989643,2020-09-30 00:41:54 UTC,400010000,400000000,false,10000,0
fb0b8ab18b721de06036cf94681883729f91c5d8bd79aa13555e90acd0055c1b,989643,2020-09-30 00:41:54 UTC,1000064954,1000054954,false,10000,0
7fd2a5b5ee1776db43f89f96a4dc70a537a1da4bc11e571f773b1a1fff164e14,989643,2020-09-30 00:41:54 UTC,1536055813,1536002687,false,53126,989631
cbf9f0b5b33ced37c60dd665ad1f337777ec8d0e8951cad79cfc8447c8ab3e23,989643,2020-09-30 00:41:54 UTC,3690921066,3690908981,false,12085,0
e03f0ccbec2727815e6be25e18ca7aca81a3090cd072d3ca5d70d8f63fa3698a,989643,2020-09-30 00:41:54 UTC,142039738,142036778,false,2960,0
8d459d9624e631312b56df390c70a45019e86130270b9d1ed69879e75595dc72,989643,2020-09-30 00:41:54 UTC,546102066,546079948,false,22118,989631
a5e0bce0be0c52549c393c3b75b2c8214268c9e62e6ac141c41bd8f99fb30863,989643,2020-09-30 00:41:54 UTC,77028685812,77028683462,false,2350,0
32646b2d9b85df180992bccbeb0bdafb66965a6909f0f0e4aa4c69a36164e527,989642,2020-09-30 00:39:57 UTC,615545100,615543954,false,1146,0
20a888dcb94af184d89bbfe1122fed9a6fa1c4baa34fa21ff9b97d43b0466a35,989642,2020-09-30 00:39:57 UTC,325238348,325163084,false,75264,0
b341ca7e2fda0c3ea013b31b6dafe1d17c75f461567c040730eff6fd6c4fb525,989641,2020-09-30 00:39:34 UTC,1009886,1003886,false,6000,0
98c2d3cfbb996634952ee281409bd079bef658f4d41e725f44f1a1a58b08e7b7,989640,2020-09-30 00:38:24 UTC,194326341,194323381,false,2960,0
3019055abf95b852bc43d4d27a7db6fb72e55be486bf94abba60e166a18db9bf,989640,2020-09-30 00:38:24 UTC,1000074954,1000064954,false,10000,0
0ec85cdf834b6af4ca66b37a8a36b0afb11de13c53096d46023233272d098d2a,989640,2020-09-30 00:38:24 UTC,10000,0,false,10000,0
752a6276ecf85a0a67e7e9f0d922742011f5c7d0d4f93a53f97b086b55765e1f,989640,2020-09-30 00:38:24 UTC,77211751645,77211749295,false,2350,0
b4d58aeb7ffac6f4c8318aaacfa401e8a4631bb38c83498311e3a48006bca3f0,989640,2020-09-30 00:38:24 UTC,1089692,1072670,false,17022,0
7c6343d9238c546c6829e9d4e24978b8d87af24168f105704a8f207243ae9c5f,989640,2020-09-30 00:38:24 UTC,166020553423,166020551119,false,2304,989629
2dfc01356d8a2d8bb7403bb12d050d998dfa68a2fdd5a152a005b4d297710bdd,989639,2020-09-30 00:33:19 UTC,1461386,1457699,false,3687,989628
1ab59c8f2d102a9269623a7a4050683feb54b76ee46b18012348c96ed2c8ccd0,989639,2020-09-30 00:33:19 UTC,21756466806,21755190903,false,1275903,0
c9b0918d50e0c38d4124cf3f3499cf44fbbe292a6933346cbb1d8d9e5c08790c,989639,2020-09-30 00:33:19 UTC,10986252452,10986049452,false,203000,0
da8f7aa293548d2d52c4842c1a82434255abd0792433e1a87226420a6bd2eac6,989639,2020-09-30 00:33:19 UTC,500769405,500759405,false,10000,0
e9927d0c9b50a56f9fc56d8772d57671087b4ee84f48a9f31560100c28388d17,989639,2020-09-30 00:33:19 UTC,166104293603,166104291299,false,2304,989628
7bc01e923e1133d100190f8e40a04b8d96d9b4bd9ce59c615bcc6c620bf059e0,989639,2020-09-30 00:33:19 UTC,1000084954,1000074954,false,10000,0
273fe26ad29b29cbc49626a2523c67d8de7c1b2be9e28257becbcc0faab49725,989639,2020-09-30 00:33:19 UTC,280884601,280879721,false,4880,0
9c8507dd8f679e93a486d4b1efe637985beada4dc08f6d9f1a95ac0761533af9,989639,2020-09-30 00:33:19 UTC,602308146,602305696,false,2450,0
60726a60dd49f121f0a398ee1140119e91ab1075152aa66251d919dd081f0806,989639,2020-09-30 00:33:19 UTC,14882559,14876106,false,6453,989628
20e6b888b0c157b2aae8cf287f9fc518a39dc41b41be1e5e3ea0eecb0540103d,989639,2020-09-30 00:33:19 UTC,148529332,148526372,false,2960,0
e1909c3e70a08dda2f5f4be07d3b20ef1d193db16f61c3f35848c948c376545d,989639,2020-09-30 00:33:19 UTC,1537226048,1537177701,false,48347,989628
2c728c69fc6290a79f06abd9d9da399f11f86798710dc95706c96f743345f775,989639,2020-09-30 00:33:19 UTC,142193264,142190304,false,2960,0
d5421c514090971c556faa61ac1ef18d8196e9764494272f3adcc8f7832679ea,989639,2020-09-30 00:33:19 UTC,546577133,546559795,false,17338,989530
0174bd2a3a1a3f2adfd4dea8ecea88516cc28d08536eaf916fc61cea79726e20,989639,2020-09-30 00:33:19 UTC,676262599,676256599,false,6000,0
f082f450c42d7ddb8f3d86b721a39846b1fd696f4475247a87d916dca8aaa9e1,989638,2020-09-30 00:27:23 UTC,21905443630,21905433630,false,10000,0
83d20c7eebd62c4063fb9d18439b8f00932a4ef87adb9aec4c90a87c8f3134a5,989638,2020-09-30 00:27:23 UTC,76820082,76817632,false,2450,0
607a0b5e69b377bc68a498b86ede57e66b661d7d805990d2e90ac512222dcd49,989637,2020-09-30 00:26:23 UTC,22213789219,22213779219,false,10000,0
d787bc15cb31a53911b15ae112c9163b6834dd07c523bc0bc3fd1d19aebac6a8,989636,2020-09-30 00:26:01 UTC,49797276,49787868,false,9408,0
87306136f4528217f390e688e8cfe08a0a4ddd6e2d9b2a5d7d2d1e9303cca11a,989635,2020-09-30 00:24:16 UTC,422268850,422193586,false,75264,0
24b9cd511e12d220a9aa3a58d4822f589233abef581dd833f24cff9de7f7bba4,989635,2020-09-30 00:24:16 UTC,22213799219,22213789219,false,10000,0
0ef4993383e3e2db461ee691ba39cc0d7972ab059e16a68fc2643dc26ea4ec73,989635,2020-09-30 00:24:16 UTC,49839714,49830306,false,9408,0
2fef56a4a593a61d3de988bf40718c388b8672a93040e43410c74cb7a163c954,989635,2020-09-30 00:24:16 UTC,77341844799,77341842449,false,2350,0
739047c6391ca51c4f2fd556091fc4847ca94391881b777f6d6011aba40c6f9a,989634,2020-09-30 00:23:08 UTC,194485967,194483007,false,2960,0
49a934d08a02dc0977e811886984ce71981ad03c2686b38ccf964fdf580ed944,989634,2020-09-30 00:23:08 UTC,49878717,49869309,false,9408,0
ebc9a89d299f30313a4cf8c5e37248ed82c5395d6c86a26c9ef089f357215514,989634,2020-09-30 00:23:08 UTC,50119329,50109921,false,9408,0
91e5990138ce087ff2497ac6282439b6e900c5af32e0595130148216c63ed77e,989634,2020-09-30 00:23:08 UTC,499980000,499970000,false,10000,0
6fbfaa553282075160970bd642ab7faddcca79c3d30593764286194478b49411,989634,2020-09-30 00:23:08 UTC,480827480,480823740,false,3740,0
07193077c4174d8e9d7acd5748a87442a113de99df38e23a9234027f376f45c9,989633,2020-09-30 00:20:41 UTC,22020011845,22020001845,false,10000,0
6effee9d0356132c0c8e27167b8c78e5931dc44ac6eb8f35ad0eac0d1fd1592e,989633,2020-09-30 00:20:41 UTC,499990000,499980000,false,10000,0
2fed03926a37ccee3e033e76f9db88ef1e88ec1940921c55c4a250eefe81f9ee,989633,2020-09-30 00:20:41 UTC,50224578,50215170,false,9408,0
2cd1275ec2364401dfb8218c657cf273403ee0082a93ff5e30c983961650215f,989633,2020-09-30 00:20:41 UTC,187625860,187620000,false,5860,0
2c1325fa85b33edc9e26088290a3eb79f063e8be06f510f47df5b96f330851c6,989633,2020-09-30 00:20:41 UTC,77451848235,77451845885,false,2350,0
30e21d4731d6b02e47ff8b202699c6c51b77900ff2f2870250e565cea40a2d4b,989633,2020-09-30 00:20:41 UTC,1537969587,1537926057,false,43530,989557
bc51f154e1e6f0595bb15cd12419b036944673228c3db633459e899a398e330c,989633,2020-09-30 00:20:41 UTC,547140873,547122603,false,18270,989622
2befc372add49a92978ce2419447b4b457d3bc4b23273723b0d4e89fda2dd796,989633,2020-09-30 00:20:41 UTC,500009405,499999405,false,10000,0
2cd40ab676de9bfdcab3c6f54d7a0030ca6b601abe316d8dddb05864df649fd1,989633,2020-09-30 00:20:41 UTC,468442646,468440351,false,2295,989622
9fdcc166f5511a8901ce1e8e1282b8b7c20132974e5a9879cc88a40c84d3f618,989633,2020-09-30 00:20:41 UTC,96028422300,96028409925,false,12375,0
eef1b79a17e35bbc1a621a594fffe2cea6c0137942b47b931b13c60d9a22d509,989633,2020-09-30 00:20:41 UTC,50181453,50172045,false,9408,0
96598d8e3bed72b1f73f18b77e177c4b23263c2413fcefa676f6579c93f82a45,989633,2020-09-30 00:20:41 UTC,16259010000,16259000000,false,10000,0
ac8ad5af2343edc61c02d6554d3c447929388b70cb6be193568980e2253b9ebb,989632,2020-09-30 00:16:14 UTC,185964385,185954385,false,10000,0
99cef1ff900146037583d9ed451b2fc2bb3ef43db223924124216f45d5f89bcd,989632,2020-09-30 00:16:14 UTC,1500288261,1500278261,false,10000,0
104ac25c8f33d30ffaf8654f3ad77da5e1ee6e876c19152c184d935191020a70,989631,2020-09-30 00:15:20 UTC,500000000,499990000,false,10000,0
2c7da3fb9a2d1d4813d47d9533207882d1b710ac8c931de98cc0b5d7037a6d6f,989629,2020-09-30 00:12:33 UTC,499990000,499980000,false,10000,0
16910a4068d15d0636728d699da62c779b3e87fb00245e3a3e2abb8638085f70,989629,2020-09-30 00:12:33 UTC,8821756398,8821752658,false,3740,0
f1074ca4910a0d680f8326ec47ba7450d712ad9843b8589ed391fe301cd1f7e6,989629,2020-09-30 00:12:33 UTC,185991290,185988840,false,2450,0
26b3906116beef0d0ae2ed183e754f1bfa7279e5b135a95b523ef997e756f916,989629,2020-09-30 00:12:33 UTC,403947052,403934772,false,12280,0
99c28e7aa9e7f2a74886096222783eec659e5e14094a53f1f48b0e46b72ed6d0,989628,2020-09-30 00:10:57 UTC,50000000,49994000,false,6000,0
e7d29b51a1092dbf32202927a8116b8f46f5ab508faef9ff329a8f48a0937e2e,989628,2020-09-30 00:10:57 UTC,780967975,780959505,false,8470,0
e6fe95e6f87c365985d36eef7d180d3f3ca5790a8b90b79ae0e3632fe4771c6c,989628,2020-09-30 00:10:57 UTC,148743622,148740662,false,2960,0
29cc95caeeb2d50080ddf82e897020992d4286fa816530a63ca8398125aae10e,989628,2020-09-30 00:10:57 UTC,1538981502,1538928413,false,53089,989617
ee977eb948f2db85f39434a88dd6e47ed87c6aaa73dc09d657e96881ce3260cb,989628,2020-09-30 00:10:57 UTC,40000000,39997464,false,2536,0
656ad84165db1e2a4d74279499f8482729d4df7159269f26abda47b5dc3d7738,989628,2020-09-30 00:10:57 UTC,277110952,277090062,false,20890,0
0a9e52f7040937168513e01a2d81adb2cec29b22c29fd78c77153a7d615c7448,989628,2020-09-30 00:10:57 UTC,547462943,547444363,false,18580,989617
adaf45328ae127495d70817b223f766edb4d9527985daca648be3d38db45dc51,989628,2020-09-30 00:10:57 UTC,55999970000,55999940000,false,30000,0
dc6f18a1b704c7dbeb2e51a0f569da8b0af04a2a57ee3f30e014609e8570bae1,989628,2020-09-30 00:10:57 UTC,33343243192,33343240932,false,2260,0
80f48126d7efc39b57905f51dd3ffafbc121c1ca4fa663dde02362a8d1122340,989627,2020-09-30 00:08:04 UTC,500000000,499990000,false,10000,0
8614064782238c90afab47a898df6b76b39ceca7aa75d6c087f1619bf1e2a583,989626,2020-09-30 00:07:57 UTC,500009405,499999405,false,10000,0
e1790d072f83fc27a7d7e4982210aa449e6f59fdab945524d4e37f04b53a6d0a,989626,2020-09-30 00:07:57 UTC,2002993836,2002990096,false,3740,0
f8e2bbc17d5578877e34fcfdbec8128fd5f655802b97b7631da2c9a738c5ff50,989625,2020-09-30 00:07:25 UTC,50277667,50268259,false,9408,0
5eb240faaf1367890b50fe6fa7bb33e5206a7b2dcdcf50e61feccd09e0992478,989625,2020-09-30 00:07:25 UTC,1999995938,1999993634,false,2304,989613
626dc1e219a77b2fccd334f4a595314babca9e88ea52836cc0a9a8f4f42fc84f,989624,2020-09-30 00:07:22 UTC,16003153811,16003143811,false,10000,0
ed80a39032a8f04f1fee9bbd3b5f1feb40036de3cbcffb86a613e7cf1f9876be,989623,2020-09-30 00:07:11 UTC,1000318261,1000308261,false,10000,0
cc678ba981b3fea7e87c3bc063b1def52edc947406a75291ae278f5964fca042,989623,2020-09-30 00:07:11 UTC,142691808,142616544,false,75264,0
ad6cd91834e6ac59b4b46ffd9bbcefe66ebc2cec164c9ef9f21d452647622960,989623,2020-09-30 00:07:11 UTC,239714533979,239714523979,false,10000,0
1848fd679c00fff09bcc6ab8e880bc5870dacb6f5d54b3c0131810518216e9a8,989623,2020-09-30 00:07:11 UTC,1995184151,1995181701,false,2450,0
caccae258ceb7568ed6210e5256b1afd7cf51f624c7858333cec0b6a55460c30,989623,2020-09-30 00:07:11 UTC,5500349291,5500339291,false,10000,0
81f059c185cc0d743e635c4a62722d09c48b32402172e73928dde943d28252ce,989623,2020-09-30 00:07:11 UTC,1500260864,1500250864,false,10000,0
ef57715678d450e29d7f04232ea2d227745a012f0fe5acdda346afdc045d8d0b,989623,2020-09-30 00:07:11 UTC,2000254835,2000244835,false,10000,0
96eb681b4dde2d1b40bd43fbd11af8d3812f77df7b57008d2d0012cc76ff5fb9,989621,2020-09-30 00:02:45 UTC,1000328261,1000318261,false,10000,0
5f3e7c81c69e743efa841c9b00625e533384ba5b9408c48da6ab3da2a72e00c5,989621,2020-09-30 00:02:45 UTC,500008780,500006476,false,2304,989610
a9bdce8b33542c0da43c9bebf4d3f9e0b559a49d6d4aafa4e0fd4ed801a0ab0b,989621,2020-09-30 00:02:45 UTC,500039611,500029611,false,10000,0
7af01d9331ab90eb81707a98ed54161172388c51fe6785924284d2567f0b2a46,989621,2020-09-30 00:02:45 UTC,50349968,50340560,false,9408,0
9bb818aea68e12a1c249c45ca639741afd7eddf65d9b677eaafc7010f6c8a51f,989621,2020-09-30 00:02:45 UTC,108760881336,108760879040,false,2296,0
84909ed0e1418125d540ebc3dc64e278b990752ab41c297ed4110f82880655fb,989621,2020-09-30 00:02:45 UTC,50625898,50616490,false,9408,0
7db808c7cda013c6d45d95948a3bfd3da2c298586a88aadeb96424b499358f30,989621,2020-09-30 00:02:45 UTC,740727997,740720014,false,7983,0
fbd5c01ddfe8da419bcf7129748e1de9a90fcfa049f4070fde26ed09a61a60e0,989621,2020-09-30 00:02:45 UTC,698404831,698401247,false,3584,989610
124ec237d103d055a54ce2c2a7f0143e9b6c3c5b380c959eb35345c68df2efcb,989621,2020-09-30 00:02:45 UTC,29999210,29993716,false,5494,989610
a5f4fc38bc2f49431896e70ce57fed393be0d8be6074c1d52eb7869f2241460b,989621,2020-09-30 00:02:45 UTC,100372775512,100372763137,false,12375,0
bac54e8bdda587fa6ba8205fc886cd01a5c3703d4e179bcb0058097856e9e07a,989619,2020-09-30 00:00:21 UTC,1539696331,1539649922,false,46409,989600
0f9f376848e2c99baa25e60a1ec196a9e42cb92744169ae3d4e065dbe13d91bf,989619,2020-09-30 00:00:21 UTC,10000,0,false,10000,0
0d5136a5b8634e8fbfe9c2e8331f88d824a7417bd7168caa685eefda3ddc6bfd,989619,2020-09-30 00:00:21 UTC,547903437,547883540,false,19897,989530
21df2b99066749a327d58633d890bbfbe686fa791d3c14cbece96e184652b91a,989619,2020-09-30 00:00:21 UTC,5764826231,5764821894,false,4337,989607
b05f6a1cbf894844fb5278032c882f7303c386c724b7a694ffb8bfb0646c9418,989619,2020-09-30 00:00:21 UTC,142390167,142387207,false,2960,0
5615fe04dd1f46216a78d21dcba9b70d8d098a0773d569ff6e89e17ebb125023,989618,2020-09-29 23:59:55 UTC,100000000,99997570,false,2430,0
603f3774e876647cdacdec99bf7056fcc1b4c8a7bdb6ef7cc9125229da219a39,989616,2020-09-29 23:59:23 UTC,50657920,50648512,false,9408,0
6c2bc4e6c1b85c350b1b7b44a5756da272cdbb058399a953d565453e3d8ec46f,989616,2020-09-29 23:59:23 UTC,99675025,99672595,false,2430,0
8f56813a96e658947a5728bae9bbb82a0cf76ad698d808bfa83d9ccd9e4c1a9a,989615,2020-09-29 23:58:30 UTC,56417,50057,false,6360,0
149232682f73eb0d99873c029b02c5dc6e8d8477b72bbd606c721856b5afd8d2,989615,2020-09-29 23:58:30 UTC,7923160137,7923156397,false,3740,0
29230c390c4f28f2623750f3e6b90ce8ba997c52c2701f1a9144b0eec977948a,989615,2020-09-29 23:58:30 UTC,50921991,50912583,false,9408,0
5e8a7ed7696027156a50221470e8fbdc78c36bd7ae83dfa7d28e83a924a2d51b,989615,2020-09-29 23:58:30 UTC,194681001,194678041,false,2960,0
09c0393763bde52d98391a11878da3a6e47ae96c21c60f9daab8276ce8196908,989615,2020-09-29 23:58:30 UTC,10000,,false,10000,0
dabb25510d3b14ba101c97a1fb3201d804af5f0e990396164113bbe01f661c6a,989614,2020-09-29 23:55:38 UTC,15679592176,15679562176,false,30000,0
7544200843fca661e1c0b8638bd58db080f903ba882f3dea6dcc69c8ca2901c8,989614,2020-09-29 23:55:38 UTC,239594300,239591850,false,2450,0
2aff4787816a79a1727825a2fe297b0cb602d2ca40114f5a7333affd32f71beb,989613,2020-09-29 23:55:07 UTC,51159866,51150458,false,9408,0
40a601ed0c012e91d7969dcecbde2f48bb67ec70fe1ded0d0993b06a7bbc5958,989613,2020-09-29 23:55:07 UTC,111712404676,111712392301,false,12375,0
345328156c97b93bbd022ac4701da387db61a788cfef0827366ebe4ad56aa93f,989612,2020-09-29 23:53:42 UTC,615338000,615335464,false,2536,0
1fce4099e277b4318d1fd1a710ddf4ae0dfc458eb1952bad24004b43355133f7,989612,2020-09-29 23:53:42 UTC,354767159,354764709,false,2450,0
98f77db5518e665d9ece4b03253fb9a60b53d211d27154e1269fe2a8baac88b2,989612,2020-09-29 23:53:42 UTC,7893688000,7893682000,false,6000,0
3880b9f2db407c0d1aebcd0cbe477cf16657348c189ab31dede20abc38468f36,989612,2020-09-29 23:53:42 UTC,161712417051,161712404676,false,12375,0
e32c46cff90fd7a4f693a7988cc12c350aa484dbc5e242fe8cefb32f42ca65d9,989609,2020-09-29 23:52:29 UTC,148897907,148894947,false,2960,0
85146b3c8af7c6145baf1e9608b54fd3fff7c43004237d69a068a1d08a275bf5,989609,2020-09-29 23:52:29 UTC,615830000,615338000,false,492000,0
9178ec921fea4c3f2bd9db7911ee1930aa0fdb6d130d16b8b5b684e2412610a5,989608,2020-09-29 23:51:39 UTC,176898188,176892188,false,6000,0
3437ebd3d597caa9ae0408518b3ac30324cee9c5a439be1b1f24aed3d52233ae,989608,2020-09-29 23:51:39 UTC,36326,26326,false,10000,0
c92ea7e4f1f497209e9f614e9bae72e60e9438feb99ea22a65a3b00f962346ed,989608,2020-09-29 23:51:39 UTC,548509711,548486617,false,23094,989597
4510909eced9e8119f41d4991de694e24b384cc704784038df37992c5115f767,989608,2020-09-29 23:51:39 UTC,400000763,399990763,false,10000,0
5feb1723d4be7f72358a53fa9c4c5cf45113159173fb56b47d271d23726c1c39,989608,2020-09-29 23:51:39 UTC,1163741830,1163739380,false,2450,0
08f2cf4af7965a1f6d151b5b6218e03ca0169071ff0acfccfc55660851903ff8,989608,2020-09-29 23:51:39 UTC,142601220,142597953,false,3267,0
2783636ebef9c5d3a320c82c85937268e4b1c3030a033212225a5b480400cc86,989608,2020-09-29 23:51:39 UTC,1541020476,1540966700,false,53776,989597
427de94c8f1859324b895034be5d0faa5471818a11ce7ea4fb101bdec2376e7a,989607,2020-09-29 23:49:05 UTC,194836285,194833325,false,2960,0
36584e5471c3c1dff61c9a08a764f90d6566802f789dcfc6f9c68fb46349b1bb,989605,2020-09-29 23:48:08 UTC,2225203207,2225196230,false,6977,0
6b6d26f9bfc38a27d96b648b3b00a5cfe0f225906ab5fd51916c509834d5012a,989604,2020-09-29 23:47:52 UTC,99700000,99697740,false,2260,0
cd784d66b9522ddd706136225d579b0398b9722d8dee918c6e32339462335b58,989604,2020-09-29 23:47:52 UTC,500018780,500008780,false,10000,0
97f85a3db29ac7ea677f69695c917842ca921f31782f62436d5b107cfe550423,989603,2020-09-29 23:47:17 UTC,77575164788,77575162438,false,2350,0
576acfdf90e304b83cf1f630946e2c642235a11901a5f40a4780b9bbe17f3ee2,989603,2020-09-29 23:47:17 UTC,500000000,499990000,false,10000,0
08553b912c31d79ddea29a9557d842a6a78455d5ce06dc207ff12dd57cea922a,989603,2020-09-29 23:47:17 UTC,1185774148,1185771844,false,2304,989592
50f64f3ab288440d94f5f6922cdbe162c4b4cdcc37840aa4496656618ef4c5c6,989602,2020-09-29 23:46:01 UTC,702700741,702692758,false,7983,0
652be6c5ace36f46434da3bf0b3f99bc1f46dcd77823e207c8fedd173962944e,989602,2020-09-29 23:46:01 UTC,282522665,282447409,false,75256,0
8ee017205ca25df6dee6cd3ec55b3c422037815657ef14d84a41932544a1df4d,989601,2020-09-29 23:45:07 UTC,7082163878,7082160138,false,3740,0
f363ca45e3d721d5b5720b2a83982137787b9668e546af06f8b6ab617f77b270,989599,2020-09-29 23:43:50 UTC,700010000,700000000,false,10000,0
7478a82ea3e51abb7fa8edc16bb59beff96e7596c929d679eb717e688be74220,989599,2020-09-29 23:43:50 UTC,149099083,149096123,false,2960,0
c9e21c8ae8a4343ad1286bf66f2d7904e7c6a7aa77b8dc413c4913f6b6e732b8,989599,2020-09-29 23:43:50 UTC,13692235539,13692135539,false,100000,0
c6f269cbf1b1349ad4be88a300ae493fd1ee55c9061097a830f683ecabd8edd5,989598,2020-09-29 23:41:56 UTC,113089878036,113089874296,false,3740,0
9808ad06e1cfdcdb7cf730f90aca9302fdbfd6d036e3ce0647b0f16508440146,989596,2020-09-29 23:41:06 UTC,142758719,142755759,false,2960,0
fcbedb6c4ef93d94ff6039f79955889035c7aef492180a9ed2a946502fd1a843,989595,2020-09-29 23:40:28 UTC,549893607,549874351,false,19256,989584
17bf0f66f46dfe685d17ca7cdc360cc61e32fc5412920263aaafe11dc0227951,989595,2020-09-29 23:40:28 UTC,1542386771,1542333005,false,53766,989584
4d0e75762756084fa079b03b29835003646916106ea9a92891b83beff3b74537,989592,2020-09-29 23:39:37 UTC,160763128056,160763124236,false,3820,0
4b5ecff2d0cc8ecb1918bdc7274c2437a681414900a398d2f65ca6d93e99a52d,989592,2020-09-29 23:39:37 UTC,6500918178,6500908178,false,10000,0
2b6d1450415bb2254b4d480b7defdaaaf41c53a328fc981f890fd47d7d297f51,989592,2020-09-29 23:39:37 UTC,209842,203062,false,6780,0
d104e40bfa099e19a0080f8c129f57f1a332a24d1f7013b11e86f570933363fe,989591,2020-09-29 23:38:06 UTC,195134555,195131595,false,2960,0
4023cb75537644df6f1c56e3d5fa3d9b9fde5f90bec56bace33d79f4590b5370,989590,2020-09-29 23:36:36 UTC,6902583811,6902568231,false,15580,0
17b9167ce2649d87ce5848682c4145626a01af764fc76c2f1423d141c8f9a713,989590,2020-09-29 23:36:36 UTC,100000000,99997570,false,2430,0
94ed1f7f8405669f5ce35dc7b25e4c3eb4729d3653fca6e9b686d77b0a61a038,989589,2020-09-29 23:35:53 UTC,51486809,51477401,false,9408,0
68c9bdd71fe231b6d324c83db3a5157ba821254ab16a9e40c3f0954bfdb983d9,989588,2020-09-29 23:34:56 UTC,149294570,149291610,false,2960,0
762acb560438680a215c14aede944f56ee2fa28f3e6d318dba54cb468c85c9e4,989587,2020-09-29 23:33:10 UTC,13434958824,13434956564,false,2260,0
595985eb16a5bc1f4246c498e8099a45ba7cb233e99a41cffa8fde4242182cd6,989587,2020-09-29 23:33:10 UTC,1235830975,1235828671,false,2304,989576
cee5e62eed030c74fce1f89d274c6cc5be01904fbce4d2bf0da0e8dfe48c9450,989587,2020-09-29 23:33:10 UTC,142951796,142948529,false,3267,0
d5f0b73dad07d119b8684ad73da7d60e8c3813a563e04bc75f9f83bfe6d1aecf,989587,2020-09-29 23:33:10 UTC,15495198,15490110,false,5088,989485
8175563a7dd6f0598cd003bb599775363be169c2fb890ee553db43cc6eaf052b,989587,2020-09-29 23:33:10 UTC,865394000,865388000,false,6000,0
47b19c1257f70a19594cfa031e5d22865f280bb5655e2b5e70e9e2278c68e1a3,989587,2020-09-29 23:33:10 UTC,189452883364,189452879544,false,3820,0
c20c874a0ac47fce080dc327c47ec2ee5de12c4ae56a8469063497cec70e2de5,989587,2020-09-29 23:33:10 UTC,500028780,500018780,false,10000,0
1a05afb11806934c534f4472a20cac0c70a5c0b1e0037ef44497a8caff64ed04,989587,2020-09-29 23:33:10 UTC,51518343,51508936,false,9407,0
0dd4262a8a0217821e4c744d00647a39111dc2bc43bbd3fe6843b5c8e0b004fd,989586,2020-09-29 23:30:06 UTC,10000,,false,10000,0
5677f75ecc08ec96e74bccf3edceec9be1f62df1c62320ce599a1042042a3582,989586,2020-09-29 23:30:06 UTC,915400000,915394000,false,6000,0
936e26f71e092562f1230116bd9fdd00d47a60efd9d2b1d6f5de80e26d835ae0,989586,2020-09-29 23:30:06 UTC,201334198,201315017,false,19181,0
0fe1e9683eca9c6bc9da2ed6190786fe014cbbbd5703ce238a5ec84a55029dc6,989586,2020-09-29 23:30:06 UTC,1543369676,1543324570,false,45106,989575
ac68b557c4a7a863b9af5b381975143972e4fae3459a60d3bd73ef7aa214ab50,989586,2020-09-29 23:30:06 UTC,550197663,550180007,false,17656,989575
a0552ca80ef94d256ca4d4f86ea98b26e42a082c4978a2ce9d272f55569f3214,989585,2020-09-29 23:29:11 UTC,1393855018,1393779770,false,75248,0
060557f71c008360c42641646276f79c050bf2c0c242282375b612174676324d,989584,2020-09-29 23:28:36 UTC,19336591340,19336575760,false,15580,0
5fa7ed5781963c4b1b9b875562360a3c002d1959e81d7ea554dd2e31d5c8cae1,989584,2020-09-29 23:28:36 UTC,817966963,817965043,false,1920,0
c7807a22247cbba31d4f39ee278f8babaf87c41b3949375206c1663ab2173d3c,989584,2020-09-29 23:28:36 UTC,774447534,774417534,false,30000,0
c0fccb046f2085209a17b902ba90365a872df68ae5dc6436734fe80653fc6c70,989584,2020-09-29 23:28:36 UTC,22554864280,22554848700,false,15580,0
c3f64a79152fbe0ea8a34f736ac6d963cc0a5f04b61624e62d83fc06c7d26ba9,989584,2020-09-29 23:28:36 UTC,7996791739,7996776159,false,15580,0
b83ba76a9c68f4258a5ba6801c55b44ce915af6fac35a9fd567c0ad0adcbf038,989583,2020-09-29 23:26:16 UTC,490014895,490012445,false,2450,0
4f46eeaa40225819a9cb8899cb78c0376153318270344315f961be32497f5a53,989582,2020-09-29 23:25:50 UTC,167054244498,167054242203,false,2295,989571
338c69ff73c9b1dfcf304b00ca3774d621f35ed777430d0960a9759c2790132a,989582,2020-09-29 23:25:50 UTC,195277869,195274909,false,2960,0
6bf5dd74c150bf494fe4609e0ec2ea6e847a6d68b57ac5551ffae8bfb86f00d0,989582,2020-09-29 23:25:50 UTC,874477534,874447534,false,30000,0
b4a8a045d194ddedfd25a08be76e9a8f0a875755ef7139d53d3f0ac3d2753ac1,989582,2020-09-29 23:25:50 UTC,110200470,110188470,false,12000,0
152db7f52886d07f9439c078735e177ff73a3d1366691a258aaa42d6908f7a70,989582,2020-09-29 23:25:50 UTC,510245512,510243062,false,2450,0
7e1d547b9f242555609dd59dab0b10c2621337de163440bcbd94e5b8427e802a,989582,2020-09-29 23:25:50 UTC,21116489789,21116479789,false,10000,0
79ea1a125a77406da0f73f284bd99a112dc46bbdd58f275c385684b679e17430,989578,2020-09-29 23:21:28 UTC,499982293,499972293,false,10000,0
203c4fa3215a5dd88906a8fa37215d833e90148ac9febf9508604577d6976d30,989578,2020-09-29 23:21:28 UTC,550612073,550595752,false,16321,989566
e34ddd3f55c5f679736dca7fe394e365e3ba832e123bb9fb1e6d594acb119060,989578,2020-09-29 23:21:28 UTC,1544347648,1544298440,false,49208,989566
058613ffd97d62bfa7fc4546cc67f12b370448843c5bbb9c74b7fa7a6ae7ee31,989576,2020-09-29 23:19:17 UTC,149561652,149558692,false,2960,0
c18957bb13d3355a0c04c2216e40fa62b846b2cfb56bd1634be92c5a8cb72c30,989576,2020-09-29 23:19:17 UTC,936167618,936163878,false,3740,0
2cb2cd13cc8b646b890b92a16051a4d1833237620c0246c41d71f42bd8e96895,989576,2020-09-29 23:19:17 UTC,151608315,151606055,false,2260,0
a1fdae50586b1c273632340f8d786efa508417007f0c7cfdc82e7f8738c5ae7b,989575,2020-09-29 23:18:16 UTC,1315194614,1315191990,false,2624,989564
be9db2b681a75b3a13da0b018601e4f47b17ba254a84c2eef72c00df860558e0,989575,2020-09-29 23:18:16 UTC,1662163390,1662147810,false,15580,0
630ebccc23c3b70644fcd9c888f42c54cb95c76e7ac0b6ddba8a609f839d64ab,989575,2020-09-29 23:18:16 UTC,97810334,97786121,false,24213,989564
96a9700b9d841420269b9353a1c9185cb532c26a974a0d96f1ae8d0689e027a8,989574,2020-09-29 23:17:03 UTC,19214091689,19213891689,false,200000,0
494e38ced12142ed6257bfc23090dee4ae6665a5f19f956c9e595e39bed3b818,989574,2020-09-29 23:17:03 UTC,4515715552,4515699972,false,15580,0
4a09deac85364e0e8ea1bdabf5ee1982be98926f406ea12289035711135ffa11,989574,2020-09-29 23:17:03 UTC,19401599299,19401583719,false,15580,0
3225b532c30698895f766e200d6b46a567632a01dadcae038cb44a294d8ae9f5,989574,2020-09-29 23:17:03 UTC,24892785200,24892769620,false,15580,0
8eca9577c7a2ffeea414caa7bf7f6645994a3cc26db8d8392fd7ca74f931b6b4,989574,2020-09-29 23:17:03 UTC,151338877,151336617,false,2260,0
7256d84af70fe4c96b2c5409a8c94450e62bec668c217aa1b48eb588d5193a42,989573,2020-09-29 23:16:12 UTC,72583,70133,false,2450,0
6dc8de1f9e9adc836e1285628156c34f9ec068e931425c90e7cc08deded04b4b,989571,2020-09-29 23:14:38 UTC,51554538,51545128,false,9410,0
eb65341abc784f1880af9044e917a61ae4228b12490748537215403b18eb5bc7,989570,2020-09-29 23:14:26 UTC,143204090,143201435,false,2655,0
4b885ceb859392cec8943ec7c6a65f1f070c2ca659b09ce37bc545711ca46140,989570,2020-09-29 23:14:26 UTC,150650823,150648563,false,2260,0
aed88bd0abfeb748ce093e29aba7cc4046a28d98d8f8b1a7bb7fcebb1d6d49d9,989570,2020-09-29 23:14:26 UTC,1251403804,1251400106,false,3698,989559
5afd868be4f6a321f63912bda4fde6dc8be7f9a532b61042e1ce7522ff36ecab,989570,2020-09-29 23:14:26 UTC,168554246803,168554244498,false,2305,989558
716bc7c9878fa5ada7f8bd9a4c343cd1ec94d0e3918e22e4df8c432480931824,989569,2020-09-29 23:13:27 UTC,1249980000,1249970000,false,10000,0
b3333cb4876ae5f14d014a7f31e1cc73d6f180012ad19480a792dff11fcb198a,989569,2020-09-29 23:13:27 UTC,32349000,32347854,false,1146,0
365170b35c5419ec8b13a7d12932404ee92fd4215e8a621cf670698868f5b562,989569,2020-09-29 23:13:27 UTC,21971638,21956865,false,14773,989558
9743243acc6049ca4848dfee29fa8585c60703aa2b9ffaf72f7964263080e34c,989569,2020-09-29 23:13:27 UTC,499992293,499982293,false,10000,0
017b131942d86518ece8d92b2812cde4b4f38e3e1b182804149cfc476edb8afe,989569,2020-09-29 23:13:27 UTC,20937823603,20937813603,false,10000,0
2026a1e23376befd6ed6da48f67dc5096c31098f6dd1488a461e3b8ee4449961,989569,2020-09-29 23:13:27 UTC,142740835,142665555,false,75280,0
8a3412d23847ea0e289044fb05f2b125bd1fb8296758a35e21afcfa666075efc,989569,2020-09-29 23:13:27 UTC,492870930,492867190,false,3740,0
5ea2603f143789741b27b71576d055d7113207324d1072fecf2d79ea366efc33,989569,2020-09-29 23:13:27 UTC,1074004228,1073994228,false,10000,0
5c90e8c185d6c56820a094531b2e320d5a1d2f13d0c8e5576a1d4a791c261a77,989569,2020-09-29 23:13:27 UTC,3680219893,3680219755,false,138,0
8d4a07fb6610b9ae2c820502c7307bc557aa377627b47377c5ee83c8f069ffdc,989568,2020-09-29 23:10:47 UTC,500048360,500038360,false,10000,0
c21cc60905d3f4e742b139eefd17aa07d33f9d1ca06a3da6b94597cae3e289bd,989568,2020-09-29 23:10:47 UTC,551083646,551064723,false,18923,989557
f0dabbac6f90e2b98c564924e6f5a4f5ab809bfc21210b2bcd3266470c89a21f,989568,2020-09-29 23:10:47 UTC,1545376594,1545333111,false,43483,989557
7a68897dd533519fa3dcdec3804a2b6799006d814d663395762f8275d1333f76,989567,2020-09-29 23:09:52 UTC,500000000,499997740,false,2260,0
9d235ff526cfb3f81e8e5e76b6d7c89ac270a88e03b60382d859f42c0e2e0c60,989567,2020-09-29 23:09:52 UTC,500002293,499992293,false,10000,0
a2e5ab0f0ffcbd0388a082fbe2172336a2294dcd4e23ca7457b5178fcc92b0d3,989566,2020-09-29 23:09:04 UTC,31995,30849,false,1146,0
8476586729c18f6c949c3a4b086521d5bad3a88b8a2f3b9a27ceb54d47d4a2b1,989566,2020-09-29 23:09:04 UTC,152864063619,152864061269,false,2350,0
eed1b1c5430c53c6c6c7ed4f27b0437ae0d606ed6f8b4919d57032a9bf37eb93,989566,2020-09-29 23:09:04 UTC,628430,625980,false,2450,0
545bae4890940b2c424b800917dbc9d9b6200b0812cdf7b73649c7190af0d073,989566,2020-09-29 23:09:04 UTC,493501372,493497632,false,3740,0
9c96ef77fcf066bf63120aee8dbe33e2f91cf92c88ce6938eca2d77a47abdd27,989565,2020-09-29 23:08:09 UTC,1500156986,1500146986,false,10000,0
a473caf340278f50c5712086098a49e1fbe506bf7c8399644001a0f63ab4651f,989565,2020-09-29 23:08:09 UTC,51595943,51586533,false,9410,0
35744f8c8b32525dc9507b1f557fb1e338b361499ab38a776f65ce5d806aad99,989564,2020-09-29 23:07:21 UTC,492528541,492526281,false,2260,0
eb611fbd7ac45901c0e6f99fd8d4e7693b65a4eeb8c93500066073f71861a9b6,989563,2020-09-29 23:06:44 UTC,1500135620,1500125620,false,10000,0
c364874cac9a5b1d6f3a00c67f4c6f54a116953d903f2036f26d4d99bfeaa87e,989563,2020-09-29 23:06:44 UTC,10000,,false,10000,0
6d229fb10031a356865d3a7509382f0d57668bedd4e6715889bc99c9e0a058e4,989563,2020-09-29 23:06:44 UTC,79066,69066,false,10000,0
516b0f39900312e953d13e697829cb409167dc57e8b767cb492767c35ea9d60f,989563,2020-09-29 23:06:44 UTC,51660796,51651386,false,9410,0
26812c28b939316bf5d7f72489fa8cc2693864bdbc142854b873ac83e97d0b09,989563,2020-09-29 23:06:44 UTC,165806059983,165806047608,false,12375,0
83fc0fdac81d2eb3d4e59ca4610048b76d070b53e76c8fc9d995cf22bd908e63,989563,2020-09-29 23:06:44 UTC,994000000,993997550,false,2450,0
8a921241f85581ae05fe4520942879c7c488a0ca2bd6704d52b167df6ddd6a72,989563,2020-09-29 23:06:44 UTC,2000264835,2000254835,false,10000,0
c82432ab2e4e27d97f27b9b2d920aa703dfd917c72f6f72de00cc4726620104d,989563,2020-09-29 23:06:44 UTC,41938,40792,false,1146,0
0fa3b903b3ee0b0f8ef6913ee2233b9fec97c2071478d04f228951d599c28841,989563,2020-09-29 23:06:44 UTC,1999995053,1999985053,false,10000,0
54a1cbb4c483ab0ce36f0d14e360e03d90879ef3a3c38ef8cf7e843bc0418446,989562,2020-09-29 23:04:30 UTC,239774156528,239774146528,false,10000,0
d341b18b5b902179ffb20d4fb9c33dbb4a39f633b4199fe69435f15df81bc6c0,989561,2020-09-29 23:03:36 UTC,168925938688,168925936383,false,2305,989549
528483f9f08c1701fe61479f486d5c4fa278bfb224529c6811fa9802fffa6056,989560,2020-09-29 23:03:05 UTC,206181381,206178421,false,2960,0
449f34124b839e72ff27608900abc6736d0bfdf6101ec5758e3d68b03a9eca60,989559,2020-09-29 23:02:16 UTC,500058360,500048360,false,10000,0
f4f3744c07b978f487c41b77a33f7a5532e58ec37c7924653be7d58f37e2ae80,989559,2020-09-29 23:02:16 UTC,100000000,99997550,false,2450,0
f244bde45be62e907a99879404178768e769dd9955247510970d4bfd1ed89b03,989559,2020-09-29 23:02:16 UTC,1341482397,1341480092,false,2305,989548
3268d3b66cd67751a7829abe02410562ce0f9fc568271016a5bab611b9b7cad7,989559,2020-09-29 23:02:16 UTC,799488699,799486074,false,2625,989547
2de1f39e3089ec9a14870aeb219b1498c1dac4262a856f7e4ed880eacf7131b0,989558,2020-09-29 23:01:07 UTC,27735556,27733260,false,2296,989547
0255491dffa7a4b41799b471c3f7f2fe17326ec1bb3196f88e4cfcb039b4c56d,989558,2020-09-29 23:01:07 UTC,171512864714,171512852339,false,12375,0
2365f2597127fd494dab31cb12cebf5431591d92cfed1725fd51b8994fbe571a,989558,2020-09-29 23:01:07 UTC,51882431,51873021,false,9410,0
f7ae35b412be001889e0f047d391dde1a4e997aec88f83ca412d43cc22713cc9,989558,2020-09-29 23:01:07 UTC,551727098,551707206,false,19892,989546
c3728d67698421b55f470c954448bff015578ff2b2195543dbd349e77f9f4283,989558,2020-09-29 23:01:07 UTC,1546403022,1546356603,false,46419,989546
227cedddaeff7674c89d9e9bacf784fc8b37c7a855ddceeeb4582783690077bc,989557,2020-09-29 22:59:57 UTC,5000000000,4999990000,false,10000,0
8b5f1b38c17186e925962538bfc7795a8e2d82cc5c21c923a193272fed95e905,989556,2020-09-29 22:59:43 UTC,175974811,175972361,false,2450,0
84f41b1c1c64229241801fda0dcb4eb06fc7e5778b662be1dca27dfd7ec02497,989556,2020-09-29 22:59:43 UTC,69711,59711,false,10000,0
95af9b4a86adb160e5ef92c5804cb97a457cc03055ad41e90c9801d75d141f2c,989556,2020-09-29 22:59:43 UTC,1301095547,1301095154,false,393,989545
7f460a986938fb87e3b4f3e152ee904117ea0993b3e9278f2515baa6c857d849,989556,2020-09-29 22:59:43 UTC,500068360,500058360,false,10000,0
6000eabe1b6b2a36dc9a5d47b882c8fbb924008bbef50e590aeaed3e6798edf8,989556,2020-09-29 22:59:43 UTC,1996185,1993755,false,2430,0
9ade48e7ac3849e78308bed75562d3594e53dc8cb87c3319b4a22d20c7887242,989556,2020-09-29 22:59:43 UTC,10000,,false,10000,0
783687bec23676ec382fd3c405ea47e55f12deddbe3fbbdef01b83f9e368adc8,989556,2020-09-29 22:59:43 UTC,52036805,52027395,false,9410,0
b5046812d41bab5d481d046231b7d1bb4a2c3efaf1274575a95e86ae9e248349,989556,2020-09-29 22:59:43 UTC,51996839,51987429,false,9410,0
ac87fe1965bed4d1747e7b1349f0edcd41c1f7e7e097fd6fc696240cacbc3527,989556,2020-09-29 22:59:43 UTC,18821861300,18821859040,false,2260,0
67676081090804257e41289d88327130900b9b7b66155977ff1d10c5244994c5,989556,2020-09-29 22:59:43 UTC,18168811052,18168801052,false,10000,0
e7a779c9c60c025a6f7df745e5b18f16f6eac833b2d352f9a4799f9bbb9570af,989556,2020-09-29 22:59:43 UTC,2397147,2391147,false,6000,0
b47eab0c7e20fccb88b012585bf261cdf1284f46152c709ae6d5c6903b025b6f,989556,2020-09-29 22:59:43 UTC,18000000,17998854,false,1146,0
56be5237db0cc3dfb2b89e51bf9a27d87971f797433abbfd0e38c2f7b163a4f3,989555,2020-09-29 22:55:22 UTC,169025940993,169025938688,false,2305,989544
6a3874335f30827f94e78071cc0b232ff9793547aa47d4c5115c833f31afd450,989554,2020-09-29 22:54:18 UTC,185987309,185977309,false,10000,0
a8cb41cafac2c58e4ab6613453b25c761d128fc47df05007ddffc3ab3b12498a,989553,2020-09-29 22:54:13 UTC,681226,672838,false,8388,0
fdf372f4cbe9b0f3b76caad9edbaa2bfba530a86caf0654359b7d139fbf61d17,989553,2020-09-29 22:54:13 UTC,8609059855,8609051485,false,8370,0
99b7383388cffc49ab106603afb11f7cb005f8925e2fdc706ba809b945153aad,989553,2020-09-29 22:54:13 UTC,151727625,151724665,false,2960,0
7e9e8bf8d6a98603428144c94dd701322b17b1a919f1576a23999f8cd47dbcc4,989552,2020-09-29 22:53:16 UTC,133912445,133902445,false,10000,0
ef279c7a31dbef5480a8c6945c33267b764ebaab19a62deacba1d903a4a3d622,989552,2020-09-29 22:53:16 UTC,155929989,155913605,false,16384,0
bf200eaede8ca0da7bfb9b32ad2dba5be5c063aa7523154b833597ffad153a46,989552,2020-09-29 22:53:16 UTC,253181766,253175766,false,6000,0
78fbe74b0b1a444f46a1494e6506fed85ba6eb82abc6be76007e607ac856c318,989552,2020-09-29 22:53:16 UTC,1547472653,1547425556,false,47097,989541
97d28fbf900f569fc7d523e7fc0e34dfa11266b338505c3201f52dcdb5a8cf93,989552,2020-09-29 22:53:16 UTC,34125068467,34125065677,false,2790,0
798f90268e16a86efc880603327abf3fc358da81a865f73ab4909662bf814d27,989552,2020-09-29 22:53:16 UTC,6042737,6040431,false,2306,989541
80a291b58724d3d9f94b94be9f90608769fdf5b3092aabfec5c5aeee5bcbe6a5,989552,2020-09-29 22:53:16 UTC,650000000,649990000,false,10000,0
cafc5a935eb2c7583d2007ecd53b5114f3a8f60221c3a5f9fa4ae11099264411,989552,2020-09-29 22:53:16 UTC,7143447,7133447,false,10000,0
a038f5cd978497ac7c75b7b1c09ccde57efc6e79617ae03f742ba5fcce2fcf9e,989552,2020-09-29 22:53:16 UTC,282599411,282524131,false,75280,0
0415e46a66d4fb56aa817bead21c0ec24b50874c4b9e730e2bdeac3fc562fcc7,989552,2020-09-29 22:53:16 UTC,253175766,253173230,false,2536,0
11136d851492d499837367b4a2d3139e740b7f60c0583ccee07a2a28fe1a18dc,989552,2020-09-29 22:53:16 UTC,1378553606,1378551310,false,2296,989541
89c76b56ed9004a41850013697c5e99b41f1104d26d88587fa92a55bb0c12fbf,989552,2020-09-29 22:53:16 UTC,552021661,552005608,false,16053,989541
be76d5618949a25c20c586a43433ad3ec055d9c56f49e821cbdef8dd02a61ecb,989552,2020-09-29 22:53:16 UTC,143516004,143512431,false,3573,0
6aa60af9198a55bf418b1240771960af036ee650b83bcda5e1300d56a020e8cf,989551,2020-09-29 22:44:10 UTC,65079568,65077138,false,2430,0
720cb2ffa130471ac6920e4cb7b3d94204d008d2def7552b7aaf21c15c0c0695,989551,2020-09-29 22:44:10 UTC,52126299,52116889,false,9410,0
e798f081535ff12d6de8e8e094f89a1b355cb723da020432261c5166a2a2e75d,989551,2020-09-29 22:44:10 UTC,69367015,69355795,false,11220,0
738ceb08394633cb0fd3f9e86e0ab8893cbd7a753660f72b98c5a747af90e7f7,989551,2020-09-29 22:44:10 UTC,1881069609,1881059609,false,10000,0
95d7f0efab8be360719606a826e7e746f3cb47bbfe1722c244e536e9e2d8311b,989549,2020-09-29 22:40:15 UTC,1548561561,1548513890,false,47671,989538
4e48ca66741f5386fb2f45bbe4dc872cfa73e6e4ed2d5c3080d2130df57e17de,989549,2020-09-29 22:40:15 UTC,552600742,552576681,false,24061,989538
743dacfda132a1cc3168e144695782bc5d304ab0133d8d3a526b90a55b36c592,989545,2020-09-29 22:38:10 UTC,9712876,9710446,false,2430,0
f9d06c31775e0afe41f7cbd2129bc4300fb474e89254569529039a57be4094fc,989545,2020-09-29 22:38:10 UTC,2304637847,2304634787,false,3060,0
05be08f215e53c5760f76b5acf627b8eb75bbf1130ca9cfbb0a07074a6328d44,989545,2020-09-29 22:38:10 UTC,899348690,899346240,false,2450,0
d26731119846828797b264e1be56f89e5e8e84601e09c405565e71ffd666b5a4,989545,2020-09-29 22:38:10 UTC,206402517,206399250,false,3267,0
d5af2a49df866e0a22a74638ef3965c7396f7ca59eccc92cbf47beba0d196614,989545,2020-09-29 22:38:10 UTC,4427632722,4427602702,false,30020,0
dd86c8532a36a914a9e5221fcabf1050339f378167f58580302645cf3ef25656,989545,2020-09-29 22:38:10 UTC,52157758,52148348,false,9410,0
fc6acb7fec51aabe451b7ef6d20596f24ec7010a29ddabdfdb3d55b291a47183,989543,2020-09-29 22:34:56 UTC,151877902,151874942,false,2960,0
5a8fd469dcdee055facc619a9c63c5bf13a12830482e2ff41d363db5efd95137,989543,2020-09-29 22:34:56 UTC,113077,107077,false,6000,0
472826e293bdde9cec31bcb3a9348ce03bf7fe6d9589fe0c8a3097f9bdc16793,989543,2020-09-29 22:34:56 UTC,10000,,false,10000,0
587ee4bf6c6f2292e4644c84764f4337f46370b720fedff304d898d8bcb0a9ea,989543,2020-09-29 22:34:56 UTC,142772346,142697066,false,75280,0
550e18a8cc69b5f943eb04b64ec61856a671bf4ec0b26bddaed7695988bf8d24,989542,2020-09-29 22:34:04 UTC,204025443298,204025440993,false,2305,989530
502af8127bfeb0fcf0ddd5c2f97bb877db82bbe5301dea568c865ae2c9b9f3a4,989540,2020-09-29 22:33:28 UTC,52270048,52260638,false,9410,0
6dc7a03d29e1640a4f27e22d55045ec8e6805165bc2a7c7004113646999fd350,989540,2020-09-29 22:33:28 UTC,866680874,866678569,false,2305,989529
0fc2baa54ff3f56213efc474474be71403f1b5158a8b17370800136bf55673f5,989539,2020-09-29 22:32:32 UTC,219980000,219970000,false,10000,0
e0ca7ed9821a88d0af346be32075570e9fece67bdf9cab1cbbe7844f109a9960,989538,2020-09-29 22:31:52 UTC,124176517650,124176515300,false,2350,0
1ea646c1a27cb3d7b033584b41a4901ac9f8a3cd4ab3e48e493a63dca72623cf,989537,2020-09-29 22:31:41 UTC,143793459,143790192,false,3267,0
110700a1401582d3a45a9cbed9b0abb3372c485a61bde46f555c0e9ec3d1f069,989537,2020-09-29 22:31:41 UTC,1549643547,1549596521,false,47026,989526
d5864a6c5417e03ee33a2701513b032356fc761b9e448f4484fdd6b9d1b3b04a,989537,2020-09-29 22:31:41 UTC,553305970,553280973,false,24997,989526
9be9ea081ae278fe6838df1329b7a0d429cef563335bf1d9970e2dd1a35b9d29,989537,2020-09-29 22:31:41 UTC,206745224647,206745222023,false,2624,989526
c90166d2d70d5d5c3c64b70abb0aac950ad3052a07b9c7678371ad3b5f1967b6,989537,2020-09-29 22:31:41 UTC,9809904,9807474,false,2430,0
88040c826f622c328e9a4b07cd68308de7deba1f48ab2dccae3f3f3c73f6a90d,989537,2020-09-29 22:31:41 UTC,983477973740,983477971480,false,2260,0
4ec45aa4d507d2d7ef7eb24e18a79a44378433646c902cabe2ff8ac589430deb,989535,2020-09-29 22:26:28 UTC,206625870,206622603,false,3267,0
a5c8b7da329e183cbe7bd8af02ab5b5d8dbb1d50d514ccea3b1d3a2c054c597b,989534,2020-09-29 22:24:18 UTC,1455900000,1455897696,false,2304,989522
7a9fc1c7358637aeba94f8adfe5e60efac2b43deb313c679d7f0804d02ea138d,989533,2020-09-29 22:24:08 UTC,9903147,9897147,false,6000,0
834ce3be21a3a8e562db9f2caf0ea1bdc4741d01a285ff2502fa62892111f21c,989533,2020-09-29 22:24:08 UTC,52331258,52321850,false,9408,0
fb44fd5a2727c85d4568e34cca9fd373185378f4e668cf696c4bc1a2d66be5cf,989532,2020-09-29 22:23:32 UTC,10000000,9997550,false,2450,0
2eaf1dfdf9a52d1a692f11be479c3ac16c7f1fae27cb4386bfc356e4f72447be,989528,2020-09-29 22:21:21 UTC,100000000,99997550,false,2450,0
7b361007126d586010951cc3c808f291eefa1123191176111a7788e3ddeb173c,989528,2020-09-29 22:21:21 UTC,152034393,152031433,false,2960,0
801c60eeeddf1d8b4bac8170ae87f21a6dc2bd10de9ce32613ac672b8089e68e,989527,2020-09-29 22:20:32 UTC,554086795,554065938,false,20857,989516
6c09741c8e267c83602cef9fed53fb37830dea0704559bf08c5fbff93980a310,989527,2020-09-29 22:20:32 UTC,1422426412,1422424108,false,2304,989516
8fcfa03c17d76b758b26c78c302a32ca10a28e5e58e8439b7a8bf6e9dc1eb097,989527,2020-09-29 22:20:32 UTC,208744818851,208744816547,false,2304,989514
67d1813305c950f280c99aad9026c3c2ed87948c29f3f5250a89f0ed95888a69,989527,2020-09-29 22:20:32 UTC,1550490923,1550446123,false,44800,989516
ad7ddd311933af954a3245f20c24f4108c8e5863012bfad98aca4c33b443eba0,989525,2020-09-29 22:19:26 UTC,20280616,20276918,false,3698,989514
389cdf557a403f498c59308c1be0a257f1a248c4fb8f37a60c6d56a9f85fbf61,989525,2020-09-29 22:19:26 UTC,1390436178,1390360914,false,75264,0
6910173b994be88143bc5bc207d3b9758d1a526c9dbba2c965563f781ce4df70,989525,2020-09-29 22:19:26 UTC,52375658,52366250,false,9408,0
1752b5529b3ee48d2a54c05dbd1753e71f9f4b3d7617d48d71c6dd648fe0314e,989525,2020-09-29 22:19:26 UTC,169552527,169531115,false,21412,989514
b8db3bf155236f0b57c46aa09cb782a7eb5218afac5400e09fb8d6119b2ed533,989523,2020-09-29 22:15:22 UTC,77664497310,77664494960,false,2350,0
ed1d6cab83f45c5de873f46c4676186f9ce661944f277f59501914076dfecd33,989521,2020-09-29 22:12:51 UTC,137071358,137067618,false,3740,0
2aed4b00d24a2821036309aa451534c3e4d2acaa10ff24bbff4ce99412050ff8,989521,2020-09-29 22:12:51 UTC,144001515,143998248,false,3267,0
10bca88e907f8aa70f414e8b09d9198229848f02251d88650dd73c02168f85a1,989520,2020-09-29 22:11:22 UTC,210147417124,210147414820,false,2304,989508
0e5ca914e3527987b925f64ff6fbead558f88fb25351bace4ea6813407f2e821,989520,2020-09-29 22:11:22 UTC,94436864,94424864,false,12000,0
beaf9b42f5a65897e414544d046134933f7565d2025b6675b41583e99fe32486,989520,2020-09-29 22:11:22 UTC,500000000,499990000,false,10000,0
7da0b25f68a9a2fd62305eb07867dead441f14b08939efde42085726f5ee9f3e,989520,2020-09-29 22:11:22 UTC,33354021903,33353821903,false,200000,0
0b972601ecfa29352443991369f7478b97ed0a9baaf54fc64161fa0fcd391a2b,989520,2020-09-29 22:11:22 UTC,1551444036,1551399828,false,44208,989509
7fe0ce8e2f0628492266c2a2d647c815d14fbc7a86b20ea917faed3c2b2e1dbd,989520,2020-09-29 22:11:22 UTC,555099733,555079205,false,20528,989421
d53968c9d7303bddbf3f586be5e818b3bb13570f46525a16d12c05c2bbf17e42,989520,2020-09-29 22:11:22 UTC,75760,65760,false,10000,0
175dd3e747e133440ffe977af76709566bb4f7c7fb3bdc0846bdad11a31d8ed6,989520,2020-09-29 22:11:22 UTC,113668859,113645638,false,23221,0
f41c92cc2d8c9fd5d744a9115b44a4012083ae86abaf6214dafcab3180d878e7,989519,2020-09-29 22:09:25 UTC,4000000,3994806,false,5194,0
b2d7437a466970e7677fdc437596c70770a853b74c11169c4c7e59e5493bfd73,989519,2020-09-29 22:09:25 UTC,160638966637,160638950867,false,15770,0
9047058dab8586a7952bea02b06dcfb30d2acb50d66e644a01d9315a2afc635e,989519,2020-09-29 22:09:25 UTC,266014337,266012033,false,2304,989508
557cd9824a65782d0e6cdcfe3cc356e343afb4a109ed67b196a54f4cfcf9bc7b,989518,2020-09-29 22:08:22 UTC,24440733,24434733,false,6000,0
c56901f053e509c9e7236d97cfa514c25352108317dabcb1cbd115daf485e794,989517,2020-09-29 22:08:13 UTC,5662060,5652060,false,10000,0
956dd7046e363b4492de0f6db509e5af8e2732a01fd1e94d2237bbe4107e7d81,989517,2020-09-29 22:08:13 UTC,1500023740,1500013740,false,10000,0
7060c4d30a8896bf651b88817524cec22b07a24385ca4a80a568fc30fe25eb0b,989516,2020-09-29 22:07:42 UTC,82537673,82535093,false,2580,0
e7d9ad75afcefeccff1054cc97efe0353f3379299d6400594401be8e02356beb,989516,2020-09-29 22:07:42 UTC,124998106875,124998104525,false,2350,0
02f762619d25ce4bd988247d5e5ea767e567e22962793fcb6b1812e381962245,989515,2020-09-29 22:06:35 UTC,1500157232,1500147232,false,10000,0
ff55fb19aa600902934931f9f5907e52920094932a30aaa197c85b20f7126151,989515,2020-09-29 22:06:35 UTC,500000000,499990000,false,10000,0
e1b3a31a788664260ed57ab8575265f78c8b38a125a6d33b1f495c822703a662,989515,2020-09-29 22:06:35 UTC,206823588,206820321,false,3267,0
ec94f388ebbdea6523b2b0599a10cabb50470ffcec3a02a7d3b34003934b6641,989515,2020-09-29 22:06:35 UTC,850829572,850793572,false,36000,0
61460b7405ad89e2eb91da6f6c3d8403b4a12e442be537b097f4698b8a0063b5,989513,2020-09-29 22:04:56 UTC,2000005053,1999995053,false,10000,0
3dc887f5b4ffa6ec709cc20b66912c9f87cebd5b2f1727a91ff74f11480c488e,989513,2020-09-29 22:04:56 UTC,239014878557,239014868557,false,10000,0
c102336c7dba6010370be18ee4ee4c073f11638bd080b05935057143064587cd,989513,2020-09-29 22:04:56 UTC,1500141974,1500131974,false,10000,0
4c346040a9463b9f600f7f1fc5d7e586cf4a0acf495ecc4569f8dee51dbd7c9a,989509,2020-09-29 22:03:07 UTC,52407346,52397939,false,9407,0
5b3f73e15b0c7b89ea48cbe6c4a2aed2feda4901661b7b6b6130a5d543502d01,989508,2020-09-29 22:02:27 UTC,35357,34211,false,1146,0
81215c3ae93df53e0008d6914723174e10260d1c21f00c4768be3b227525fa41,989507,2020-09-29 22:02:12 UTC,77812030600,77812028250,false,2350,0
8ea759191819025694d4c1b6de338588d6e936a2174eccfcf0b14503dc7ceeed,989507,2020-09-29 22:02:12 UTC,1441521815,1441519511,false,2304,989496
99e515a654e5e4d8afa409099ecb25de441a75797c82e6be266473d0d239745c,989507,2020-09-29 22:02:12 UTC,123300000,123286506,false,13494,0
7c0145a58578858c359cf5f4c6e9823b9c9c66951ffc504638eff0f400a1ffcd,989507,2020-09-29 22:02:12 UTC,889889641,889885418,false,4223,989470
6e18b3c3089e35450c56d9d3243a97b3bbacec766ae6cd6e5094951b0250f96f,989507,2020-09-29 22:02:12 UTC,52475261,52465854,false,9407,0
4ce7b2fb570d3fcca211be17a64f607c79faaefc5151a3adc8e37f9225e91fbe,989507,2020-09-29 22:02:12 UTC,210225641319,210225639024,false,2295,989496
18f555ad15f657844e558c1fd7c9609e960b1a7ee6b793362470440af47d5b91,989506,2020-09-29 22:00:30 UTC,929294329,929291395,false,2934,989493
ac01910775f3f59764ef16247fc402072bbba61f77b77c04f19178479a76b0db,989506,2020-09-29 22:00:30 UTC,320617772,320542516,false,75256,0
73b20b7d618f698f87e582323d9fd0bc5db2461dc2ff7a6958ef3ef50b0a1306,989506,2020-09-29 22:00:30 UTC,4735500000,4735487625,false,12375,0
f5ab6c215dff3f041e8c838ff6d87c37feb5dabad66381383ebddb26a9dc7c7b,989504,2020-09-29 22:00:09 UTC,152255025,152251758,false,3267,0
a002784de1e91f514d0630e4a45a9a72a8adb17f752fd26715c71e3a0b03b9e5,989504,2020-09-29 22:00:09 UTC,555878127,555856642,false,21485,989492
708bc2f8638c497a78444d18282e9cb14a9124eae163a26ec15f69bcc8c01cbd,989504,2020-09-29 22:00:09 UTC,10769637,10767333,false,2304,989492
402b3f2a381e46bf40a2791c7ffce4f76887815c5ae6b617babda49c9609e36b,989504,2020-09-29 22:00:09 UTC,10145843,10143548,false,2295,989492
c8f27b3514915b8959684d426950861dd399350b18de00a0f164bfe346f23bfc,989504,2020-09-29 22:00:09 UTC,1552225031,1552184384,false,40647,989492
ef3db19970fee4e0a6f8d1b66938b1acba403406c6003960e542db8b6f2f09c2,989504,2020-09-29 22:00:09 UTC,7403438,7401143,false,2295,989492
e73ac8b1d67ffd4de50385ab68f685bca4fbc5f5b2d5d025a87656c1b02fc4b4,989504,2020-09-29 22:00:09 UTC,52547596,52538189,false,9407,0
ae3981fd893ef67164ed4d74b3c71989b6154e7e53e10c1a1829f7fdadae0703,989504,2020-09-29 22:00:09 UTC,27021673,27016603,false,5070,989492
b0fb7657ae882c23f866121e64c057a64ef6235c2136c8d63d220262378f8415,989503,2020-09-29 21:59:44 UTC,10443567,10441263,false,2304,989492
1b6f06622946495be78ed26b21f7b41aa361e63beca8d1c95dedd12686d93cfb,989503,2020-09-29 21:59:44 UTC,7197925,7191463,false,6462,989410
7478264c34ccee65a00cf938b1b8c14416251275dc355e0923bae3324bb115cf,989503,2020-09-29 21:59:44 UTC,22864035,22858946,false,5089,989492
bd0b8df8a2c5c734d730bdde41faa7b5a73cb83c03cfef8879093bba2be5173f,989503,2020-09-29 21:59:44 UTC,15460499,15454027,false,6472,989492
d9231dcbe7a50f85465bbd50715f65e04e1f441dd78e0c234823c9f8b728387a,989502,2020-09-29 21:58:29 UTC,41370854,41360854,false,10000,0
3ab5ebfc323313e72d2728e459a3123b2a9f40077e9b7b4080879a6b75ac1e10,989502,2020-09-29 21:58:29 UTC,2201403806,2201400110,false,3696,989491
2dfa01c699bcff5d091013bba481b208aee8615eb070e05ec84d8bb135ecae9c,989502,2020-09-29 21:58:29 UTC,2248921358,2248821358,false,100000,0
162d7bc620f7a7d9a22f44f712fc32ed27588e74393fadf6760efe49fe00c7ca,989501,2020-09-29 21:57:03 UTC,2199980000,2199970000,false,10000,0
69b21374f2caa52a9b330365074c910e3db1a73eec2d33cfeda846206d622a4e,989501,2020-09-29 21:57:03 UTC,77965645551,77965643201,false,2350,0
d8d3db4d5be0e7dd196c028b30a73e49e49abceff9d1014ea4d1cbbd8522d1f1,989500,2020-09-29 21:55:40 UTC,117450,108366,false,9084,0
7d0abd2c6c54daa9ec8b1d2463ce17d0f3bdeddb2233be175d6a1b9d727a267e,989500,2020-09-29 21:55:40 UTC,52659554,52650147,false,9407,0
bc699dd57d4c0d5fb61ff01009451f24aec0730e1e41493bfb85a7ca35e639f4,989500,2020-09-29 21:55:40 UTC,7246000000,7245797000,false,203000,0
f40ec9c26eb4fe6df319b40949d86836f9ffdc0bec144e84ac63e497b2a36b70,989500,2020-09-29 21:55:40 UTC,52575607,52566200,false,9407,0
7478216933b3fb28e482d47800fb675653e270d51d1561567ea0716e282482fc,989500,2020-09-29 21:55:40 UTC,52628781,52619374,false,9407,0
d62d3e41b577807c878e6f74b1e1342f0f7842f80b49cc01a0b3d5d4d5b196d7,989499,2020-09-29 21:54:28 UTC,2716018663,2715990000,false,28663,989391
251de9114ba70019b3ad1471672d9e941d1a223adb73fae02802923539a5a827,989499,2020-09-29 21:54:28 UTC,52724075,52714668,false,9407,0
d31349074f327546a670fccd22f6de1b345aedfea9d5e6f50843e027f8a74137,989499,2020-09-29 21:54:28 UTC,1876399695,1876397435,false,2260,0
586a9e77187a5c61eb1cc0f3bff29cfe99a294a2d4b30378f1af36e9e6b1b646,989499,2020-09-29 21:54:28 UTC,144480525,144476034,false,4491,0
d285492bbbf05559684ae0f3660d35b9b9735ce0826ebb4d3f870c9ccc82bccd,989499,2020-09-29 21:54:28 UTC,67050905,67040905,false,10000,0
e4bc2fe1393393e9108d06e918bcf3c4bb94409ab371df6d6e8c932e3922413f,989497,2020-09-29 21:50:30 UTC,556754573,556732124,false,22449,989486
229942cff314bcdb7b87e45456911e7689f86f72dca1175d9b9e2caf257d57f0,989497,2020-09-29 21:50:30 UTC,65679660,65659640,false,20020,0
5bba35e2b57e76ab87771ac4048728e8cec8f0d931bcb37d37587fe410b6378f,989497,2020-09-29 21:50:30 UTC,6781478959,6781466584,false,12375,0
50aa56455d67809215a787feefd2d9a6ed09e28a7469c8a9442370532e3f44b0,989497,2020-09-29 21:50:30 UTC,2007354,2003614,false,3740,0
480f8e13a1846dacbb861877b216663265394f0527403d3e539d01ec51b80775,989497,2020-09-29 21:50:30 UTC,218925143613,218925141319,false,2294,989486
47d71c97e1783fde3c72e6cd34f1b6668a1ef825785234fef6e98e883056014f,989497,2020-09-29 21:50:30 UTC,1553354185,1553308092,false,46093,989486
d68d8307076cfd0fcd6a837bcb2e9640ebf05ee850cc9a56518b68a8a30f8eb4,989497,2020-09-29 21:50:30 UTC,7426515,7426063,false,452,0
203ebfaa97e9ba0ed0d8ddaeb6f443936bcf2fbdfad9f7fd30614593c6136a66,989495,2020-09-29 21:49:03 UTC,800010000,800000000,false,10000,0
e165edd77844bcab1cf23d5ba0584714ff284ff193bceac9c1c455cd13d307f0,989495,2020-09-29 21:49:03 UTC,206998167,206995207,false,2960,0
3ac12503c9a406081c82a13f0718dbc2a48a45da20c78ef3eb3fe066c01efa1a,989495,2020-09-29 21:49:03 UTC,225945258615,225945255672,false,2943,989414
c528ea68af70e73b6206be9b37dd67e00ef0e966c02c692d40ef6f95dcd91cc6,989495,2020-09-29 21:49:03 UTC,3191917566,3191916983,false,583,0
1a050e1fe495499fe7b40f26595e3ed27a4116babae7c59baea76a27ca56b635,989495,2020-09-29 21:49:03 UTC,17367188,17364278,false,2910,0
35d746d7888654fb24dde106145f75b16ae8c6293c8dd3d0b21e41125aeb5fa9,989494,2020-09-29 21:44:15 UTC,142825751,142750511,false,75240,0
b6fee2b7b0157108daeb3301efae111779a0862784bae84e527193c55cc0ecfc,989494,2020-09-29 21:44:15 UTC,1997900000,1997897706,false,2294,989483
55393ed0d8f2bf8f8f548326b698c09a67325458821fd15f4e742cbd6c6e330a,989494,2020-09-29 21:44:15 UTC,365310612,365308352,false,2260,0
2e5dbef5e62ecc5ed79683a025900feccecd643901051a74fd8601fdfa780974,989494,2020-09-29 21:44:15 UTC,10000,,false,10000,0
3cc48701f6f198551fd86fe369da8c479b0976c72f4fbc712590045372cb0cc9,989494,2020-09-29 21:44:15 UTC,20070168,20052572,false,17596,989482
6a55175c9b7c8e4043f4514c398293ec21b84385f0f9aa699c5101de45f6766e,989493,2020-09-29 21:43:09 UTC,152501700,152498740,false,2960,0
5dc3c99ebb24c23e84a7485248ea56dd63f6db0230d173dea19805f62241be22,989493,2020-09-29 21:43:09 UTC,1835770000,1835760000,false,10000,0
fd6ac26757c5a0f4fd05953149d12a4f1411d8955f173ed08f0a49c8995bd424,989493,2020-09-29 21:43:09 UTC,50209263,50207343,false,1920,0
33169c2e5a928760c69b5ac9b5aa5aec25c1cf7449e6de51fd4926cb5a830377,989492,2020-09-29 21:41:04 UTC,557706328,557681650,false,24678,989481
b9129e34abe40707caa25c1ed23f378e8869f1e880088db21a30751ea3945390,989492,2020-09-29 21:41:04 UTC,2178667360,2178567360,false,100000,0
84ef93a3b46ec686b43fbd763e53b3080ef10339d7111784b9889cf7d1a0ae03,989492,2020-09-29 21:41:04 UTC,77999500000,77999497650,false,2350,0
6dd0c2123ce849a313b90827836a16180bd30ce311b7b813367df0c3d7f6be54,989492,2020-09-29 21:41:04 UTC,3735780000,3735770000,false,10000,0
b9365d5901bbadc28c4d60ecbd721427c27585303257d8e5bb63d36ad913dc7c,989492,2020-09-29 21:41:04 UTC,3000303686,3000293686,false,10000,0
f5cc4af2d40b6d725a4ec59659b47e82ddfa8284a159527190e74b480b6e86b6,989492,2020-09-29 21:41:04 UTC,144726112,144722539,false,3573,0
e8451a7d471b52baedceead20163408a136b2ce1814cb86b5808db0c4d07f828,989492,2020-09-29 21:41:04 UTC,157994052,157991602,false,2450,0
5c441638cf92d7a97a54535c03981cc52dadec578a2ff33bbff8a932f55660a1,989492,2020-09-29 21:41:04 UTC,1554520949,1554470360,false,50589,989481
c888a0478f0a34857b113348adb4a2a7bbb4027ce50118f22973f5036092d57a,989492,2020-09-29 21:41:04 UTC,27993479,27983479,false,10000,0
af45770d3ed8364af3bed2beb3d00e1482f8822addb2460eab06e00539116a74,989492,2020-09-29 21:41:04 UTC,5270476,5268026,false,2450,0
023cbe1d15689b4ee0b580be655814bc5c196f26abb6898bf8b4735f9caa8a09,989491,2020-09-29 21:37:02 UTC,52780284,52770879,false,9405,0
0c141b2ea0c9982e46fddc1983ec29832f34630aa8024705fdff1e54e790ff34,989490,2020-09-29 21:36:29 UTC,52830350,52820945,false,9405,0
89c70c9a3453bf360e1348849465584024552b6c870e4abd8dd92dd5df670e2d,989489,2020-09-29 21:36:00 UTC,228653668319,228653666015,false,2304,989478
cb64a7625276cb8fe84eb2ffc83300475bb56d48fc93c94be516e8627d2f6349,989489,2020-09-29 21:36:00 UTC,53029900,53020495,false,9405,0
df6b552156387ea543b1fa1ca8b592bfdebece1cd8ea7d8d9e18c2fa72700e55,989489,2020-09-29 21:36:00 UTC,66990000,66980000,false,10000,0
e2274207bf1f79ae1450bb0bd3897a6665dcc677cbf6cddcb290dbc9f4c715e3,989489,2020-09-29 21:36:00 UTC,6920088313,6920043553,false,44760,989488
4365c5bea2f37638e861a6b077e1cf2a0bfcd20451fdee17701b6d4cd349f0da,989489,2020-09-29 21:36:00 UTC,84763995,84753995,false,10000,0
570499b2a3b982d9bf5bb95c3adfa31f3e84e5b4a38d36e3a2749f0c49372b0d,989489,2020-09-29 21:36:00 UTC,10000,,false,10000,0
69d6250394317744771b0e20a05e9c3cad0990a53e6ea9ea0e0de6678f36a1bb,989489,2020-09-29 21:36:00 UTC,248701,238701,false,10000,0
3518382bec71223ea185bd48246b4174aafbda9fa3f7ae978daa37baa7059490,989489,2020-09-29 21:36:00 UTC,3568810000,3568800000,false,10000,0
d614d663394fc32b81a61c54d7651ac42b6460e7e5c65628c49c5878230e1aeb,989489,2020-09-29 21:36:00 UTC,1478732880,1478730586,false,2294,989478
a8718aeae763139becd2892a2cfa6816ade0e21d6e7147f48cb5fbd98a8d17e8,989489,2020-09-29 21:36:00 UTC,42349370,42346920,false,2450,0
2a1e6d71870ac5a5a6b948ed982a2f0449e43e79631ddd7d8be3cabc0b5c12ed,989489,2020-09-29 21:36:00 UTC,53111468,53102063,false,9405,0
bf1caf86b38cc27d3ff6febbd01715bcdb944826c475b270c2be315bbf4df19e,989489,2020-09-29 21:36:00 UTC,558603769,558580059,false,23710,989478
e2163375aed095ef4fe775d03bc68b2b7b1e9ccfcf598fae27b71a0ddd824c05,989489,2020-09-29 21:36:00 UTC,72163,71017,false,1146,0
88d524ac66d486d6acfd3fb9398ac0abac132413b8cc05bf3af99fbce4c5338f,989489,2020-09-29 21:36:00 UTC,207238687,207202387,false,36300,0
5a398ba39f215cb1a48ea1ac90b85129eb9c20a3b6fbe8dad9b49fceaac7a729,989489,2020-09-29 21:36:00 UTC,52988570,52979165,false,9405,0
fa141beeba80ebc93a6e530a3027e0fcb3f728db51853d027b8921b51621d8b2,989489,2020-09-29 21:36:00 UTC,1555530502,1555483120,false,47382,989478
06d40f3586e3fbdad1c7d36208a4029d0ec9c808fc32ee8dd7b20e364956c171,989489,2020-09-29 21:36:00 UTC,17855104,17845699,false,9405,0
eb290f369dbf15d8c74e5800726d3ae18b332c0ade0e947c85cc64aa19bbe8e3,989487,2020-09-29 21:26:32 UTC,499260000,499250000,false,10000,0
59acf94f5a74e940751c7ee9841aedda0268c39bfef613f44807934dca829e71,989487,2020-09-29 21:26:32 UTC,10000,,false,10000,0
a1d8be17d46da1de633bd3509688a730ca8b0e317ea9ea1d0ad8bd8f625d2395,989487,2020-09-29 21:26:32 UTC,277406,263646,false,13760,0
886cf4b08f31d23504d7dd053f42bde89a5b8ed102e45e08ac8bc7558e4545fa,989486,2020-09-29 21:25:37 UTC,2018542547,2018538871,false,3676,989474
813b3b3927d5be625e2b4c037f53b183966d0ecd779d1e2de43f1fdb977ad2f2,989486,2020-09-29 21:25:37 UTC,53157718,53148313,false,9405,0
ed2d27f07be857896b2474653c5f84b28beb9ed2d4e0074204ed0910f11917f9,989486,2020-09-29 21:25:37 UTC,20697461859,20697451859,false,10000,0
e8740f3ca9e83de8c208d61af4cb83ae6891240325b5eb7d64eed9c18eca4779,989486,2020-09-29 21:25:37 UTC,207183451,207180491,false,2960,0
45d408ce5efd5713c9b5cd5374d45f40f303bfc419ad16897cf2d714fc760d28,989486,2020-09-29 21:25:37 UTC,228702136497,228702134194,false,2303,989474
c35a0df49e4d1fd1ec948047780cd8f5cd201455a0a4e017f0dec6606268bb68,989486,2020-09-29 21:25:37 UTC,1594221318,1594146078,false,75240,0
bc920b71936e38a4d85f1eee407d96911662c7b90f63b1632c12026b67c8221e,989485,2020-09-29 21:23:31 UTC,1215011747,1215007647,false,4100,0
d499ea00fe6f0ff62ae01275865b1df940971dae13912f15f2e025e978f59370,989485,2020-09-29 21:23:31 UTC,244759756,244757306,false,2450,0
e906cc2b57b749140261c3805b9333d5e35a372c1eb4a022d2fc2ebac53c56a7,989485,2020-09-29 21:23:31 UTC,15573874403,15573867347,false,7056,0
7f7486829209e44240e01287b72aa3256a5703a98411bf0200e36e4d71e9264d,989485,2020-09-29 21:23:31 UTC,53215223,53205820,false,9403,0
2c090fbca48a7a740540d47a0f2d2e19176beaeee80a914c956cef57920e819b,989485,2020-09-29 21:23:31 UTC,499980000,499970000,false,10000,0
f41a0ca3014d176d6ab16d332083516a19ae57acd47c80444b778469cd1c1990,989485,2020-09-29 21:23:31 UTC,1020775098,1020771358,false,3740,0
9c89deb669bc7a68c5e27b8ccc1c929d8c6f2d9758604618b1383bc01fa344aa,989485,2020-09-29 21:23:31 UTC,1012716,1010422,false,2294,989474
23df17718685e79f6a25f9a418db831e92df55808638edb19061f22c843f64bb,989485,2020-09-29 21:23:31 UTC,179975619,179969619,false,6000,0
c41fe3ef46b3dff4ef4dd4787317e3996a1540352a5e784d426c5522d9e46c12,989485,2020-09-29 21:23:31 UTC,725707072,725689072,false,18000,0
55193b9abcaf5ebdd40bf04cb8cad83f9d01d5d12785aad9209a09274abe6c78,989484,2020-09-29 21:20:34 UTC,100000000,99997550,false,2450,0
01ef48f4b2a48bf0cb2430ab990cb270bd75d7c2be30df6a003a4eda5ef2c89c,989484,2020-09-29 21:20:34 UTC,152905084,152902124,false,2960,0
615b1707619cd77ac3a8aa16eb686a65341541b4d2f40816481351e51f54bb01,989484,2020-09-29 21:20:34 UTC,559375104,559353938,false,21166,989472
a9b59d7eb4516bb65cca25521e3bc50bab2636ab529a810bdbbaaefa160910ef,989484,2020-09-29 21:20:34 UTC,1556440921,1556394518,false,46403,989472
c198e293e89021c318a20fdc5ed96c718c9edaf30ddde8171416e12e45de62a2,989484,2020-09-29 21:20:34 UTC,17889877,17880474,false,9403,0
53a938edce910eb4428859b463dd4080a5edaf0fef1e0a5fdcc44ddcf3e0acb7,989483,2020-09-29 21:19:37 UTC,4087022031,4087019737,false,2294,989471
d3a1e16a3ddf7efbfd80bd58233ed291ad63401924b7b137eff63269ee4e104c,989483,2020-09-29 21:19:37 UTC,1503291413,1503289110,false,2303,989472
cad2bea050535c88e546de9dd45faccb4b182e6e10eec7fde2ba6f42488e75e1,989483,2020-09-29 21:19:37 UTC,103906424,103902729,false,3695,989471
0794d57be9942b3c23e96b6be0ca8ca4274c40e7116a4c4af201e849dbda291c,989483,2020-09-29 21:19:37 UTC,787019737,787017434,false,2303,989471
03ef86f695c7d8631c3ee09ebd25e90871e451de05a79ff18f3c5b49b6e7a0a5,989483,2020-09-29 21:19:37 UTC,20387024334,20387022031,false,2303,989471
d172470d8f0eae866a0cd14a647c6caa48d0eb207d70c262d04bf21dd9c8411c,989482,2020-09-29 21:18:21 UTC,122463168,122456468,false,6700,0
ec942aae2a8c5626da6b35f63560cc24a1ce83f6866fa53ec4a77deecd0f8365,989482,2020-09-29 21:18:21 UTC,29367222873,29367178353,false,44520,0
67a0686defa4745e98d7d8011ab0907045b7a6d080972cc4508e375af8184608,989482,2020-09-29 21:18:21 UTC,229702138791,229702136497,false,2294,989415
a4a3151459d5e28c5897fd3196c32d028628ab9cd00ea5713b7eb8c6bfae1ad6,989481,2020-09-29 21:17:13 UTC,144130294,144128000,false,2294,989469
7f92112aaaeb0613cac0dbdb7461cf2011b02423fcff002695184bd5057c7d05,989481,2020-09-29 21:17:13 UTC,2201404151,2201400457,false,3694,989470
6c057d40f1e32872cca386a554081212baf2a438e7a142316fbdad2902f07962,989480,2020-09-29 21:16:18 UTC,231701732894,231701730591,false,2303,989469
a0eee2109f3ea7d130e2e52d10932825475cebda652f6c1f2a7873f83d8402f1,989480,2020-09-29 21:16:18 UTC,56204328304,56204321827,false,6477,989469
e28b3083b4b3f8d6cb902e246c0a280634466f0c0303a73d05089696d071082b,989480,2020-09-29 21:16:18 UTC,500000000,499990000,false,10000,0
ee39a7acd549e975450d76260a35fef66cf5bc7e8d47b36d433562080d309c39,989480,2020-09-29 21:16:18 UTC,2199980000,2199970000,false,10000,0
f41afc247ae984d9640f263fa1620f658ac2e170213b1c1f9f401ecbf222740a,989479,2020-09-29 21:15:03 UTC,104491037,104488501,false,2536,0
968d4d337a3d23370cb7dc950dfb970b0db6b6c2cefd56f32c4dda767e5177d0,989479,2020-09-29 21:15:03 UTC,145044620,145040741,false,3879,0
cd394359c3a98d6f3c0a3d43ec47cf9888808a1df6ef060aedf6c9740a4675a5,989479,2020-09-29 21:15:03 UTC,10000,,false,10000,0
ad0acf0427e6ffb162e4ea204d464db25e0416b0cfdc143240cd42842f22aeb7,989479,2020-09-29 21:15:03 UTC,970418498,970412498,false,6000,0
3cc61a0ec771e346f0e855d198182a0f2b962865ed450f8d9343842622c064cd,989479,2020-09-29 21:15:03 UTC,5861000,5855000,false,6000,0
45271f5550f50184596ea3b57c9b9e032d63235075671089f2f16cb8e086cdce,989479,2020-09-29 21:15:03 UTC,53250777,53241375,false,9402,0
ab00a0ec043c9eb4b872088f6b8695612fb8d0a406cdcf416b73b39ea0a499c1,989479,2020-09-29 21:15:03 UTC,1463593722,1463576188,false,17534,989468
60a8616742b952ce78c3adb2aa670410ee98c8ff2df06604c225d55f9ac6afca,989479,2020-09-29 21:15:03 UTC,3401047336,3401038113,false,9223,989468
18292f924c01e8eca25a559f969c341b3e87d089ce76fd9cdce5bcacd58ccebe,989478,2020-09-29 21:12:25 UTC,104492957,104491037,false,1920,0
8b9317417234d5ee66225010f49b85b376f3e45cdbc5b8981fcc86bc7aae3da3,989476,2020-09-29 21:11:27 UTC,499990000,499980000,false,10000,0
f46efb2fdb98c2f38c2f93ddaaf2bad79eb163965f732b24add5b0bceb01b942,989475,2020-09-29 21:11:21 UTC,504951071,504941071,false,10000,0
845fdef835f583a228f37b02fbdfba557473cde624c1fd9965e3f34bc2849de8,989474,2020-09-29 21:11:06 UTC,6265867,6256207,false,9660,0
071ca5a8264c2a6e0da481c53fc683c8689333ffbe08e37c1e00027922881cca,989474,2020-09-29 21:11:06 UTC,14532872,14525004,false,7868,989462
163c29074af43f716a13faa0aea04d3fde0f641113be381c4619128eb98998b2,989473,2020-09-29 21:10:25 UTC,500000000,499990000,false,10000,0
bf9d726875c9d6b1ddb7c928299e35ea69892ec06a140aea282795aaffbeb152,989473,2020-09-29 21:10:25 UTC,560088423,560063783,false,24640,989385
cead264ba0c54015196dafc170601f4cc8bea44bbe8b947fcae4903130b0651b,989473,2020-09-29 21:10:25 UTC,108401740,108375100,false,26640,0
c2e69dc61b18881de4226be5015c8bd990e5179f3578693756a8a92ed5ad4f76,989473,2020-09-29 21:10:25 UTC,1557440273,1557387509,false,52764,989462
8f97899df1ea5a36bc0cdd0371dc03999e20031ce2c722310e2e51f7f07a3aef,989468,2020-09-29 21:07:45 UTC,78448265418,78448263068,false,2350,0
720e137682789999253e1741c33d5a04b6071a2c4872c193bee2d181769e0819,989466,2020-09-29 21:06:26 UTC,73412220,73396640,false,15580,0
0eb7ff627d638d81eb0b3d7a3d5838df20678202b47f529be6f502921b5b6f43,989466,2020-09-29 21:06:26 UTC,53495707,53486306,false,9401,0
52102d57043ab6bbe416f0cb0d02df44e4103532b8f975869f086a38d5754a61,989466,2020-09-29 21:06:26 UTC,2500503554,2500493554,false,10000,0
ebea0ad8d35902c3634518e129729b21bb25be303576da98f55c7c968a088b99,989466,2020-09-29 21:06:26 UTC,4843112940,4843105940,false,7000,0
137c85a6dd06280dc0e44182d8f581b23012d3baa48c7ace731e5d5ac82ed382,989466,2020-09-29 21:06:26 UTC,1000105396,1000095396,false,10000,0
cbc8cb6ba377708672e07b391b7cbd8c8bbfff19b7eba4343f2ea51eddde99aa,989466,2020-09-29 21:06:26 UTC,31378088,31375785,false,2303,989455
1d7994244be8740a235b493901d9592034112ce928e862e4b4384fc0ec0b83f3,989466,2020-09-29 21:06:26 UTC,20450160629,20450150629,false,10000,0
bced632b53fee6f39e3db76b9ea53176be7063f584bc486be14b4019eae5fe57,989466,2020-09-29 21:06:26 UTC,1500151974,1500141974,false,10000,0
6f6eb323fd64f7b69c44b848f61ff6a971be16424b5266d95df973b400625dcf,989466,2020-09-29 21:06:26 UTC,887943774,887875414,false,68360,0
0d32ec3db88c35533cdd4a356845aa3e7d2b664a81a8dd798b5cc86f6edd8986,989466,2020-09-29 21:06:26 UTC,2699990000,2699980000,false,10000,0
4e5105ec713f41b266abea421c3b4b28c58e2883bea693d589326223b9ff2545,989466,2020-09-29 21:06:26 UTC,3908401144,3908391144,false,10000,0
c9bd64656b8dac96e649c1ac9536e6a3bf9624589bf7b8cc603b400260cb17c4,989466,2020-09-29 21:06:26 UTC,2062149004,2062049004,false,100000,0
0d98cfb5c69d09fd6a26931dd38ea892b533e67a2f4c83d51255f20426879d3d,989466,2020-09-29 21:06:26 UTC,55753834199,55753834099,false,100,989454
31a5d24e27bfff72438f5779b81b07069fd9969f822c4549683c7634cb0849e6,989466,2020-09-29 21:06:26 UTC,238288664348,238288654348,false,10000,0
b15d1fa2ba134ad501783d816ee77b6d86bc213b1d9256ae859e8ee96dd626f0,989466,2020-09-29 21:06:26 UTC,53406891,53397490,false,9401,0
96083ee8892b5d64e3c21b4fcc1af2538c621010e268f44912c5c98b2dddccab,989466,2020-09-29 21:06:26 UTC,80435642049,80435639699,false,2350,0
0edab231096550fa6a2a528eb319166967bfa636dd76335b229f0c1202817502,989465,2020-09-29 21:03:56 UTC,141462587,141460294,false,2293,989453
5fda5784db7bef78c74d4b1ff7e4f348e3f542e8202e1cdd4d20f6081bbed5c8,989463,2020-09-29 21:03:25 UTC,3650010000,3650000000,false,10000,0
4474d3533631c2d8ce3b5f6a7e224e07755ec657d4f93a8c9e357bd46d938d1d,989463,2020-09-29 21:03:25 UTC,20891222151,20891212151,false,10000,0
6c2533da28164cb77744dfc76f1aa85d6a2158e04ad0eefe7c05a5ee1d02f832,989463,2020-09-29 21:03:25 UTC,6471033804,6470992685,false,41119,0
24a727f78453ac56d52a456fe0a131da3be4ed0abfc6f2b36b32b606630b4bfc,989463,2020-09-29 21:03:25 UTC,207507086,207504126,false,2960,0
7d12370e129d1ff71572fb02c5224870a070c3fc0b28f9bba0a23ca5a6f67e2d,989463,2020-09-29 21:03:25 UTC,1500225277,1500212307,false,12970,0
b18061bf0d6c9ec3749095daf6a026f245fce7735060aaf47baf4abcd88041b0,989463,2020-09-29 21:03:25 UTC,2790900450,2790895230,false,5220,0
ff9d95bd577df212ebc68d06d44d7624fe263439d6106c437fcdfa4dddb3e7cc,989463,2020-09-29 21:03:25 UTC,223655114,223652664,false,2450,0
9ffe1e0c80ccf907db8b9d0172bb35b2ae5acbb27eb2541e1695cdcd747eca63,989462,2020-09-29 21:01:40 UTC,237214443401,237214441108,false,2293,989450
44ab3ac91a7198a9f04b79c0293cf4f8b3a19b6e89c31d75ca55952e9c7c1c61,989460,2020-09-29 21:01:14 UTC,3132563300,3132553300,false,10000,0
4d0bc03a47daf77d5f80fdf966ab1ab7c46d515445e2cc54c5329f34d144194b,989460,2020-09-29 21:01:14 UTC,3908411144,3908401144,false,10000,0
8a8dc2db0e5426e892072611173563162b244ac2a0876e0e3b987eec68482b95,989460,2020-09-29 21:01:14 UTC,163000010000,163000000000,false,10000,0
5690bf98728d9631a6809c8bc20fa2493db68f47e7864b57e3cf25f73a281615,989460,2020-09-29 21:01:14 UTC,20891232151,20891222151,false,10000,0
105adc7be4529e2ba6590d63b9eedb369c5f75e12752bed678715cb6bce90cbf,989460,2020-09-29 21:01:14 UTC,2750000000,2749990000,false,10000,0
8b8dddbe686f967d68572eec3c0050ae688821a9ea4a9cc725dd14b2b1adfd7e,989460,2020-09-29 21:01:14 UTC,173301430,173298488,false,2942,989449
a7242d20e69f88cdf1b0ab77cb2a2fe8746471ebd64a5b864d14333b40e180f0,989460,2020-09-29 21:01:14 UTC,992981159,992977578,false,3581,989449
8a05ca077a246a974376196cd07f2fb1ded1d383cd5705e849924c640959a0f9,989460,2020-09-29 21:01:14 UTC,1558255618,1558212304,false,43314,989449
8ff01e2ea51cb67c96c0b662ebabbd1365247a8d2780abfa0eae905bfa7ea7bc,989460,2020-09-29 21:01:14 UTC,560851773,560830943,false,20830,989449
4a22f956a1fa1321f0f89b91a3a31d708094c55b8c7ab54930b32befb84b8e7e,989460,2020-09-29 21:01:14 UTC,20486997740,20486979138,false,18602,989449
4d11ac31aa9d875275b8027f8abf9f705d560cbb01a36e741a8ed1daaeb3c803,989459,2020-09-29 20:59:45 UTC,2750010000,2750000000,false,10000,0
6512e39c5ed3936904aead5010464b9f857b960321aa3e1da520239f16e8aef6,989459,2020-09-29 20:59:45 UTC,21168843966,21168833966,false,10000,0
6ab5d0158c13827468cdea08c04def1057324abc2ad57b0aeb6dee5f3889c74e,989459,2020-09-29 20:59:45 UTC,153257810,153254543,false,3267,0
83755051a095acfde0d81080d6901896c35acfd02a79b318fea9db93406bbde5,989459,2020-09-29 20:59:45 UTC,53587213,53578668,false,8545,0
89c80dd96ad524a057b1939f50b83123a206276b73efe6d6d26dad29401dc218,989459,2020-09-29 20:59:45 UTC,10000,,false,10000,0
313384a6dd3577ca64ebd4f95ab0cc07b0338a938aaff179843122fb72fe59dc,989459,2020-09-29 20:59:45 UTC,3999500000,3999495000,false,5000,0
d69a702d17d0987634b13ef93e3074bbd19eab0d92737d6af27d1c90e1d9f77e,989457,2020-09-29 20:57:19 UTC,500010000,500000000,false,10000,0
2eefc1a0063f5e5b10eefb97d9ec3db0bb6dd47f0ecabda7a91e578f25429bcd,989457,2020-09-29 20:57:19 UTC,21168853966,21168843966,false,10000,0
ba9ed4ccb665c1c42085a07ec64d44f221f5911f0fd59bea4394d196076decad,989457,2020-09-29 20:57:19 UTC,13626482015,13626474406,false,7609,0
8613abe2d82e1ca5eb93ca2eecced92cbea8398232e0a8fccdb6b239ec4a7a56,989457,2020-09-29 20:57:19 UTC,1502158,1498809,false,3349,989446
bf5c6dacf9ce718eae18c777e8ed654e97c259cbddf947ed61f670cb9517e4d6,989457,2020-09-29 20:57:19 UTC,399403332,399397527,false,5805,0
a035badf736f72c4621f0f27830b92350d2287f359d04021a0f7c6b55b9517dd,989457,2020-09-29 20:57:19 UTC,114110,107750,false,6360,0
2b6ca867a777ba57993cf3073e46260c0e78259ac60f8c22fbdd6d39bd065a5c,989457,2020-09-29 20:57:19 UTC,15861335558,15861305558,false,30000,0
2eac8febf01a32fa101574b5d5d65a3a24d0e1ad832ed58f1a9cbd14170d15ad,989456,2020-09-29 20:54:58 UTC,798875159,798873066,false,2093,989445
145a76a4abf197974e5747949fc4c7a56f6fbb65d33bf47f59d4842065a0f919,989456,2020-09-29 20:54:58 UTC,84709251,84704577,false,4674,0
d3e62bf28bc990ff6df3589e8dd7e8a9665bba6a8b4018fa939509b9e9e36ee7,989456,2020-09-29 20:54:58 UTC,21169219684,21169209684,false,10000,0
e91bc29cdb4b381b7704e1e29d30e86721f4a5f937d8f70774623bdb99efafaa,989456,2020-09-29 20:54:58 UTC,1133393563,1133363563,false,30000,0
5a78b31cbe8ecdd7b8ffb09a73643868d8d1e645c4cce459436ad1f25d21bd2b,989456,2020-09-29 20:54:58 UTC,67722871,67718197,false,4674,0
e02645da81a8474245ad655065b9dc89d8940fcfb7928c95b70e1d31508b1714,989456,2020-09-29 20:54:58 UTC,101012362,101000194,false,12168,989445
30d51ae48dfa3479e9bdadb3cc54a0ae06d9e9461ac9aec0c03300e343544394,989456,2020-09-29 20:54:58 UTC,54218317,54209772,false,8545,0
6bb99253843d1a172e06e2061e25f210b9b585fc2e6def3abefd70b8a30f2682,989456,2020-09-29 20:54:58 UTC,42956500000,42956498245,false,1755,0
c6ca86b8cfefa0c4109528ed65d3ac9577a8f1cfc7772aa003beb60f2fa82afb,989456,2020-09-29 20:54:58 UTC,126667,116667,false,10000,0
aa2ecfc530b888327552e5978a303e5d5c91a354558f40cbc58f3b1f90d17ba9,989456,2020-09-29 20:54:58 UTC,34125068467,34125065677,false,2790,0
69e181a385d318ec0ef60ecde3a6655c7c308924bad914c25830a8a7103a96fd,989456,2020-09-29 20:54:58 UTC,162248890186,162248886366,false,3820,0
7ac812643ffbdcbe9ffefdc6e20e4d6a7c8cb59b578c13fe850e7324aea1576b,989456,2020-09-29 20:54:58 UTC,4298877243,4298875159,false,2084,989445
68b8ec5ff59dfbf5b931f1e3fd8896289c649a18020bed3332b8168cb33c9e8f,989456,2020-09-29 20:54:58 UTC,16700162179,16700162108,false,71,0
7bfc9aa47a3fef7ed502632e8fdac51e9972082172e46705e6b709c310b70bc8,989456,2020-09-29 20:54:58 UTC,2199970000,2199966651,false,3349,989424
cb12bb292d519f38df71f4106c2e45c2c1ce78a45b6a3b6262519194139540ae,989456,2020-09-29 20:54:58 UTC,21798879327,21798877243,false,2084,989445
2a7b1615d08f475b743efbbf2f36053b40777db1c3672ed58ea7b8b1cf4dcf5c,989456,2020-09-29 20:54:58 UTC,53845835,53837290,false,8545,0
19cf68d0dcd3d7465884f4afb73a0452495fdf3ac8106ca698bafbfaffc33ea1,989455,2020-09-29 20:51:07 UTC,79921329131,79921319131,false,10000,0
42d53f0dc94178bdcc44d3f979c4ea9affa4b6d22ac8a65f5fd686e46b983758,989455,2020-09-29 20:51:07 UTC,6658431144,6658421144,false,10000,0
8bda9f3632e3ab22120ed96d01f15263c6c326fea0e05ae5a0015a7a0f1d21e4,989455,2020-09-29 20:51:07 UTC,2199980000,2199970000,false,10000,0
2f72ed605f28d1bea47cc169f1041e19dc889c847901c207f2d54d81b85636d3,989455,2020-09-29 20:51:07 UTC,1559373458,1559326931,false,46527,989444
200ca5beb7a44b9b9c737fcf29d5c5e41770eb459887d39904a2be4cb36ff33e,989455,2020-09-29 20:51:07 UTC,561437250,561416563,false,20687,989444
d97a8596faadfc7949375c6c6aa695a7d49096ea7bb0805ca5a602bb303c1a0c,989455,2020-09-29 20:51:07 UTC,145384802,145381842,false,2960,0
b7dd37dbe74bd1ac0fbfaa0d9b4b368ad6464ebf19ac38393e647d5c950e2717,989455,2020-09-29 20:51:07 UTC,21169229684,21169219684,false,10000,0
db1561e4ed1c4777dd344ad7b4c304c6667e9a11abd0c8f4bb323fcd226b2865,989454,2020-09-29 20:49:02 UTC,282856027,282787667,false,68360,0
c7b1195188200a26c895a58b79964b38fa705b0c65b3238b812bc9f3b3aa6db7,989453,2020-09-29 20:48:42 UTC,443708215,443690215,false,18000,0
0891d46381d1311bc9b209ceba03fa6d126dc3b674dbc996d4db3462420a438c,989453,2020-09-29 20:48:42 UTC,54335954,54327409,false,8545,0
98074bee01bf2394fb85be49fe331b889d8ab25e4f81347a313308253ae181bc,989453,2020-09-29 20:48:42 UTC,175978838,175975098,false,3740,0
c7994c496f75f4b0e677ed11c7b0e139a043f30d084e1848139d23bf68bd8f4d,989453,2020-09-29 20:48:42 UTC,54534544,54525999,false,8545,0
9cc27bf201c148243fcb48c8d59645de839c2989a2d2b381498b8b2e3f989bac,989453,2020-09-29 20:48:42 UTC,207813288,207809715,false,3573,0
298fb7b6dcd3fb7b08b6c1c8fdcb124c18740a799aa9022046f60be4d4fe2349,989453,2020-09-29 20:48:42 UTC,56561040156,56561030156,false,10000,0
f8875e91cdeddb54122251911188fef9ac89073ea380d5f9a6c1e541d73ab79b,989453,2020-09-29 20:48:42 UTC,174022650,174012650,false,10000,0
ad6a981a3924c5b6eb9b5e637cf7262bffde451ad490d0a8ca2c4657bc643388,989452,2020-09-29 20:47:25 UTC,18059008,18050463,false,8545,0
8ea8465775ef5fae1e407e5603bcfd7b58e1eb2e3ae1d73a107c6d48da6d4ff2,989452,2020-09-29 20:47:25 UTC,25813826150,25813526150,false,300000,0
1680cb0506632e641eff7fc1c48ad1ab4d03ae0c97016834c144ba5589f257e2,989452,2020-09-29 20:47:25 UTC,2104313,2101937,false,2376,0
a68f610db4e9a43119efa325484817f36f377e07c829f2f8b4b92fe0e1d35b95,989452,2020-09-29 20:47:25 UTC,54566734,54558189,false,8545,0
542d6ae2e0f0dd2b06932923fbae1320bfa9b3c3f18af9cce3880b15c486d269,989452,2020-09-29 20:47:25 UTC,76433746,76423746,false,10000,0
71df52f127c38a1cfbbb54f20641624aafe6dac7071a03b937d0443b8fddfc90,989452,2020-09-29 20:47:25 UTC,2017749930,2017649930,false,100000,0
6e1368cfe6492f4d89e506774c5532dab7d0b97b42a16c070a5aa60453d75418,989452,2020-09-29 20:47:25 UTC,6658435324,6658433064,false,2260,0
eb961bb50982470342103b2e00869978442c60cc3d5791ef9f05b568ebdd4281,989452,2020-09-29 20:47:25 UTC,499980000,499970000,false,10000,0
968d3ad1a15b752d9a3324bfa519edebfac6379434ee03c4d320259bcffb0b68,989452,2020-09-29 20:47:25 UTC,503000000,502600000,false,400000,0
63fdc0c88b3a852a7b4db23aaf590a94bf84e5872b67b2938bd6a30fa3a4df49,989452,2020-09-29 20:47:25 UTC,161563881987,161563878167,false,3820,0
bf1b5d65ab1ea76f026c8c9b35863d88f8e3280da98f8cb81aba7a9056df9898,989452,2020-09-29 20:47:25 UTC,6558433064,6558431144,false,1920,0
7c1fdfbf59d389e04714115abae05a6c73193822f1b8106ac728e96dcc1e4a86,989452,2020-09-29 20:47:25 UTC,10000,,false,10000,0
3babe159924d7db184a6795a4765ce904459a581d848e8b29c354e8031f24e1f,989450,2020-09-29 20:44:43 UTC,238610547494,238610545401,false,2093,989439
433e9d7173ffd828b713d2ed7cdea13692759f384e3a96a0ef19eabdd69e8be7,989450,2020-09-29 20:44:43 UTC,10471500000,10471499929,false,71,0
4eb1ae2b833d1fd535df46157c7d3f451b2dd670385a91b03aa78b58a750436b,989450,2020-09-29 20:44:43 UTC,100000000,99997464,false,2536,0
bbf8e2f59fd01e5b7145177b5974f496b5e4bbc8eb00d48465b23ed07b38cec3,989450,2020-09-29 20:44:43 UTC,437309050364,437309048271,false,2093,989408
469b74eec63bceafd8b12fbc0d18c548e0c665a414c817525121ad9aa83cfabf,989449,2020-09-29 20:43:01 UTC,4971261470,4971254470,false,7000,0
ed1b7c67c3d869cc57aefb73b5f4c5a9bfedeb66af5823b28041a50bf204384c,989449,2020-09-29 20:43:01 UTC,81087054439,81087052089,false,2350,0
8e45504330a1a9e660736c7af3f1235e7873c9484a8d3b5fc90562b74a50d76b,989449,2020-09-29 20:43:01 UTC,500069381,500059381,false,10000,0
1a4eba5900b433357bdd592c6df01375bf5ac7221e39fe71cf93c2eadac3e6dc,989449,2020-09-29 20:43:01 UTC,1100609300,1100599300,false,10000,0
f469617a3608c30e5ae02770fc418102939955da04fce1084625abf4ce07355f,989449,2020-09-29 20:43:01 UTC,1307446213,1307416213,false,30000,0
813066bf6cfb2ebf3a06027e6913ae698b061287ccab623015a53d0e1e0c1904,989449,2020-09-29 20:43:01 UTC,55768932299,55768932199,false,100,989438
543f76bc0e307c369b6e6be2df1892182f5f808b4f360864afa3459b7eb8aa5c,989449,2020-09-29 20:43:01 UTC,110847003,110841003,false,6000,0
09d75ed86728b255f22d6ed3573e90fc30e2a41cb0939d81957b5a935f9dc99f,989449,2020-09-29 20:43:01 UTC,239360298695,239360296602,false,2093,989438
36d5dce02645c507944f8321f0974a21df66d0415c9339516f74727a910a8c80,989448,2020-09-29 20:40:29 UTC,7559537277,7559529540,false,7737,0
bdda742e915d085ba223091b0d335709a374f0c26610796a1458c90c76fca009,989448,2020-09-29 20:40:29 UTC,500473766,500463766,false,10000,0
1767950bc45dbc5ecb8b743ccff2d20936e2c7ed147f379a49a2c73fe8a9ab42,989448,2020-09-29 20:40:29 UTC,21899997740,21899973233,false,24507,989436
0f7e93505740146174f639b4bc0914fdd7a879a76f7989ddc1da7ba08022d474,989448,2020-09-29 20:40:29 UTC,153484169,153480902,false,3267,0
7ce51ea34dfc7f1f5a95c60cc4e4fbf7ef1c92566adfe8ae8a73aefe78c9d2d4,989448,2020-09-29 20:40:29 UTC,214447424,214445504,false,1920,0
6d8cbe58230c9c1b48b229e8cf057b0284759458ab1ba88d5ade8c9fbca955cd,989448,2020-09-29 20:40:29 UTC,24805,18805,false,6000,0
44b1e97eef13306880160dc072bd2ba3a75b3e2a9f7366bb277dea4ecb76d224,989448,2020-09-29 20:40:29 UTC,1868194922,1868187185,false,7737,0
97cfc23c7aa91bbe06af600e8af34bfdd9fbb77186e96ecb53da2155756bd5df,989448,2020-09-29 20:40:29 UTC,119999800000,119999790000,false,10000,0
620b2354b636095265c51fca80644e476f4cdf72ccd44ddeebd094b98f0fda87,989448,2020-09-29 20:40:29 UTC,10000,,false,10000,0
eacae41ab88de34a2f2ba31ba48091609efcba7de1b6c86b3aa2b91fffc5551f,989448,2020-09-29 20:40:29 UTC,54635128,54626583,false,8545,0
ea8556eb99eaa0c5328c9788697a40c445c0bacccb58ede77f446969d9357556,989448,2020-09-29 20:40:29 UTC,1560508191,1560456742,false,51449,989437
f7a34f17f878d6e872e2776ff92ccb56a990df9786771e33863e45c0362037d6,989448,2020-09-29 20:40:29 UTC,570707422,570691842,false,15580,0
97440bead1de09d3ff75b0a0336cd019c6715a794733ec9c98c7c8226088ff72,989448,2020-09-29 20:40:29 UTC,500079381,500069381,false,10000,0
08822e0050523f2fd4a63724f698e88f9603d54081fe275510abbe03d5f154ff,989448,2020-09-29 20:40:29 UTC,145573880,145570613,false,3267,0
b9c0740f7e6226bf71aca855ae0c4187dfd0efe6ad9b56075f9cfc4a217abbdf,989448,2020-09-29 20:40:29 UTC,562109616,562083990,false,25626,989437
73cde6243655ca9bad64a874304fc3fbf19514943e2f59d4e7f6a1e9b3a8cc4e,989448,2020-09-29 20:40:29 UTC,372695439,372679859,false,15580,0
a24eb1c3fd9a4d4cfd3cbf32e0da3a867ad6bc0b59157b90d41f0c8d5b30b567,989447,2020-09-29 20:35:58 UTC,1334985936,1334970356,false,15580,0
d01a3a039572f61bc9a0313b6f8c5628485e199e702118212c0e9f158c50f289,989447,2020-09-29 20:35:58 UTC,239764873588,239764871495,false,2093,989436
04ef91f333303eaeb7d81a05ee839a4828e18935dc555214a999d7387c7d45bd,989447,2020-09-29 20:35:58 UTC,49081151,49079067,false,2084,989436
8580275fbfa8268a697fabf2e194f525e03e35d34c258741d9054f2aa0d00fca,989447,2020-09-29 20:35:58 UTC,54686282,54677737,false,8545,0
6ceb8b250b2df70f43fccb8c10744b6c78731d3ea83cc1ecb697403187eed805,989447,2020-09-29 20:35:58 UTC,500000000,499997464,false,2536,0
1229accff867c7994f3ee2721ce347b69ca00008f33958c2752eab6f3a22c16c,989447,2020-09-29 20:35:58 UTC,63776871,63766871,false,10000,0
e2d7f086d10bb00221dde902c9182296d1acccae62e1ff6b390d4b29fae27415,989447,2020-09-29 20:35:58 UTC,499990000,499980000,false,10000,0
aa63f3ad3d2ab67e83e0de78470daecfff14c438fb74aae724fb9f2a6122176a,989447,2020-09-29 20:35:58 UTC,4834876873,4834826837,false,50036,0
fe359e5e829b7f95f8c5863a3fdc0b75a4ce42bb708dfc758c662de921b71a64,989447,2020-09-29 20:35:58 UTC,1249990000,1249980000,false,10000,0
47901b59b26a2684b8ac5f418bfb5538b60698c36d62d1acf64b82758adcc6f7,989446,2020-09-29 20:34:17 UTC,491563777,491560366,false,3411,0
e2533ab22bc41a29be3ca746b95ad67043ca50164962a9047fe23bc7b48f7e0d,989445,2020-09-29 20:33:19 UTC,142854480,142754480,false,100000,0
845218f07f32d90ed5bd0fd1b440de1f8cfa654cd4a2d7fa654f2ff62c2d5c88,989445,2020-09-29 20:33:19 UTC,305670674,305662834,false,7840,0
50848b137f8467fc985def823e30ce506bb85eb671025bc4068e7fb7f0de2c96,989445,2020-09-29 20:33:19 UTC,500000000,499990000,false,10000,0
7acfd62a9cea32af717fa349203925e93364a7617f2e4a7a8adf373a45b3b7ff,989445,2020-09-29 20:33:19 UTC,562794050,562769885,false,24165,989434
7d6fd5c4b0c0a9f97c01f06cbe1dbf8051652f911bac97d3bdbbd42d850fe07d,989445,2020-09-29 20:33:19 UTC,55903832399,55903832299,false,100,989434
393763544cff209ff959ed7deaa90fac6ede7ea9085a74c6f67a26274b7562cb,989445,2020-09-29 20:33:19 UTC,2522453376,2522451116,false,2260,0
36a99f3853ec251d85a5fe9c5d9c74e0507b5f125cafa24d374cc079233940e4,989445,2020-09-29 20:33:19 UTC,3725000000,3724986237,false,13763,0
1e399eaa6358bab54526c5faad8e09d33cb8b7a9287ed3740957a0815df324a7,989445,2020-09-29 20:33:19 UTC,34125068467,34125065677,false,2790,0
071b2415310188faf7232a3e67f16cba01bdf99f94fdf3840c3ff01ba64fd6ae,989445,2020-09-29 20:33:19 UTC,1561419367,1561376600,false,42767,989434
f6b1ec56a7dab46fd3c6d460a3fd2f0bbfeb9dd5fb8906d458557f9f1f8de431,989445,2020-09-29 20:33:19 UTC,142891330,142822970,false,68360,0
9d7dbefdec5be819066d1d04479e376c9a4be5586746f7ec5679712300ab5d23,989445,2020-09-29 20:33:19 UTC,208079099,208075832,false,3267,0
7a3df87589f899e8bb6d0ca2f22980d3a39ebdb2387e8fb9423b9e6f3894d6e8,989445,2020-09-29 20:33:19 UTC,1000000000,999997464,false,2536,0
26cd9edeb8dfe7e7569821b2451c7d0de214b3d4dadf6c503df44ec9bf3a6636,989445,2020-09-29 20:33:19 UTC,54800714,54792169,false,8545,0
de557803c2f0add3c29cac5093c59c7eedbad420b0e44cee43ea667832e96c37,989445,2020-09-29 20:33:19 UTC,240554775681,240554773588,false,2093,989434
6d122b9524f4fbf0bd5b05c14c055d0e1682e876e1a4d2d360f1f028e8f42429,989445,2020-09-29 20:33:19 UTC,112838910597,112838907907,false,2690,0
53952c39ed5202e38fd33a864adce2ed73fd3181dc828739ca0aefdeac6e687f,989445,2020-09-29 20:33:19 UTC,103964741,103961001,false,3740,0
f47151d74ab7d5f49cf3e91da4cbfe1941b81592415bde139805fc76953aecc0,989445,2020-09-29 20:33:19 UTC,15672179999,15672076999,false,103000,0
1929a309a0fa053c67f4cc164a049492c84e81deec4b7d938a1e5fab6905ae96,989445,2020-09-29 20:33:19 UTC,260820352,260815132,false,5220,0
c141cdcec0df0ba062e308c37910353b2c3eb0a3841d996fab11e8f29a622bdb,989445,2020-09-29 20:33:19 UTC,33325372,33319372,false,6000,0
b8019bdf483d3448f9f7b4090859c9ff8b8bd8b65ab3d9dba3d9395c39ec912b,989445,2020-09-29 20:33:19 UTC,1371253084,1371223084,false,30000,0
b41b4c02144d859ef0f05c4a2da254068788fd19622686cf52a7ff83c494cb76,989445,2020-09-29 20:33:19 UTC,10000,,false,10000,0
edf4fa70dd08a2415c171625bb38bee46a5c1e74a785d3d74c4cea23cf9eedc2,989445,2020-09-29 20:33:19 UTC,280810588,280807970,false,2618,0
1713c115a5152ca59f9501ea4a36ffb0e2ab056cafb3088378c8cbb2d194c84f,989444,2020-09-29 20:27:05 UTC,54932980,54924435,false,8545,0
d829e1436e8ae22808ec48480d5fca80225a7405c809df6f4bae1fabc7ea85c8,989444,2020-09-29 20:27:05 UTC,77999900000,77999897650,false,2350,0
bbb49e4589f1bfe9435eb53024038d08ad1ae74ed0d28cee95d77b411db521c2,989444,2020-09-29 20:27:05 UTC,151071675,151064736,false,6939,0
98bae56dabe076a5d21689520007dc08ccdb4e87007d8d63acc8fb1b473c47f7,989444,2020-09-29 20:27:05 UTC,54960478,54951933,false,8545,0
9e1fbc0542b7c7a1c55cefa3e074b3b067b48df531e40c4066fcf0a2ec0250bb,989444,2020-09-29 20:27:05 UTC,16000000000,15999997907,false,2093,989432
380817ec20802a00579268279b9cc78d92ac9f81cd6d8110faf9b82b918934db,989444,2020-09-29 20:27:05 UTC,17748136062,17748106062,false,30000,0
31c63bf34e443fcac799a74ca084de09535bb5abbddb5e081ddfe212628e5a7d,989443,2020-09-29 20:25:46 UTC,1033578749,1033576489,false,2260,0
2ef7af22074a7318b8391a520f312f9e343d3e5356481718a64305fa3522249c,989443,2020-09-29 20:25:46 UTC,2135414,2040776,false,94638,0
5a99c6a4c497666bad307ccc77338acd9aa5f199204e9f816eebb9a74495fe9c,989443,2020-09-29 20:25:46 UTC,365736073,365720493,false,15580,0
0a082d71564dc30e7fd3cb8078470fbb78b00ce7102bc6e31cc41f746f7d9026,989443,2020-09-29 20:25:46 UTC,30350609722,30350603844,false,5878,989432
9538cdb711845ea4a65bd87e753497a67b3edd9bec6aebd725b55d6e21918afa,989443,2020-09-29 20:25:46 UTC,240879869474,240879867381,false,2093,989432
bef4ff3eda1ab9af6d7b74bef828999fe42057f1ade33e2c4672dd66ab7e3593,989442,2020-09-29 20:24:20 UTC,2859340521,2859224481,false,116040,989441
835a3f8104cd8f117b83d43ade3fb40a5b1b4f2942e77b44773de7fa657d3e1f,989442,2020-09-29 20:24:20 UTC,34125068467,34125065677,false,2790,0
0ec2c2f86272d93986e1cc52a36fce97eea2327eb6ebcf456799bc964fcb558e,989441,2020-09-29 20:23:44 UTC,138710929929,138710929847,false,82,0
aed2049a0d0e6d794f1401000faa89aa5f9a49dfc6fc428311b636f954b1e8be,989441,2020-09-29 20:23:44 UTC,55084240,55075695,false,8545,0
869f0e3a494bfb1036fb5cb73718c4f4b9559ef3a7df27b9c574185b3d857873,989441,2020-09-29 20:23:44 UTC,1732746001,1732742261,false,3740,0
ab178f81329ae9ce63db0ac55f958dcbf0e859ab1f50da8f65feeaa9f43ea473,989441,2020-09-29 20:23:44 UTC,111916211,111887240,false,28971,0
9486b42636c899d6fd40ef7375902050484d1a69bada1c63a15c931cc5b38f0d,989441,2020-09-29 20:23:44 UTC,208342004,208339044,false,2960,0
f3f3fad0ec8be410d8f3e3bc7b27c3601896810f82cbf092e4b6d91474419a5f,989441,2020-09-29 20:23:44 UTC,1000000000,999997464,false,2536,0
021062abf1b35b7101aff01f9c0db8aa3707e52d8634981d0ede9393fb8e0973,989441,2020-09-29 20:23:44 UTC,63133610,63129860,false,3750,0
0124ffea30ec18f1ede872d75a6059cd91bde1d9f6f6f02e6f10eb062a08fcfd,989441,2020-09-29 20:23:44 UTC,2305876304,2305874210,false,2094,0
8890d3fe1919a3d89cf9830f2e0b0c15d7794bc4a01c3d27b415030e593eb601,989441,2020-09-29 20:23:44 UTC,181918044,181897335,false,20709,0
6e3db86614e2d819393b522036d04db8df72279c4652afd184c37e7a303f2a62,989441,2020-09-29 20:23:44 UTC,500762421,500752421,false,10000,0
adbf1a7a220a97feb15dc65063f97196a4d32b7ed1109d6deb63fec60f9d5965,989441,2020-09-29 20:23:44 UTC,1562856150,1562805846,false,50304,989430
b7a7df3b757a7831f12f18732f3d6e222a63284da93995d553813ddca0287dd7,989441,2020-09-29 20:23:44 UTC,711796886,711789919,false,6967,0
8fa0212d14440efb7a0ee14fe8a6b2ec7138a25048245b0fccf24bd26d6abc7c,989441,2020-09-29 20:23:44 UTC,1940081889613,1940081887520,false,2093,989430
0775336e3caf33d370d2cad6b55e105d54497bd4a033c95eecb38be17f58d897,989441,2020-09-29 20:23:44 UTC,166392557829,166392553329,false,4500,0
b5161eefd88a88e1aa587467ebc154827029ac9a0fd50cb60686546eefc3bd4b,989441,2020-09-29 20:23:44 UTC,499990000,499980000,false,10000,0
7150e452eec175b33ac4e9d9e33e3cf023a4bb2e0bf43010bab9445ca0a52a37,989441,2020-09-29 20:23:44 UTC,147822896,147812896,false,10000,0
0fa43e7a3d6cea700a0b36d7c6a6851df7465aebaf57a7c55f1f7c74f25f4bb5,989441,2020-09-29 20:23:44 UTC,206380000,206370000,false,10000,0
4166568b102ce1b0ce2575be9a975ca4f6ce66970beb0d236963a89f8c450860,989441,2020-09-29 20:23:44 UTC,563557174,563534163,false,23011,989430
32b0f8cfc0a4fb5a39959c37682aa87691991c76e6cd15eed4e05737ee76df8d,989441,2020-09-29 20:23:44 UTC,499315573,499305573,false,10000,0
1c93b6dc6fd132ec6c253012a6f21f4b4db784cb5c2f64fc2afe3f44ec76a071,989441,2020-09-29 20:23:44 UTC,55956092713,55956092613,false,100,989430
c45f7a224d93aa8e69d1ec0e3a3e3f227908945f41b047bb358c55cb30df531b,989441,2020-09-29 20:23:44 UTC,159042400986,159042396486,false,4500,0
ef0de31e5ceef41c1e3bea1e3ba61d54dadb98bd2dadfc0d6cc1ac19b14c8f56,989441,2020-09-29 20:23:44 UTC,107679303,107673303,false,6000,0
7e6c3de63838765c6ae869d66c5c21b17894dffffbd25eff241560d751613c1c,989441,2020-09-29 20:23:44 UTC,79893109,79891025,false,2084,989430
d2218d51cdac5d2e8748ee756909a070da38a03e61699255cd5d211b827bf123,989440,2020-09-29 20:17:40 UTC,99910500000,99910497310,false,2690,0
964f7bbe266ebb2f153c9715cf0ce2b9698bd4fd51aa3f108e12f8bc33736fe1,989440,2020-09-29 20:17:40 UTC,16353868492,16353852912,false,15580,0
703e17fb13424dc5468abb7a4809d6a8e8e89475314fddde5ea10b56b0259aac,989440,2020-09-29 20:17:40 UTC,500000000,499990000,false,10000,0
916f3a751ae9c41c2fec0fbb4bd0e0d6d2c744c31cf008e7224d17194af7595e,989440,2020-09-29 20:17:40 UTC,151262297,151259337,false,2960,0
aaef5a8d87164953ef84fe58425d9b9edafe1c4986d2a7bed822e848c53d41b3,989440,2020-09-29 20:17:40 UTC,29733900000,29733897550,false,2450,0
b4a5331c2c5fe36b7be9c7de885fb422039ed7bdd9595510522931aa3c33b087,989440,2020-09-29 20:17:40 UTC,1949940046,1949931929,false,8117,989429
f6916c454b02e69b109ee839130301ac75ec760ea7d4d7b65f56ad6fdf69b059,989440,2020-09-29 20:17:40 UTC,1870657378,1870641798,false,15580,0
491f3d27134e56319e7160f834b1bd57d076a7fc0c7aba6770c903576ac2ea46,989440,2020-09-29 20:17:40 UTC,242879871567,242879869474,false,2093,989428
38221ad15fe5c724d6f5444e66259ea208560b1d7848c94a2a20f686ea77ee49,989440,2020-09-29 20:17:40 UTC,2000000000000,1999999997907,false,2093,989429
e2109b623c852c12cef5aeb5c436e1642cedb48ecffbb90d61d8d57c61c1270b,989440,2020-09-29 20:17:40 UTC,219990000,219980000,false,10000,0
3933ee1ac647098d6039d0e3a59b6fd9c25fa0c702476fac15ef514c43331dd3,989440,2020-09-29 20:17:40 UTC,18200600923,18200592532,false,8391,989429
b95c61d4afb30f4c1e240c6949f1607ba91bcc01a51284dc88334493fef7a57a,989440,2020-09-29 20:17:40 UTC,282247976,282232396,false,15580,0
6eb348c7a769aae382a1c1278aeba8920c23984bad3b2f1b52839b230df69a49,989440,2020-09-29 20:17:40 UTC,106982800,106981654,false,1146,0
d25590ab60305cd0cc8c4eaccd103c75afdb8dff26c5439565df3415ba45847e,989440,2020-09-29 20:17:40 UTC,121031040854,121031038504,false,2350,0
da550a4529f9ac5c4b6b6bdb649e04c79c5eef85dc53b626e39d9255a7e30e7f,989440,2020-09-29 20:17:40 UTC,1962680891997,1962680889613,false,2384,989429
b1ae3589dd28f801d8d5c96744286e1507020c5e58d90a419bd571e0aef071d2,989440,2020-09-29 20:17:40 UTC,508384093,508381643,false,2450,0
5acbaf7bea34a1690c5bea37b2c2fb92a772ad7dfb47216bd30485b5d8ba4021,989440,2020-09-29 20:17:40 UTC,1376430028,1376424808,false,5220,0
4470abaefaf53ff29cecf2357c0556bb71729ad5a54d7de1afb3cffd498a637f,989438,2020-09-29 20:13:02 UTC,62293605242,62293205242,false,400000,0
0b5b4e1bb929a74d494a92bb5f25751994753d437f9839ebb5c01d0cd3eb3f0c,989438,2020-09-29 20:13:02 UTC,109227973,109223299,false,4674,0
bdaabf0ce8249d120969ef9a6e999b65afd34912baee75fafaf5106da1de8b0f,989438,2020-09-29 20:13:02 UTC,142909172,142840812,false,68360,0
bdb2ca9ca28a3e0c44d6965031d7bf34dc5a9728991e090d46325bbb36a58720,989438,2020-09-29 20:13:02 UTC,219000,217418,false,1582,0
9a9cc92b56023070a86a99f289a88cdbc3e7bc0842d26b9209539fc26785a79f,989438,2020-09-29 20:13:02 UTC,55124390,55115845,false,8545,0
ac8db5954d0f80e78b6b76e5d9c2b5442a1271aabbb7cf5b18c94fb4a2134383,989438,2020-09-29 20:13:02 UTC,1000012085,1000002085,false,10000,0
f56be5280f101c6d7ec4981a935b6c4c9b0b919f9619527acc754dcc5bef6fa7,989437,2020-09-29 20:10:20 UTC,78099500000,78099497310,false,2690,0
242c4640da3043e5cd540e20b3c6e1de9c84fdc279b36c311518953c09900041,989437,2020-09-29 20:10:20 UTC,182087286,182084326,false,2960,0
f9d30bd911448d6a4e3fc420cf3f18cd9b9b93c676ac3313b7ecdcedae91d7bf,989437,2020-09-29 20:10:20 UTC,10000,,false,10000,0
4cc0dc42918bf7f90869ad98b10b2a58a192b71751be7e5095875e65d93fedb7,989437,2020-09-29 20:10:20 UTC,564107365,564085806,false,21559,989426
eed856f595602de165ccaec1736234cab6e3203bbcde8fb8b40a202df63fa915,989437,2020-09-29 20:10:20 UTC,25857152250,25857152179,false,71,0
6e154b9690580b83d9b7ac7a5bfe411da4aed9c92174b88c08d856b2a1e34c20,989437,2020-09-29 20:10:20 UTC,415747356,415733256,false,14100,0
8cdc92ad464ae805ec2128e11213a55131b46101ec51d4bd69835840a7353301,989437,2020-09-29 20:10:20 UTC,1563786421,1563739621,false,46800,989363
4ca00df0f7252d2be3a97d0832af73968c6af9c9da60da262ad70a3ca4bf5a59,989437,2020-09-29 20:10:20 UTC,159298171,159292615,false,5556,0
cdb510a8a106c0735fdbee9fc6126d31eb42a6e72e0159b798206c6a42ac3f64,989435,2020-09-29 20:08:02 UTC,5000499500,5000489500,false,10000,0
0b5fe6ae7b3cfdab4cff753b552b1757c9cdc43befb21c8124f969e3db2337e3,989435,2020-09-29 20:08:02 UTC,500000000,499990000,false,10000,0
8a6f6c2e3e5e41ade3cce2dc2340b8ebe2f972949d0d971e59e234ed8a21c7cf,989434,2020-09-29 20:07:46 UTC,173886725552,173886713177,false,12375,0
a7f12865fe8b6065c09f2ceba380d4220a1f223d07082a877d75340e8eb7feaf,989434,2020-09-29 20:07:46 UTC,110939458,110937365,false,2093,989423
002217ad15387c8d8bd4e66cc17959ba90d16eee2d2283b12e1992ad29224663,989434,2020-09-29 20:07:46 UTC,20000692608,20000686862,false,5746,0
60c96e59248e7df41ccf94b2fc137654332c2c5e1b14f1f522f74c66c165a58e,989433,2020-09-29 20:06:47 UTC,23000000000,22999997550,false,2450,0
0525c091c86f771802a102e223440d52a03ff4c0fa9b1a43d5f7eec6fea8badd,989432,2020-09-29 20:06:19 UTC,2690991972,2690986226,false,5746,0
f73f810cb8d8df2e1797516f425432f082ae7e3b8094fad6418cb47369d572c0,989432,2020-09-29 20:06:19 UTC,151472108,151469148,false,2960,0
15320eef3503fe2ad3ee008b19c3a2e92508d62a14f7d4c92d55288934c0fd01,989432,2020-09-29 20:06:19 UTC,209017814,209013629,false,4185,0
4f24baafc099c7d2a30f4f36aa12543d3a87444df025db5832dc5e439ff21f41,989432,2020-09-29 20:06:19 UTC,2500200399,2500190399,false,10000,0
a06629e6ee8f83b1891d26901d545c73dd66622d1d964022cf3e27050deaaf1a,989432,2020-09-29 20:06:19 UTC,55172920,55164375,false,8545,0
d82f94333715703a51873df2f12d14c6edd817ba70727ef6a620aef28374c139,989432,2020-09-29 20:06:19 UTC,157525647680,157525643520,false,4160,0
76c8523ba4146055681ad810804b30e549bb7dca7849e9a04209a25b756b13e2,989432,2020-09-29 20:06:19 UTC,1035002260,1034990175,false,12085,0
fdb0b1817f914aa912ffe758b7470d963752ba90678e9b2427ac94eb3084cfa2,989431,2020-09-29 20:05:08 UTC,260873462830,260873460737,false,2093,989420
b097002db4b5a27233ed76f44d61ce12042e578d4967c863d849b18c5e41619e,989431,2020-09-29 20:05:08 UTC,1000115396,1000105396,false,10000,0
25f5bcb03bd7ad2f5066e242a053fd9cb618ff494838446d964430a9e5b7ea50,989431,2020-09-29 20:05:08 UTC,235052404636,235052394636,false,10000,0
d258aba0a3f5a27cd10199232144fbc8e4b06e540e6a5c90dffcb3e1ab19efe0,989431,2020-09-29 20:05:08 UTC,3500575813,3500565813,false,10000,0
6bf9489f8e9c6c26240cd434eaa8a89715f1515f25df295f012e03c543c3bab0,989429,2020-09-29 20:03:55 UTC,17301335413,17301328270,false,7143,989417
f46c8e598d56c7627c74960eedf7c7353094539e57fbff4443171d42b7c93ad4,989428,2020-09-29 20:03:39 UTC,78948632197,78948628487,false,3710,0
d2ad5a2da31a9bbaadf503c61e7426f0f3d209b960da7bad130b33bb73b795ca,989428,2020-09-29 20:03:39 UTC,200070205,200043481,false,26724,0
4d9af86f9952b8927bd54f0c5464dd359ac39cae41bc9992739e278a5d819ef9,989428,2020-09-29 20:03:39 UTC,10000,,false,10000,0
c8f2f53ae9900107dd6abbd434dca2c6c584a93bcbd3a087005f3c8bed07d694,989427,2020-09-29 20:02:52 UTC,2267473732,2267468228,false,5504,0
808ac159ff8ac4eeb43724bd3a55dd07af63e90c4979450b091e4644a36286c9,989427,2020-09-29 20:02:52 UTC,5900000000,5899997550,false,2450,0
8b627bdfc1abcbe70d41220458b2c5167dc4c31e49d12186f9e6f4e82a78e8a7,989427,2020-09-29 20:02:52 UTC,7000000000,6999997550,false,2450,0
f15f6a225b2d87f87f0858e05bebaca298bc6a5bc97d1654f70f580f4e754863,989427,2020-09-29 20:02:52 UTC,14999995820,14999993736,false,2084,989416
ce9bb77627fca780d8ee1cfd934457e8aff04239e423b7a2c3b7dc3de87238a8,989427,2020-09-29 20:02:52 UTC,78983790482,78983787112,false,3370,0
f9019c9c19204402552723906c58adf56400598855c30cef3bad21c7bfad3f33,989427,2020-09-29 20:02:52 UTC,16780728482,16780718482,false,10000,0
3c630878745da0b597d5abe7c339418aaf694c92a35d89dbfdff67c45ea9c668,989427,2020-09-29 20:02:52 UTC,4000000000,3999996260,false,3740,0
57467e47a00e542fff6d7a23c86df76504c0f51a5b95d365ce51a6c4c724993b,989426,2020-09-29 20:01:24 UTC,55202951,55194406,false,8545,0
84f14bb67081ade17c2f3612dbc33a58c00373a4e13e2d549f8a87b61dd5b790,989426,2020-09-29 20:01:24 UTC,2199990000,2199980000,false,10000,0
d8067dac939aff3656e80800a59dc1d802cf5b10233b04bbcff76d6023fd61f2,989426,2020-09-29 20:01:24 UTC,253571072,253568979,false,2093,989415
902eb612d4191e24ed781045d09c68ad295ea28bf5d279e3733d5694110f9579,989426,2020-09-29 20:01:24 UTC,235960844,235957589,false,3255,989415
e090a9620700dc24c24f5af526411c86b8f03259b7896b537b1ee4ee74edb7c1,989426,2020-09-29 20:01:24 UTC,16577731000,16577631000,false,100000,989415
e7a942fe897c0c9b088bfc92e45b02e00bd3a8095502adc079566a5a712e0a43,989426,2020-09-29 20:01:24 UTC,3001384675,3001369435,false,15240,0
b7d164ee759ce2aeabb03ba8ce80915cbfe891379e397bc9879fb44823ba0d66,989426,2020-09-29 20:01:24 UTC,15556298,15551684,false,4614,989413
dafb710e88503bb062d08472952512dd19147260a481f61ba3e80f280c86a805,989425,2020-09-29 20:00:26 UTC,5771168475,5771163272,false,5203,989413
74cc8ec4bc90c35c833453cea9fe85cdc149a842348f82422b14898bd4c8f6b4,989424,2020-09-29 20:00:14 UTC,412370000,412360000,false,10000,0
a9e10a8002ff1e70930dd746383db0d1e0cd21ad2d5f363b120858c51cb26ee0,989424,2020-09-29 20:00:14 UTC,158395500807,158395496987,false,3820,0
dc84b5686c5c9607ec32df13276c4e05dc3729a16419d1e4e7c55d5bc4c3e259,989424,2020-09-29 20:00:14 UTC,1565149169,1565100916,false,48253,989413
df9a0bb9b4c92f29681054cdfb9293abc63e4def185199a534685704e9302f69,989424,2020-09-29 20:00:14 UTC,182423579,182420312,false,3267,0
92c3348f411a8c23788ea386363bdc2844ce480eea8837c8d58a7c71f2844e7c,989424,2020-09-29 20:00:14 UTC,564644978,564624291,false,20687,989413
f4a8bcfdd36b3dce50f2e4349e7dfd19bf39f89342c9cd4a3f031d48d207660d,989424,2020-09-29 20:00:14 UTC,32504,30054,false,2450,0
74abe4c8b9ff6e23baad313fde8feff7d50b9c6989cb2429fbfdefafd7bdf52a,989422,2020-09-29 19:57:17 UTC,100000000,99990000,false,10000,0
33adad7211266e6f4f7be9d3ec4135156205292648165c8be27d91bf8c6babd1,989422,2020-09-29 19:57:17 UTC,499992084,499989991,false,2093,989411
af34e3d4d86af202a2a48009cb42d9d471ae08d5415192c7572bb4395caed1a6,989421,2020-09-29 19:56:38 UTC,19978700044,19978690044,false,10000,0
13a2e7618ee88836e4c287212be14e7f928cc766bc2750d231bf99ae3ee317cf,989421,2020-09-29 19:56:38 UTC,35685444,35667444,false,18000,0
a252acc23d2c3c65c45d5da9c09d66fa6acd58279d02e7515b219127ff4eaa7e,989420,2020-09-29 19:56:00 UTC,500013879,500003879,false,10000,0
3b3e455bb015ff6f9ed513880c16a3746ce63e2bfe1bc68b2f4a80c05e81d15e,989420,2020-09-29 19:56:00 UTC,79516824487,79516822137,false,2350,0
0fa65cd3a135cfbd31b5e127553c9c3276069fb47f712a19e1bdaf77a572eee8,989420,2020-09-29 19:56:00 UTC,1674618754,1674616661,false,2093,989408
9d91ab95ebff5ec335b423c5f69379358a39b049f486a0d53f1ea5a80ce23e88,989420,2020-09-29 19:56:00 UTC,132996,122996,false,10000,0
c14233fff5045cb68d4c7fa0127948283f0cfb529bef72e0fca4e40c86743060,989420,2020-09-29 19:56:00 UTC,20870,17470,false,3400,0
18a0cca4bb7058adc28c01b5e63301eba151b32bf34516174877bdef09343633,989420,2020-09-29 19:56:00 UTC,374616661,374614577,false,2084,989408
d5b135a15dbbe69bc154e610f7933430411e68c74b48ec43ba0664a3f5ffe736,989420,2020-09-29 19:56:00 UTC,262425000,262419000,false,6000,0
53a824d09e22b5b5b73b6ca6710b179174ec1fcc6d3b3a634189aefec46de831,989420,2020-09-29 19:56:00 UTC,262873464914,262873462830,false,2084,989409
c8da65a613d4771135bbbb4fd8c4c2b6ca3a39b68ab2900522c126cae84b417b,989420,2020-09-29 19:56:00 UTC,1535484732,1535384732,false,100000,0
837e7f8a23d82dc7f6c055fbbf2c9b229e2ea06cbf08e9108bb57d71b96252e4,989420,2020-09-29 19:56:00 UTC,151761892,151758932,false,2960,0
45a838008a9a43e963317dcc4e2d569d835d2b356e01d01d91dad741c0586aee,989419,2020-09-29 19:53:55 UTC,142922840,142854480,false,68360,0
04191915470e029bb2605a8501b39c96ae49888d9954e66d3fc1657e7fbf39be,989419,2020-09-29 19:53:55 UTC,100010000,100000000,false,10000,0
baec2b6d7e9e011b7a4608108bbd4eb6247a908a056ffb2b0ffa9d5ce9c9e3e6,989419,2020-09-29 19:53:55 UTC,55231011,55222466,false,8545,0
1b761313cf42306e692f97f37a97d729d76e1b6194af67b5f0e3b31a764e9f9f,989417,2020-09-29 19:52:36 UTC,3334591767,3334590858,false,909,0
f123df6fb0a2ef27d4f89971b6a2a44db234cabad5a140d027dd97db2e4cb656,989417,2020-09-29 19:52:36 UTC,262972967007,262972964914,false,2093,989405
17e2b328cd80e233e67d0a8989981b454bb8dfa299be7a611d04a64756f6418d,989416,2020-09-29 19:51:50 UTC,2679276438,2679268359,false,8079,0
5f5fcccbc93b5c976433a65b56616556013a69eadcf5fac4742a3aad36469093,989415,2020-09-29 19:51:16 UTC,8372117593,8372092847,false,24746,989403
c873a3418b861ae47dac0443fc59f52785ffaa759146b0b117fcc48fb31f7cd7,989414,2020-09-29 19:50:49 UTC,565226559,565202967,false,23592,989403
99cdd2bcb3c9cdaae4bf7d60af6150131b4d8221826fe61b5b47330899164705,989414,2020-09-29 19:50:49 UTC,263580001491,263579999107,false,2384,989337
ab41628d536e73af122b27b3e0615a93c2ee8b1f5755edba76ddcf41cb9d1ee7,989414,2020-09-29 19:50:49 UTC,1566215283,1566167867,false,47416,989403
8867aba9e1711101983386f8c92f461edbb3497223b0e7958156d7c7adf5a4ba,989413,2020-09-29 19:49:28 UTC,8501093066,8501086230,false,6836,989399
6bbb248e08be9c8af78d63825694ccd7975be3f9b322194e671cd425829a613d,989413,2020-09-29 19:49:28 UTC,209183405,209180445,false,2960,0
d979876f84946288182fb846568c3fcb98f0174db2f67d9e1d202680f695c8d4,989412,2020-09-29 19:48:52 UTC,500023879,500013879,false,10000,0
4a5fd74d293abeb263f359d993f815eb2bc896b0ba1ba91587766f2343d0a9b0,989412,2020-09-29 19:48:52 UTC,50010000,50000000,false,10000,0
843b031e415c68fd67a28be2dbc2f11e7df405787904e2fc2e5ced0724ae22b0,989411,2020-09-29 19:48:19 UTC,2199990000,2199980000,false,10000,0
921c3eb9b9a23664bb6c62010846e63f62870f8f528147368c6f8dac19f57391,989409,2020-09-29 19:47:36 UTC,500002084,499992084,false,10000,0
b9cd2bc5df21133804dced312c4ca6e77a1db03e42e38ad3da99caafe12f8aad,989409,2020-09-29 19:47:36 UTC,500033879,500023879,false,10000,0
d8c7fe72312dcc1886c8c080e79056c4ea0c46143040976327dab38ab9f81d36,989409,2020-09-29 19:47:36 UTC,846142429,846139979,false,2450,0
997cc08420113a66319cf4e135e8f6580624791bb2e5529538bdc4bb4c15278d,989409,2020-09-29 19:47:36 UTC,100010000,100000000,false,10000,0
52323716ebb29899dc07588accebad50678eb17d21e09e9f3a17644d5f1b549c,989407,2020-09-29 19:46:18 UTC,182623759,182620799,false,2960,0
1dd3f33042f1f9a9b9526474d8e707747eb444ca445a5bedb05f20f182bdd345,989405,2020-09-29 19:45:54 UTC,151916265,151913305,false,2960,0
4fbb79f893a16a0589d34f98cc904011bab684ffeb418e1cc2b0e300a24d2cbd,989403,2020-09-29 19:44:24 UTC,209338060,209335100,false,2960,0
5308d6d3298fbdd3dae964fbbcc000d25054169e4e7226aeed62755dd917c182,989403,2020-09-29 19:44:24 UTC,55273439,55264894,false,8545,0
bd77df9b0eed1bb2bcceb9fb4addbc0bf270889d3c7d81497b16968e20dae810,989401,2020-09-29 19:42:40 UTC,8929470456,8929446056,false,24400,0
462507c1c2aa44712e89b3922cc73b76111019b285b01f4cff1732947664bc46,989400,2020-09-29 19:42:05 UTC,566059064,566037505,false,21559,989389
8a97b96aefb0f3b824f4cc58cf0f8d95ce4cd4be2b24dd31fce532cd0adff968,989400,2020-09-29 19:42:05 UTC,995107115,995097115,false,10000,0
7d61c5bc3ccdb37e33d1bcbcf9c1167340a76b2c3c7db09b8271fe99cdb2c8d1,989400,2020-09-29 19:42:05 UTC,152151788,152148828,false,2960,0
d44ea841c03ffc05b073fc74b3a72b19f120f86398d13e213e5c934290fb248f,989400,2020-09-29 19:42:05 UTC,265580003575,265580001491,false,2084,989389
ccb5b42317d265db178f328a735fe4eb6be92a7830f99e8c5b60fa8c7fd40207,989400,2020-09-29 19:42:05 UTC,250,,false,250,0
d5eddd863e74e5f5e407fac2d0235a887f116517a612a4db4b079d1fecdeb3a2,989400,2020-09-29 19:42:05 UTC,601011495,601002990,false,8505,0
c8d88b900cc6a2ee6ea4503bd22ed403dd25aa6d00b0e9c96dc07ce445ae65d0,989400,2020-09-29 19:42:05 UTC,1567519152,1567465960,false,53192,989389
458288c022b4f1844286e44f56da5293abb63f5c6163b9ca7ea5d4ff5e4f3bf7,989400,2020-09-29 19:42:05 UTC,1417876527,1417873127,false,3400,0
f7791878aa92963cfc64877ae64a6533f01856b45b890378222a32eb05f11f3e,989400,2020-09-29 19:42:05 UTC,55309330,55300785,false,8545,0
1f354206b70b65db769185fc0b131cbb42e48b940e9a1ee11f6fe8027bb0e54f,989400,2020-09-29 19:42:05 UTC,182775777,182772817,false,2960,0
4d6ac36285c56d4942ca864b191de7f407a425715b22b3f0d7c2693781b24f66,989400,2020-09-29 19:42:05 UTC,289717195988,289717190698,false,5290,0
aeecbda1afe7bbcde0a09710fb6ff17e6e926d377f9a94c6b85bea47227638c0,989400,2020-09-29 19:42:05 UTC,21862,11862,false,10000,0
3d6d461f80928836e07fe99ae4978bc44072bbc09a5412e93821d3972fb55deb,989399,2020-09-29 19:38:05 UTC,2000236516,2000226516,false,10000,0
460ff975846a0c6fc14471490fcbebcec329ef57d670616529f3e204e5dfd498,989399,2020-09-29 19:38:05 UTC,141687912,141685819,false,2093,989387
3a4255f02b7a5b7465d80248e2ce29d54caf06d880ab65d03dfefe0d78dbd12d,989399,2020-09-29 19:38:05 UTC,500012084,500002084,false,10000,0
aab2b63d3fc9d697eb9a79438e8924fa5ab1a040caafe30f6f7f9d738e2dcb82,989399,2020-09-29 19:38:05 UTC,11039840,11026346,false,13494,0
e2a8b492d36e78bd372aaa22b4b83a2856fefb7cc7bc31ad7b145c5300d1451a,989398,2020-09-29 19:36:46 UTC,1507089,1503740,false,3349,989387
091026f908800a40bd13c527e830fd17c094d5655c2d3375eacf8209abe65118,989398,2020-09-29 19:36:46 UTC,55358982,55350437,false,8545,0
2ec3c5462dcc8069f38afbf6b97891f5880d0f2be1ce3b041a51d806ab4b059c,989398,2020-09-29 19:36:46 UTC,16591169137,16590969137,false,200000,0
629c307ffb2303949b7e59355081b968fa180804c7437366b0e4a036523f2c02,989398,2020-09-29 19:36:46 UTC,321569100,321566650,false,2450,0
700b9111d259abe747995f01728fc29f8e1c5afb54d7dd438968c0df0576a681,989398,2020-09-29 19:36:46 UTC,511798867,511738867,false,60000,0
247b13a699a7b968c06fdf756a4a9b52ae4b7734033a531275b0d9a619849f7c,989398,2020-09-29 19:36:46 UTC,1007137312,1007068952,false,68360,0
2861653817add892ada1c1418499c9b0de3df87a691baae5249d724a96277d48,989398,2020-09-29 19:36:46 UTC,7354874,7344874,false,10000,0
8111f6d8cbe34fc6dc51447a43153b8d2c5388309c25e5c6bcacc6fed892e292,989398,2020-09-29 19:36:46 UTC,22425595,22415595,false,10000,0
c7083ad796db83465801dbf34045ffa4a1eb7cdd0f9d56efa9317dd643a867db,989398,2020-09-29 19:36:46 UTC,1700000000,1699978083,false,21917,989387
c1b982020e3168c613adacef4c9a638c9f0d2ea4b5f34290c952a687c900a46d,989397,2020-09-29 19:33:22 UTC,3447091549,3447087809,false,3740,0
02ce1815d3948ebe57b548946c83af1370b59cc7f728e8e0c84504fc77df9f18,989396,2020-09-29 19:33:03 UTC,2199990000,2199980000,false,10000,0
7e45e2d15ff2ef5876abee4d6e5a708d0be83ac714b629e2faa754249ba7d3fa,989396,2020-09-29 19:33:03 UTC,55453945,55445400,false,8545,0
1c3b139f7279b24cd3f56b81d43fc3420cdf9b9591c7f009fcd301d3a9a792bd,989394,2020-09-29 19:30:59 UTC,3000010000,3000000000,false,10000,0
4e888f96c3088344bc1d1d64dd10bf818a5b2c8a5c1747c5b05917b422e43d98,989394,2020-09-29 19:30:59 UTC,1568622541,1568573109,false,49432,989382
55de6804b84e779d5207f0f4ef3d830700ba4ca5aaf5795376da8b97e9927fc3,989394,2020-09-29 19:30:59 UTC,566621153,566599603,false,21550,989382
812ca13563a430dd5f0eeb363b45d8a2daa2745c105ad2cd8242441b9b573baa,989394,2020-09-29 19:30:59 UTC,209535824,209532557,false,3267,0
0441f52a071549cc57d8d2c6faad9bb6682c728343c120349574aaa79abe98f3,989391,2020-09-29 19:28:27 UTC,17852303704,17852291329,false,12375,0
e559723725b353f0fedd37e5f406fed5db12d7e5ac3be8a4463c02c8d544d70a,989391,2020-09-29 19:28:27 UTC,265584192959,265584190875,false,2084,989380
af23580d7750b9abaf0a6895f1c1f699352abda8454e27ee16cadb7e9df7ec12,989391,2020-09-29 19:28:27 UTC,2324534,2320794,false,3740,0
85ccce10f547053db2c7793e9911dedd72b549b8300592caaf7d38c810a139f0,989391,2020-09-29 19:28:27 UTC,152427441,152423868,false,3573,0
0ad792f0dce398bc26b869420906ee0d038a9ddeae9195a82c47ea346014acfd,989391,2020-09-29 19:28:27 UTC,51105411,51093326,false,12085,0
c6ece820542de4ca47d7356b6e488a7c773b6af587cd516fc84de3783c871b10,989390,2020-09-29 19:23:06 UTC,1000118198,1000108198,false,10000,0
8d39b39cdaaaa901df0ac7a1d708678cf344fdb546e13249e5ce44f9b4fb6b26,989390,2020-09-29 19:23:06 UTC,55481506,55472961,false,8545,0
033e1c90ff99029f71209161e4dcdcb4724ea60250f7203e6335a11bacda2bd3,989390,2020-09-29 19:23:06 UTC,182992870,182989603,false,3267,0
4a0fb35ce8316eefa6d558d5804e85c2dec64aa55322855abaec29c6077fa9d5,989390,2020-09-29 19:23:06 UTC,9234,6324,false,2910,0
e84a7547adcadc071076a1d24ffbb1898e8659379f686a0089830ac2dadd2dc5,989390,2020-09-29 19:23:06 UTC,178879886,178877793,false,2093,989378
0c2e345920ad472915dfbce3fe14aed6766e0e44a8a76e628603988cc8d38a87,989388,2020-09-29 19:20:50 UTC,299467996024,299467993059,false,2965,989336
41b08d5e7f63ec45a74efbd2228dd6d172ab4f97fd28d1c9878aeeda2d44706a,989388,2020-09-29 19:20:50 UTC,79872617305,79872614955,false,2350,0
51f461a3d30af8ef99fefa215feb6ab150eac88cae6fa51143f11e5da0b38ba1,989388,2020-09-29 19:20:50 UTC,1570038008,1569984500,false,53508,989377
ac12f33ae35f0e8a0e5ad4506f0ba8c92a78a6ced3c5a189412a50429a8d967a,989388,2020-09-29 19:20:50 UTC,21344438,21334438,false,10000,0
f5b7d735aa1ec266e35922acee7bdacc924a1706b1924b87aef3c6ea2d740b67,989388,2020-09-29 19:20:50 UTC,55509312,55500767,false,8545,0
9609580c5eddbc07d98a21c7b6c8963c7b0a3be9dca1e59da3066d35f65a2c47,989388,2020-09-29 19:20:50 UTC,251782960,251772960,false,10000,0
abc39fadc0eb354bd71ee1970102b76080750b21789f5f2f6728bf118f788696,989388,2020-09-29 19:20:50 UTC,567516815,567487412,false,29403,989377
547ff579b0027ba86b1708f4a0e5b4b327950cd5aace11d0086e02e2f13d1116,989387,2020-09-29 19:17:28 UTC,209747037,209743770,false,3267,0
97fa98dfbf0576e7d4a13a335932632a077e4c78c8cb40ab492b41d4d1fd8303,989387,2020-09-29 19:17:28 UTC,1558723581,1558655221,false,68360,0
cd1dfbab88aa75afee7ff4e9537deaf9f957a591f94b2df085def6b073c95b1d,989386,2020-09-29 19:16:56 UTC,341266998408,341266996024,false,2384,989375
51ab9356c95b0b3e308fda1a1464d0fc3e67e3ab64b163ec6c37b38f293c4802,989386,2020-09-29 19:16:56 UTC,250,,false,250,0
8bc108c946211fee24c50a8cc0bf62f499e53a8a5addac4641b44987a29cc28a,989385,2020-09-29 19:15:30 UTC,499281783,499271783,false,10000,0
5125ece126a73fd9e3c494a8331f8f2fcff5cc509374a1d42132c18cf5f36fa9,989384,2020-09-29 19:14:25 UTC,275755605,275735026,false,20579,0
aff0c6745fe16762a4e09e7b3e17905564374ddf05b78fabb8b048a052fe8894,989384,2020-09-29 19:14:25 UTC,152861520,152857641,false,3879,0
a5749934b38edb58824015745dce2ddb5e1a12b1825d78cc2fd64ef93fddce43,989383,2020-09-29 19:12:19 UTC,344259813192,344259811108,false,2084,989307
a064f7b4a2172ca934bc763270af7c1751021f64125cbe8a95ecee5ef432dbf8,989383,2020-09-29 19:12:19 UTC,568346421,568320522,false,25899,989372
91ef5d3ed3aa9bc7e461cc5bdc0677f5667d355790cdda5a6addc90dc8d23eed,989383,2020-09-29 19:12:19 UTC,1247922093,1247904530,false,17563,0
d3ba91d8d29bbda04d37f2a66f37029d5dfb5f6d89819ffcbf682d06c2eea01c,989383,2020-09-29 19:12:19 UTC,1571223679,1571178314,false,45365,989337
542953918f7e3e538591e23d636ec4e842a0f01451dd59c66cf06e6f341367b5,989383,2020-09-29 19:12:19 UTC,79537166858,79537156858,false,10000,0
c28576e4ae8bd1cd22165447a62e77e381abf32ab51cd07825fc74e8ad9f21ea,989383,2020-09-29 19:12:19 UTC,42504,32504,false,10000,0
c1d8807ccba43f800c8b0eb6b39130a708cdc9afcc0e8bae4cd57d6ba1f20b1b,989382,2020-09-29 19:09:48 UTC,652999620,652997170,false,2450,0
cd30350ded1d035257ec5da3f766abbc5d2946bcfcc517c87671d2112c66098d,989382,2020-09-29 19:09:48 UTC,55772429,55763884,false,8545,0
288124452f559fa9efd0264d93034d988b2e218db23eb39bbfa36607f2f9273a,989381,2020-09-29 19:08:08 UTC,183196750,183193483,false,3267,0
60e11abd857ef9d7f0ff77cf58450a07a1a61fa0c412450a05fb755fa2ee04b3,989381,2020-09-29 19:08:08 UTC,102390000,102380000,false,10000,0
df8cf22c8c574a3af146dc100665dd55ca12db6d67cc93ffdab3bc379fac65c3,989381,2020-09-29 19:08:08 UTC,1000132807,1000122807,false,10000,0
3b6bbbc56a83664f121f94829459b1e6f3222d770fee1bc9cec4c505c65a9166,989381,2020-09-29 19:08:08 UTC,2023567644,2023560492,false,7152,989369
d02e0179643f9506df2b68132b66e073f93e3c8c2b1189404060bde231670c6a,989380,2020-09-29 19:07:01 UTC,320577254,320567254,false,10000,0
2923b06d0416662982740cf137b64de3dbdc15b4dfcd52ef02a35788cdd79ce4,989380,2020-09-29 19:07:01 UTC,273568807,273566141,false,2666,989274
ecae2c3bd5c6ed8c2f33d3180e6dbed6a5412732a1a13c28a429e4ee5facc834,989380,2020-09-29 19:07:01 UTC,10000,,false,10000,0
8b83257470788e5fda9887e8f41c2177e1139fa9db9407f030d0fcf447aedc21,989380,2020-09-29 19:07:01 UTC,1625999243,1625993365,false,5878,989368
9304c73a92e57f18f22154b1c4db2d6899d653ab916e3240df60a7748f419992,989380,2020-09-29 19:07:01 UTC,500024204,500014204,false,10000,0
ae27a452f98adbf23762b2c09f7178ddb67c5ccfcf976e2c70116529e2d44ccc,989379,2020-09-29 19:05:19 UTC,3500585813,3500575813,false,10000,0
7f05ba985c4e61d7f8c808506608b8b1b2b970428f480543175ea9f0dc1833d1,989379,2020-09-29 19:05:19 UTC,10387893,10375893,false,12000,0
0cb46ff5b33a2ba08324539de7f8393e033dd4e95b46905af0890c64c47fe72a,989379,2020-09-29 19:05:19 UTC,251817500,251807500,false,10000,0
b618bf3a8b6e6d3b3514e6c710a435912cca8634b3acc2fbb274f8b607d488e0,989379,2020-09-29 19:05:19 UTC,210058232,210054353,false,3879,0
ad1887b91225cfcc131440c1331d4ff7cd2be90109e76977e99e55ce88fd7345,989379,2020-09-29 19:05:19 UTC,345159856697,345159854604,false,2093,989368
bbeb8619e046ac89194cce3f59ec2c61d3cebc9a1211254f1d72c5f9767f4f19,989379,2020-09-29 19:05:19 UTC,1500100596,1500090596,false,10000,0
82b06cd92ec78c7c50d7bd8d9ad8eb51905f873ef0b3d66c38d5ec9479ca2a69,989379,2020-09-29 19:05:19 UTC,223232592,223232140,false,452,0
22af6987cf30f4ebb3e8ab2e235c780db2bdea6dbafb3393ca7de21e33ac5a88,989379,2020-09-29 19:05:19 UTC,55808924,55800379,false,8545,0
b2637c265765f1b6ab78ba83da724eb0795b7bd8bb32b8a3ecafb8847e7b2ffe,989379,2020-09-29 19:05:19 UTC,1999500000,1999497740,false,2260,0
b18d6d9b290d7e38c02b0e1f221c7ad5ce866d62ecf1576c54afac646ac51285,989379,2020-09-29 19:05:19 UTC,17973644000,17973634000,false,10000,0
f2ccce5a2b085ccdae7a66669880438eedbf9c1b452963366b6f0d59c815b62a,989379,2020-09-29 19:05:19 UTC,445148980,445147060,false,1920,0
abe115acacf5639fb787798d9eae2ce495044d67a64eb8b72ae49f6d6092edf5,989379,2020-09-29 19:05:19 UTC,1015538,1013454,false,2084,989368
ecda79a520d4bec3952f0488fecc92869e51bd1c8e512116aa5e85b8860bd76f,989379,2020-09-29 19:05:19 UTC,244541032554,244541022554,false,10000,0
9482321e49de2a5b435acb90913d65016ded24d83532b304063be6fa67160e94,989378,2020-09-29 19:01:45 UTC,568861878,568841191,false,20687,989367
f2bc45d8511ece0da102a7ee41e4d3afa5458f2f92efef1ea692f028aa0683a6,989378,2020-09-29 19:01:45 UTC,1110003785,1110000530,false,3255,989367
ec5dddf30e94d8d2c6f14f49e8e15996261d22774bbca0d507fe60f4f79d02dc,989378,2020-09-29 19:01:45 UTC,163000000000,162990000000,false,10000000,0
08a8ba4d542309ad5ef5c1392c6a053e6ab918ab513419f7f2c75f0960d47fde,989378,2020-09-29 19:01:45 UTC,251817500,251807500,false,10000,0
2a494165351e85bb3fa179b920b66cdbbc0dbd0f0e53580c9b26f16659b1b014,989378,2020-09-29 19:01:45 UTC,1572453165,1572395051,false,58114,989367
8c689f710e64d7eb62030779035418d56ac49240a24836840069bc82dc6616db,989378,2020-09-29 19:01:45 UTC,16596137364,16596037364,false,100000,989367
5603fc1e2be3cde97dbf7c9849d49476c23de75f986446592c51c4b5ec168c0c,989378,2020-09-29 19:01:45 UTC,1350353,1345739,false,4614,989367
b1102e8c4fe28c37ba4d63a679429692012a1ea494a436188862646770a7cd4b,989378,2020-09-29 19:01:45 UTC,1827160448,1827157483,false,2965,989367
839a626c1faf1f5785634307a4b290b7f3da72cc7213b0b72e6254ccc6aa0edb,989378,2020-09-29 19:01:45 UTC,198103667,198100267,false,3400,0
2b5fe773307b9593f39de2d4c98204cff7ae948c01e31578d4c6a59c4d0cb78d,989378,2020-09-29 19:01:45 UTC,345209358781,345209356697,false,2084,989367
419cd6ea4c49e5c908da1dae8b52e1826f0c3d9f3112afef7053bc9405fc9f35,989377,2020-09-29 18:59:01 UTC,9008121385,9008120481,false,904,0
1675ffe2b7139327ba9be84fbd51596e4585626b7bf260e5461f772c8235a25d,989377,2020-09-29 18:59:01 UTC,55876827,55868282,false,8545,0
06658c425152f012925016eebd56e0473f048c114849086746b8d1712d934886,989377,2020-09-29 18:59:01 UTC,320578400,320577254,false,1146,0
b1a18701937eb6470f3817ece3242987504455d0ff1028164299d911bd54f47d,989377,2020-09-29 18:59:01 UTC,142961002,142892642,false,68360,0
3ffdc53c80c8417afaa1bf58d5e6afc3e1e5b6b11162b45ae51087e3605e8b5e,989377,2020-09-29 18:59:01 UTC,79910888379,79910886029,false,2350,0
289b60e2d20366254dfb30bd3ca66f02790ff1e665eac9a29596d5411c16abff,989376,2020-09-29 18:57:50 UTC,346224343964,346224341581,false,2383,989300
ca908bbc0365c667be4d572cc874b2d6f553727f2fd7e1bbc713f815a479d211,989375,2020-09-29 18:57:42 UTC,14081872698,14081653948,false,218750,0
3d0e7dc1a195db27d7b7ef26c3c423322007b9f3356150adef46000a1f7c1486,989375,2020-09-29 18:57:42 UTC,17581133,17561397,false,19736,989363
89067c07b39e34b47623c087698bc3dda90f1d69a49db96c9c74590d515a8341,989375,2020-09-29 18:57:42 UTC,153046287,153043327,false,2960,0
341ee46410efa824bb23465ae02cffc9beaf9670f8262ed99b68290d65c889ec,989375,2020-09-29 18:57:42 UTC,6300888,6298438,false,2450,0
16268783a5f88ea989de4036cfabafb0fc37d759036be36f5681223c2012368b,989373,2020-09-29 18:55:47 UTC,1894492484,1894482484,false,10000,0
0b66431eaed229aa0f4c0019c87bc45debefdaf4e2af3d39f7997816e58be707,989371,2020-09-29 18:54:49 UTC,4527071742830,4527071712920,false,29910,0
42e3302e02f95edade1e3b033bd472ff346a3d7b12d1584fc106c0fa212f2f41,989370,2020-09-29 18:54:18 UTC,127604,117604,false,10000,0
a0024201f89059540ff6b6b7de0b8582c5e2566af26dd4a2f3b0eec427c11c0a,989370,2020-09-29 18:54:18 UTC,10000,,false,10000,0
567c45cbd26cb82562c7671aca6ae5d7fca39031fa6bdb38321f42e36bac6f94,989370,2020-09-29 18:54:18 UTC,183518751,183515484,false,3267,0
93c1a2116cb930d293f7e2ebabfbc53c071bc77c1abe8a6bfaecddfcfd4d0919,989370,2020-09-29 18:54:18 UTC,1700097740,1700094000,false,3740,0
b6cb551ba004d51c291bf2810bcd2efe5f7befec82edd0eaa728a13fe16886c7,989370,2020-09-29 18:54:18 UTC,55904690,55896146,false,8544,0
5f6cf3b8a49ed8e1d699c54f1a844b86cacee81b1e7a5c3c006e3c5f28798e24,989370,2020-09-29 18:54:18 UTC,26895868,26891255,false,4613,989359
c27163d73a32f84ff503cc6128cb3f9adad3dccc5920ae6d09d23342822e1f6c,989370,2020-09-29 18:54:18 UTC,24217414077,24217401702,false,12375,0
219d6f46ba621a8dc1bf41870ad24a6b32a6c36b40d1ea88c25808a9bce81a44,989370,2020-09-29 18:54:18 UTC,162913402241,162913398081,false,4160,0
80ec61663c1cac7aa81d2d7e31999393797bb23ba1ae368a6c60ffec2a1310e1,989370,2020-09-29 18:54:18 UTC,251817500,251807500,false,10000,0
3d7c90c71bc748f42faccc50ed733550265d5fa7d7d60500e5381690f3a28f98,989370,2020-09-29 18:54:18 UTC,598829572,598829120,false,452,0
474a944cbb153f75c254617e6ca3c1fd2ba6cec0fc167cce3d1a18a059a8fafe,989370,2020-09-29 18:54:18 UTC,1713303225,1713224185,false,79040,0
27d1b8048806c0222fd444a2c07fb62a7f45cfafef15e73b3a2948147e7a2316,989370,2020-09-29 18:54:18 UTC,55936982,55928438,false,8544,0
a43045a9a1c8f9454241304ef13930f6607880f430fb7796c4919eaa564ddcf3,989369,2020-09-29 18:51:30 UTC,346228623657,346228621564,false,2093,989357
4e9286d7b5053cd20bbe089b1b7dbab69cea8a8efdba75c489b21be3e07961e3,989368,2020-09-29 18:51:24 UTC,55967261,55958717,false,8544,0
b7ee417db5ada8b9c8fc14b6d9993c050bcc264de816d4d215d7f7fd86d2f96a,989368,2020-09-29 18:51:24 UTC,210219661,210216701,false,2960,0
6fc4dfc2dc5dcffc3eab38c20fe0953971288600f4d57ef234235651c1740d3a,989368,2020-09-29 18:51:24 UTC,10000,,false,10000,0
fc2c71c67340deadd9296d58623fe5d212fe52e3b30cbc052b22848915465e8d,989367,2020-09-29 18:50:18 UTC,56703879,56694890,false,8989,989355
27328147b857f2a48162eec740598d18164e090b56598c1b9707be84c6c50613,989367,2020-09-29 18:50:18 UTC,2000002688,1999999000,false,3688,0
553d2d9a3c7dc8a0c30621b8a86b67bfffd8096b4688333744b762839c6fdd25,989367,2020-09-29 18:50:18 UTC,569575078,569551224,false,23854,989356
604b1fccf63f44f7c916bce8686546598bb1ffeb7d9ed074094740c2f008adc1,989367,2020-09-29 18:50:18 UTC,55999359,55990815,false,8544,0
b14e15dadd2b9b6abab96bbc2819355ebc70e3885fb709b565ee30146fdb6533,989367,2020-09-29 18:50:18 UTC,79702954,79692954,false,10000,0
5ba19f8a1c68d6f668a5b16b0005bb26d53652f97e39754e3867f5b2923e1957,989367,2020-09-29 18:50:18 UTC,5989110093,5989101903,false,8190,0
2d0796f9122c51870c34072d8b4e2678ad1e5fe107747d5a2aeda6a5c1916f2b,989367,2020-09-29 18:50:18 UTC,1573774379,1573720322,false,54057,989356
a030250603c3500a0b13e8b7553856ba7193565eb3b49f971e4dabd329306f81,989366,2020-09-29 18:48:33 UTC,346293908750,346293906657,false,2093,989354
add78f0eb44e92e5eb12048967b7179f6f7890a8ecd571949be3357f3e1d1888,989366,2020-09-29 18:48:33 UTC,10000,,false,10000,0
83698b049d0fb265574b0979340fa7fef7fc85b69319c532463b4bf75d23c148,989366,2020-09-29 18:48:33 UTC,10000,,false,10000,0
7d383b8523c6c34c3ceeef52ccd0f1e276a7af85040ce8009183d8412ecaec20,989366,2020-09-29 18:48:33 UTC,153251199,153248239,false,2960,0
e83963114b12eff73ba516a5242fe9079b9483cccefbee45b4e948212e9287ff,989366,2020-09-29 18:48:33 UTC,56058594,56050050,false,8544,0
7be52d92b831a92575523fe8e8e1f49c341a5fd42f7eeaf406469e3338695c4c,989364,2020-09-29 18:45:52 UTC,183763118,183759545,false,3573,0
84c019c9de0aac0291006a81ef50bc1e17a4d3733de3509805bbf63f0ba2db08,989364,2020-09-29 18:45:52 UTC,56259745,56251201,false,8544,0
678eb1acf8233f3f009d736b5586e33535deb206402251d31131eb4052cbe300,989364,2020-09-29 18:45:52 UTC,2051660216,2051630216,false,30000,0
3dfe01d8c26c1b3d0040ffaff4d5f52ae1dba75eb06fb9d404c2297723126c8e,989364,2020-09-29 18:45:52 UTC,19698939913,19698929913,false,10000,0
9ffa8e04f6dc5b5b19cbd8e81a6df5ddac65c9b1ac6c585b38c5623168562357,989363,2020-09-29 18:44:01 UTC,55638,45638,false,10000,0
d59eae08207d5285830dc64bcae6b21ac736f7f237fe6b0d703a2a6edddf67dd,989363,2020-09-29 18:44:01 UTC,56305866,56297322,false,8544,0
b716f46e26730cb9f8fbd12794cb8af5581ceba0487633b427ec0bf7d78ca9dc,989363,2020-09-29 18:44:01 UTC,62522889,62512889,false,10000,0
47b3af1d5e2a5e897e1fa2b6dfb0a7075e0211def79317e7f25029574612ae81,989361,2020-09-29 18:42:35 UTC,45436206,45426206,false,10000,0
7abea10105f0bcdab6ffbbfdd1e21ece24ea8ea9d59770cc44c06cfb4f08e1c9,989360,2020-09-29 18:42:11 UTC,29901424142,29901420793,false,3349,989349
fd56d4fd72255f19a60867dcb7c340beddf3ec4a8307cbf5a6276a8166bdc329,989360,2020-09-29 18:42:11 UTC,499980000,499970000,false,10000,0
694d1d7b687aab519c0e2a0ca843e9b3d237ea26ca22e9d121debb1e035bf71b,989359,2020-09-29 18:41:29 UTC,1292459670,1292439650,false,20020,0
25a85033a4983134f9d8218e2b2a9263389d0c9c47ab33bfa218fc2805e12ad3,989359,2020-09-29 18:41:29 UTC,55995027813,55995027713,false,100,989347
3d262c71d8a1eb797f3613e377da270132c6025c7b7cc9d42c781ffc868289cd,989358,2020-09-29 18:40:36 UTC,1575005500,1574948230,false,57270,989345
b813366338ecabab4893dfe1c3b8c424534ede4819411232b5b5dd8e6cc13b66,989358,2020-09-29 18:40:36 UTC,705435492,705367140,false,68352,0
4872629f55dc10dd3bca707e0e046db191fd1689bf7f5ffe6af863ff9e716720,989358,2020-09-29 18:40:36 UTC,570422735,570399146,false,23589,989345
71a677f0c4f4a6cf1ac759c1403687708b96e2700b2dc22fbf1ba0bc4c33a0cc,989358,2020-09-29 18:40:36 UTC,39381748354,39381732774,false,15580,0
ee3d891505a1d0e81875b680760d929528db8437679eb8f1ad7433c4729c9822,989358,2020-09-29 18:40:36 UTC,10000,,false,10000,0
fab6605d3c1592f3bdd0072d36b34c0de74e88b7c2a06d637ab052259f5d84eb,989357,2020-09-29 18:40:05 UTC,32107813,32105277,false,2536,0
85f7c45608a191b5123002e706f3ee15a21671eba1432c65e640a5c32e20e415,989357,2020-09-29 18:40:05 UTC,210383557,210380597,false,2960,0
12f81a730a42e18a40279267332e38d72bad3d6133fc45cb4c40f68ce7747761,989356,2020-09-29 18:39:28 UTC,2763202436,2763188294,false,14142,0
c8859edc005fd297213048dfe30f827308e56352319286adf7346a7149d0201d,989356,2020-09-29 18:39:28 UTC,38263625,38261705,false,1920,0
9baee135186be4e633d62b46ec110e2b10fe39f6308ccee45236745194aa996c,989356,2020-09-29 18:39:28 UTC,1963244333330,1963244331237,false,2093,989345
5b51fa65974649d0b4a02cf4c4dcb5a47907a1c52d246f2bccdcf3394d89078f,989356,2020-09-29 18:39:28 UTC,29900000000,29899990000,false,10000,0
0b61248283d181f19e4bce93e871bc990d26dd9852d65166d953b8e1926139e9,989356,2020-09-29 18:39:28 UTC,23000010000,23000000000,false,10000,0
04fdda44553ed2e86fee1aaf5e969cdb5d89f8cde2af9d8cfbeeba47b89dcbcc,989356,2020-09-29 18:39:28 UTC,336386060,336383800,false,2260,0
dcb3c97cb514c3f2de4808f266d8b6e0b171fae7d9b4889080cc7f33b097cacb,989356,2020-09-29 18:39:28 UTC,38261705,38259169,false,2536,0
abe231b755f65719488911b51f56712abe07a1f8dcf7eccabe4b0d0f68e1f6ff,989356,2020-09-29 18:39:28 UTC,153424545,153421585,false,2960,0
423c261a2b842c82323f40cca199fea9998c447719b323023ba78ef4156e329a,989356,2020-09-29 18:39:28 UTC,41826061,41456701,false,369360,989355
10d2ac333e9ca337d7f606f2c0505f32c4032dda833baeb4dd7d49e5f9e05488,989356,2020-09-29 18:39:28 UTC,318666583,318656583,false,10000,0
3dcba949925782ba08231212cba91509e7788593ee67a9ed106eae70dc0c55cb,989356,2020-09-29 18:39:28 UTC,347733651834,347733649750,false,2084,989343
11ed1bcb728fb0cf5d92f1115d046d7f0096aa2f635361ba80282dd1ac0226b7,989356,2020-09-29 18:39:28 UTC,200000000,199997740,false,2260,0
1f0cd264ef69ca3c113636562e527a92e1f3b659229ee49f4608a758124e5bfc,989356,2020-09-29 18:39:28 UTC,2000160177,2000150177,false,10000,0
bdc6027d521354419f4caf74fb65c666692f61b73a4190fc2b261cb2952325a8,989356,2020-09-29 18:39:28 UTC,4900104092,4900101832,false,2260,0
e0cbef0dd0ecbb86f0975e5ef0bdd25672b97a752b0012f1e7cfb6a2ddf670d9,989355,2020-09-29 18:36:58 UTC,499990000,499980000,false,10000,0
1c3be8ccaffd4453248e09fe3acfa70b947216800b9ed486535b1b019000a83a,989354,2020-09-29 18:36:37 UTC,183925377,183922417,false,2960,0
7725d31554bda39f8526d431d37c753371854ca92a3525c5105c6727dead5588,989351,2020-09-29 18:34:55 UTC,210645976,210642709,false,3267,0
8212a53037d77cc5b2f26760421e83cc81d9b38400c78a53206e14a8cf983812,989351,2020-09-29 18:34:55 UTC,6482796000,6482792651,false,3349,989339
3ad118c96e26be3180cf6d75ca4ba793aa3d9141fdafa0d0a159d50bb197d76f,989351,2020-09-29 18:34:55 UTC,500000000,499990000,false,10000,0
525afdc19fdb30d4029772b7c09cb03e37445991469edb0f908b462d6a53773e,989351,2020-09-29 18:34:55 UTC,19624049692,19624039692,false,10000,0
846b59bc35c8cf1dd723c56fea9fee5f07693544b0c9c5c1d98958109aef89b8,989351,2020-09-29 18:34:55 UTC,50454265,50450525,false,3740,0
28c44150ce3f024a9744e2c9bc495b996d75bbc9c21c7896883f5b6283ec462e,989351,2020-09-29 18:34:55 UTC,56410648,56402104,false,8544,0
e49a02149ed942be9b712a9e9ab33f35602dfd2410dafcb8e93d4d2cd9fd7595,989351,2020-09-29 18:34:55 UTC,50000000,49998080,false,1920,0
09dba19803c7e1e1b263eaaca6c014b60615f22b1c9c3b04e05503d3b928c9c4,989351,2020-09-29 18:34:55 UTC,349733153927,349733151834,false,2093,989340
eb34de0bd39b4cbf506beac3948107cc1cee76ddb4d94a5853717f6ce57444c4,989351,2020-09-29 18:34:55 UTC,201658,191658,false,10000,0
2309c9307fa2dcd08920a9d9c7c2e813e4514ce77a64ca44da9b74bdf2368eb2,989350,2020-09-29 18:32:44 UTC,802709760,802707699,false,2061,0
f49520ee7165eb6288b0af8828486975e4cd2c3e99b0486b0fa52260b6041c4e,989350,2020-09-29 18:32:44 UTC,349762827707,349762825614,false,2093,989339
14a3605762cc08808b897701a87e9558e9c499a477aad91d068f9b5d9e959079,989350,2020-09-29 18:32:44 UTC,500273531,500263531,false,10000,0
bc5d87d91d50b36b7bf033ff75791d44ac5d7ab188a6b5c672a08d869100c992,989348,2020-09-29 18:31:42 UTC,23200000000,23199990000,false,10000,0
3580be4328ed6d7eedd65dc54cef3ca579b53141b679512c9c2e67a58972b315,989348,2020-09-29 18:31:42 UTC,153588596,153585636,false,2960,0
3ecd59d1b21cf218b987add934ac8a93899597c2bdd73ccfa5c05e59d4915189,989348,2020-09-29 18:31:42 UTC,119022580839,119022578489,false,2350,0
94fe2509992c49a62c465b703db5afa90f35a3f86a5823c69506104b5464b74a,989348,2020-09-29 18:31:42 UTC,528918889,528881449,false,37440,0
8e0c3082c331284d92f8f8843b73b0dbb34b53ed538e90cd585567f7365ee1b5,989348,2020-09-29 18:31:42 UTC,112336979,112282520,false,54459,0
5f11c8439aee16a775b402ee102691f72f2a39702a85e5a446c1911da0deaad4,989347,2020-09-29 18:30:15 UTC,571243474,571217868,false,25606,989335
82b5930fb94f2f7be3df56e8378fbaa7a5ccd87ce1a39d29860e8f490f282984,989347,2020-09-29 18:30:15 UTC,1576030053,1575976278,false,53775,989246
b9c22448b27454ef34820a825ff48052703a02ecff1374da3d4946043e7e74c5,989346,2020-09-29 18:30:01 UTC,56555116,56546572,false,8544,0
44e5f1e59466e7bb9c950606df7417e126005bd6437b33e310ca8e9054c40e51,989345,2020-09-29 18:29:35 UTC,16612709487,16612609487,false,100000,989333
d0036dd5a3d123bb74e4090d87f8e5d853ed8cea3c101d83b45de8a946510a04,989345,2020-09-29 18:29:35 UTC,56595840,56587296,false,8544,0
13cdc841e6c98c8fdf70f066b3453035be2d8dcc0e3383e4f178eea4ec49996d,989345,2020-09-29 18:29:35 UTC,56619184,56613184,false,6000,0
1065294e0def32866b7f3b14d2c4f1f7c4a842cbe6e896a352c02948dd5936d4,989345,2020-09-29 18:29:35 UTC,184075820,184072860,false,2960,0
df812152719d4b931ca6178788e4c55b688a93cbefe098748477b18a918cee22,989345,2020-09-29 18:29:35 UTC,32272303,32269853,false,2450,0
64ba9c25e047823b67a88b7023f2520ed4515cfc624da11cc2471effe5fd8f77,989343,2020-09-29 18:26:14 UTC,372962829800,372962827707,false,2093,989332
0670a4a7463fc51456d0a59114e5483889fd7597c74c03005fd83cc56294415d,989343,2020-09-29 18:26:14 UTC,3383753,3375209,false,8544,0
c5608d1e194ace86fa76c7f13643ad8a836a748253364edab9202fad02461b77,989343,2020-09-29 18:26:14 UTC,56682916,56674372,false,8544,0
c58750261520d318532341a35c358ecc9bcd1380ab49a85eb6d5ec85f1c7d293,989343,2020-09-29 18:26:14 UTC,210793812,210790852,false,2960,0
d45a7df3320b86e15192b0bbbc859791a8f2b24f93b06f0748771bd9848bacbf,989343,2020-09-29 18:26:14 UTC,100000000,99997550,false,2450,0
6272fc45dee0f057d4c1e4ca6672f870ded6caefe117288698bfe7107cf07dd5,989342,2020-09-29 18:23:51 UTC,1028709832,1028641480,false,68352,0
c53ccc4da1ac95b095095847adb7f5ff461de426513098b55949f64ddeb1224b,989342,2020-09-29 18:23:51 UTC,2038460936,2038450936,false,10000,0
fee8eb4c240fb0768fbedf92872b361f7cf70a1be77fff805cd00b1cc67b0509,989342,2020-09-29 18:23:51 UTC,103086570,103081350,false,5220,0
0c250026f38f4cf70f7daed23be356e7eb5cfcf21c4006053836d7f69b81e6ec,989342,2020-09-29 18:23:51 UTC,102914,98600,false,4314,989278
df9202d01a4e0c731c8b216df0812d45d671fb0519e4a74bdaf34a4494db5cbd,989342,2020-09-29 18:23:51 UTC,10000,,false,10000,0
4e826970fb0a876156b55284a906e028602126998a40b18a94c81076d94201a8,989342,2020-09-29 18:23:51 UTC,380299842,380297749,false,2093,989331
453c705d601d88f5fa5f33b086a8971872e7520eb23bcf1cec2d3d4957a0562d,989342,2020-09-29 18:23:51 UTC,374063441193,374063439100,false,2093,989331
e9c52a01f82158c499ea9924460f7df96d358d254801ae37ff9ff6ad67b7648b,989342,2020-09-29 18:23:51 UTC,499999900,499989900,false,10000,0
662cd26e6dc3e3cc543d09774720b88ce3cd590dad4b33548b47f25d86438560,989342,2020-09-29 18:23:51 UTC,56751098,56742554,false,8544,0
2bdd7087a8095aaad9ee2f73d1a8263b2cec5bcb71cb8f1a7ffa77a5013ecd0d,989342,2020-09-29 18:23:51 UTC,56906902,56898358,false,8544,0
053e3326dae5dbf395c7f13f5f1a8b5e48e1d2794d5c17c03a846755a0649184,989342,2020-09-29 18:23:51 UTC,83496791571,83496789221,false,2350,0
3cd3449b3ce6f810d264c931b9742aa69ed09f9a9a98c8c9f14172f1a6aa76c7,989342,2020-09-29 18:23:51 UTC,37699483,37693483,false,6000,0
91f55270de7c2d2c39e3ed4fee330d8f59d761ed1be2d611f19b3c357b294b73,989342,2020-09-29 18:23:51 UTC,56801162,56792618,false,8544,0
9517e7a511d4a0fd9e0357b5cf4329c1d360a3a8cc59d341ba533a256b3a7313,989342,2020-09-29 18:23:51 UTC,153767140,153764180,false,2960,0
f89958ce7560872c133e1e4997267844585f7d9c30d05fc776cb603349006061,989341,2020-09-29 18:20:41 UTC,29477939,29452979,false,24960,0
4c6e71e79b74f439d6efec6f351386d99229a083f399d58b2400552d7533c299,989341,2020-09-29 18:20:41 UTC,1577331303,1577275212,false,56091,989330
7abed6ec57fbec41d67121d873e135ad2cab0c9d80132a59d4ed8a88391f8dbf,989341,2020-09-29 18:20:41 UTC,1085792941,1085427661,false,365280,989340
04a076ffa7c46248913365d0c2ba17deb6ac36e0bbc241fc2379e1f54b4079ef,989341,2020-09-29 18:20:41 UTC,174529338715,174529336365,false,2350,0
1c803370e721c01ecc4b1d69410b55d3531a845a20eb25cbcde711c89caa3e9c,989341,2020-09-29 18:20:41 UTC,699278389,699274978,false,3411,0
bf020d7fb36b79b9bb9467a47e8deb83b5533ba2888964c28a0ff1478933467d,989341,2020-09-29 18:20:41 UTC,571811007,571791783,false,19224,989330
cb6dcc45b220677bc42e2a1e34e3bd10180478f4c53562c1bc9dec035f9fa681,989341,2020-09-29 18:20:41 UTC,1100000000,1099997550,false,2450,0
ddd5ec61098e495bc145a5bd192c2e2179e63d897ebde6ef15529c8d8300e1d3,989340,2020-09-29 18:18:06 UTC,6481806000,6481796000,false,10000,0
6050ac9185759888011f35be3d2e6b1ae78c66db3550f86fb87faa68e83a6e2c,989340,2020-09-29 18:18:06 UTC,184245616,184242656,false,2960,0
daa2ac1676e812a04feba58f734c59fc338f7672e620430716adbd7eb273739a,989340,2020-09-29 18:18:06 UTC,100288524,100282524,false,6000,0
2f844d71fddb18cc91f455d8bd20faebbc5ce2c44fa6be3ece946b82b63dafde,989340,2020-09-29 18:18:06 UTC,227514,197514,false,30000,0
90580358145d3f858f99d908d764985066a02ee52dd9d70b6f756a0471ee89d0,989340,2020-09-29 18:18:06 UTC,57254570,57246026,false,8544,0
dc4ed532f6236e3aab25884863bb04e7a17554d72036ce8670426185ef1a3b26,989340,2020-09-29 18:18:06 UTC,10000,,false,10000,0
60b29b86a43f86a745dd7f084126f5955d5c4253239549518487d922d82bd449,989340,2020-09-29 18:18:06 UTC,211003595,211000328,false,3267,0
3ee815b2293b1eed7b7d1b4391edd32f2ff0b52be1a1c200b649180e8b138e91,989340,2020-09-29 18:18:06 UTC,374224455444,374224453351,false,2093,989328
d953fb13e1612fddf235211b9ab33bea92f526a6d8d55cf9fc2b3482df9b5449,989338,2020-09-29 18:13:30 UTC,332956,302956,false,30000,0
af5bed7d7523cf1ba9ed7334bf392ac8ff0a5b8d05e09f4389133bbffb3e3df9,989337,2020-09-29 18:12:49 UTC,382323957537,382323955444,false,2093,989326
92f180af32e70334e5881e0f10fa3fb55051f53b01d75dbf2044fa18c7085b45,989337,2020-09-29 18:12:49 UTC,10000,,false,10000,0
66231df5240d5d6c450caa0ecfb6d68092297cc047734977862802fbc30168fe,989337,2020-09-29 18:12:49 UTC,57411772,57403228,false,8544,0
e5725e13d227063240c2a2dd9be8e435cd15e5bc08da5f534b27dcfdf2a78724,989337,2020-09-29 18:12:49 UTC,403168269,403166184,false,2085,0
32dff2bef2ff6f915fd5f6f74fb8215a950e4b5d25da41948a5f73b9b4b7ab95,989337,2020-09-29 18:12:49 UTC,217694,187694,false,30000,0
001ec4490b2ab1bf3bbd0bd57ffd3d6c2381114ea7b8a687ad186eeb51e41d8b,989337,2020-09-29 18:12:49 UTC,1578711867,1578648582,false,63285,989326
0ab6d314eb9bccd81e40baf1753e4553eaf4decd2cd0f9d605c290c4aa42812e,989337,2020-09-29 18:12:49 UTC,153941217,153938257,false,2960,0
30611e33d8289cddef8ef4467c0156550b366610738213d4c2bf8b6a623e0e2a,989337,2020-09-29 18:12:49 UTC,572657675,572630078,false,27597,989326
596658ec36266ef88d0178dc98a0f6307376a849c4b33a768a45cf75658852b5,989337,2020-09-29 18:12:49 UTC,500283531,500273531,false,10000,0
13bb629e7317380b82301a7d446b46405303dfa313a82873517383c08cbc8abe,989337,2020-09-29 18:12:49 UTC,57332039,57323495,false,8544,0
40a32bdb78864c744fe361b62b096d9db2b25f47c9fab4659c9e1cf155bade86,989337,2020-09-29 18:12:49 UTC,4778690952,4778680952,false,10000,989325
10c113b44071208e921b0ba3caced14bea364e91ec958f59380ce9b041100649,989336,2020-09-29 18:08:18 UTC,9172145848,9172135848,false,10000,0
130220c715a95b327328086e06af5f2eeec650a0681485f8cade26100df18897,989336,2020-09-29 18:08:18 UTC,5000229811,5000219811,false,10000,0
247e444be729fa3f8ce784b8af73b5b2c668ba82f931ea14b5c9e7458330191d,989336,2020-09-29 18:08:18 UTC,2023491519,2023431539,false,59980,0
3dba99a6e16f9eb97bcb2ff4ed04fee45bbc17c15c69812cdf95f7d81941dd74,989336,2020-09-29 18:08:18 UTC,227680,197680,false,30000,0
5b5634223decb868cb7858e9fd99e6e44c3fb0262aee4f342a84708a58166513,989336,2020-09-29 18:08:18 UTC,184451681,184448721,false,2960,0
0f6cc092328b18b278ffb71a82849a17e4f208b4bf536c0e6324b42e3f76ea82,989336,2020-09-29 18:08:18 UTC,26854809487,26854709487,false,100000,989257
1f12b7c7c58d8e09ea90f922016eddcf0ae8a4b9ec9ad08554a31eca50404592,989336,2020-09-29 18:08:18 UTC,500293531,500283531,false,10000,0
660e159c9351a084e3d8dedc1ed99f0263c24cdfedd42b529401026125ed355d,989335,2020-09-29 18:06:11 UTC,500010000,500000000,false,10000,0
c0181f6b4e6e21022c9d87ad04862e61041bd843e2fc752f169339f8c585d1f9,989335,2020-09-29 18:06:11 UTC,2000012093,2000002093,false,10000,0
c9ef20b28200b70a3898474380fb31f1679ad2d52358ff683d295399ce776aea,989335,2020-09-29 18:06:11 UTC,436005,376005,false,60000,0
8d3053b799f0dae319e5a3a18c95e21e19ced43e434b10e3edf8c0fe5568ee0b,989335,2020-09-29 18:06:11 UTC,500018744,500008744,false,10000,0
f97e055905cf6acb9ba04106699c829b74e09db5aca2d0d2b16a1455245edaac,989335,2020-09-29 18:06:11 UTC,57469505,57460961,false,8544,0
9be7259e7a8ef66f0eb283f4576974b6ca36e440c9b26bd5951e0ad99f1d7974,989335,2020-09-29 18:06:11 UTC,211195117,211192157,false,2960,0
83c8fe753323975392fb5ee14758d786c8e1c92e9367e5c6a960ffe2e8215892,989335,2020-09-29 18:06:11 UTC,242987008444,242986998444,false,10000,0
19b4618ed87f34f3a7795395196202729b959401ed1b4ad132b501d38f1e65a6,989335,2020-09-29 18:06:11 UTC,57505135,57496591,false,8544,0
beace05a7e9fea084b86f0a3855bdf23a1c76e47ba70186e8faff41dd5628413,989335,2020-09-29 18:06:11 UTC,1500110596,1500100596,false,10000,0
862f0c609c217bb5cdc2a0d1bf30fe35e431d4bbbf43a8166eefd186272d273f,989334,2020-09-29 18:03:22 UTC,753060199,753048114,false,12085,0
504a5f9a37255fa6fe86ea3b68205cc105185df3e90abc50b00532937d658ef6,989333,2020-09-29 18:04:17 UTC,382389608621,382389606537,false,2084,989322
bf6cb3ec52611b20b775f692d11238f78a9ea4d67d74b4c2f7e158d4b8ad3f53,989333,2020-09-29 18:04:17 UTC,565386963,565318611,false,68352,0
9193b840e15eecf42edfb934a9e12397df11b1730559ff45f0a8db174810d525,989333,2020-09-29 18:04:17 UTC,270740250,270696192,false,44058,0
7d403720b51e2ab4a8a4583633c306bb4e6156f0d50b690b33be523602c844e0,989333,2020-09-29 18:04:17 UTC,412328453,412326360,false,2093,989322
f65a58b39f6b1bf4cbba3fffbbc75443fc3686f578714b056eb2c43bdd46e4e1,989333,2020-09-29 18:04:17 UTC,10000,,false,10000,0
afd56cb604e12f6df2ae7afb737ce8ebfece8de818cfdccbd55fb837953b301a,989332,2020-09-29 18:03:06 UTC,154407882,154403391,false,4491,0
1af77e19cfaf77cd53b96597f4ab8345a83c7fe226a6d003bc2db6e273e27ab1,989328,2020-09-29 18:01:55 UTC,1580345855,1580281639,false,64216,989317
a9e9ca2ea148cce16517dc78b4183ca8195408d76726dbdd0cb689d049846b95,989328,2020-09-29 18:01:55 UTC,72216484,72206484,false,10000,0
f4776ff0c5b058a694ebca5037533b62e3d3af6ae635c06a216b8a3eeb2dd709,989328,2020-09-29 18:01:55 UTC,1135587543,1135585168,false,2375,989317
ae438ef772629e94a3c4c07c2992f5ae9257e2829bab529768eb945dab913e9b,989328,2020-09-29 18:01:55 UTC,4439203,4437283,false,1920,0
68b0a064501099c21764df3edeb3848eab51686652fd6e729a1271f4a8fe0312,989328,2020-09-29 18:01:55 UTC,1917300229,1917296393,false,3836,989317
1b03477e0e98090c83d3d3c264e86a72fc42d33f1d5121eabed7b873d2a54ba3,989328,2020-09-29 18:01:55 UTC,57621357,57612813,false,8544,0
0483e84d0d7ce52c02aa854bd747382596efe73d3a22df9b451603591a853a41,989328,2020-09-29 18:01:55 UTC,4000232,3900232,false,100000,0
d2d4c539f1d244a2280acc59dd4edd5cb55b1e07ea87aaf1a425d4fde09965bf,989328,2020-09-29 18:01:55 UTC,179209959198,179209946823,false,12375,0
1baa7932638a52228571ec91c467fdae77833717bacd6db21faea1a137535915,989328,2020-09-29 18:01:55 UTC,573402942,573378797,false,24145,989317
39d5e9f5e8f90368de01cb8691161014007c62888d031dcfb8420bdd37ad6895,989326,2020-09-29 17:58:41 UTC,7685704970,7685697970,false,7000,0
27406a5bb73843d40794680b684bb08785d9e24aff35a70ab312eba3027586a3,989326,2020-09-29 17:58:41 UTC,1582296,1577691,false,4605,989312
98391f882e69fdf6ac8fb04a32aa45dddb05550cba534c3f0410ddbf72a02685,989325,2020-09-29 17:57:29 UTC,57675704,57667160,false,8544,0
410e171b4e272dcf443add7c14ebea08cf4b5b9ed7764384111836480dad6be7,989322,2020-09-29 17:56:33 UTC,551533,453413,false,98120,0
4ed58f6e0d65cc55392dee9e28dd8d78cebd0ebf2f61e8c2541291c5130a5637,989320,2020-09-29 17:55:51 UTC,1292878168,1292869663,false,8505,0
46e30dfe887a6f3ce13aa22db8dfa773e2fd2b4809b077dad65850d874e15fe7,989319,2020-09-29 17:55:20 UTC,19456132333,19456122333,false,10000,0
a0a1e6d8ef271600f17c5f92cb1c903f738ef333e9d8807fcf51172fdc542b9a,989319,2020-09-29 17:55:20 UTC,39957697,39955267,false,2430,0
c0761d5170b34a95cf5fd39176a2a0d0bc9bc8260b6b15aca9344a78f13fc6db,989319,2020-09-29 17:55:20 UTC,211344046,211341086,false,2960,0
8790dd28aaacdc6435c1100ed2d36b5f226dc58c81496fc810771cc841da7091,989319,2020-09-29 17:55:20 UTC,35554426452,35554414077,false,12375,0
6a44b440c4a08d7151887aa81a4c80063b6f32a07ccb9a1c32782c46ef4958fe,989319,2020-09-29 17:55:20 UTC,44512,34512,false,10000,0
85b65143456a7f68b6d8fdcebbb06d76a0688f31a0eda93b5c7d3c705a569f88,989319,2020-09-29 17:55:20 UTC,184737080,184733813,false,3267,0
28d2ee70b91b2e55a36ca48aad161bb9b9efccf3e3de75fba2cf699a3b7eae42,989319,2020-09-29 17:55:20 UTC,382455415714,382455413621,false,2093,989308
94ea77750271a1b9b4cdf4e62320059624c6e6d7059cad0bf2c7145aabd12458,989319,2020-09-29 17:55:20 UTC,1300015002,1300014002,false,1000,0
238da8ec84247c4ced224e43fa5943644a53b107debb899f18d4583400b4da83,989318,2020-09-29 17:52:46 UTC,54349355,54339355,false,10000,0
288cda9a8ac8f63163d2e14984b3a83b5561a0dcc28e4e4cbb8afdb07d2a16fe,989318,2020-09-29 17:52:46 UTC,19656263666,19656253666,false,10000,0
4d0a5c95f8e53265aadc3bf0402be3102f4230d3769853b0a61e040698083daf,989318,2020-09-29 17:52:46 UTC,235097000,235087000,false,10000,0
94cce86c36b43ebf545188c89af4ba0b410e790eb3565dec5918d2a0cde8d35f,989318,2020-09-29 17:52:46 UTC,191186535541,191186523166,false,12375,0
364a233d4f5e295ef606b0d4a73cbdadc993771ecd1846a8f1c77346c4af7549,989318,2020-09-29 17:52:46 UTC,57856759,57848215,false,8544,0
34460725d1f3b29ce8d787a9059cf7e620079109323aa0edad93065af21cbec5,989317,2020-09-29 17:51:03 UTC,19656273666,19656263666,false,10000,0
0a15e7cf38e2074348172d57eca340b6851bdf8931fc9b8710f9366e8d5961ba,989317,2020-09-29 17:51:03 UTC,15500091,15495486,false,4605,989306
af657ad13b6377e363324761e3e3241fda404c5116bdc025c6b5b78c7c9907be,989317,2020-09-29 17:51:03 UTC,154632240,154629280,false,2960,0
302640f86c9b2d22f2e694f16c48a010b393cf8bc1acea5ac7374ced0b55fa75,989317,2020-09-29 17:51:03 UTC,574045623,574021461,false,24162,989306
602d020528e9aada8d27107487dbe12698ce589e116b2d1ad542713eefca773e,989317,2020-09-29 17:51:03 UTC,1581783223,1581722527,false,60696,989306
e871abc0863c759035aad99ee5089992aada5c6c5ca611a60191afd5bf62b089,989317,2020-09-29 17:51:03 UTC,93412,87412,false,6000,0
94b4b3eeed92759562bb888090431d5f2343edf1e4822dac3572f86c8806e737,989315,2020-09-29 17:49:39 UTC,1275160000,1275150000,false,10000,0
81dd4b7b05a456f5b27b494cce565d0d9d71b33be17b7e2e50e46f189ff9bc83,989315,2020-09-29 17:49:39 UTC,184953545,184950278,false,3267,0
1e055a784b22ff8d91d0ebcaf71f68097355ecfd70ef9480476f16d421c57abb,989315,2020-09-29 17:49:39 UTC,567539500,567530000,false,9500,0
650230bce4dfeb6d9f480c7de1029c512dcb45b503231e7dcb26a1bb7039d2bd,989315,2020-09-29 17:49:39 UTC,20113680024,20113670024,false,10000,0
e25e954be8d2bd50f30102fae2b8441a5cd0d94b890375bea7d813dc2e8cc9d7,989308,2020-09-29 17:47:23 UTC,3570993146,3570954304,false,38842,0
5b82b2203af3da4d936cc4c18695b4ce693b13b642724d2981277840b7450424,989308,2020-09-29 17:47:23 UTC,57299500000,57299487915,false,12085,0
a8663d8717a6d2efa9690ca480a302266017741033711fe796e5471d9ebf1f4c,989308,2020-09-29 17:47:23 UTC,454564787,454562694,false,2093,989296
3c59e37ca818bdf23d9eed98233f202071eebbfcc0a67eb558d5cd8b2a541ce3,989307,2020-09-29 17:46:52 UTC,368870,358870,false,10000,0
18690fb738da2c675a76f8e82732e0a87d92274f50d81c2c2281be0035fd20f7,989307,2020-09-29 17:46:52 UTC,349970000,349960000,false,10000,0
21b431c1980b17d0869b1e0afc5a1bf549e7845c4825439a3092ad7268aa4611,989307,2020-09-29 17:46:52 UTC,211544845,211541885,false,2960,0
69fdc0c06bacb3c9a404d6ce40e2d7cc68991f91f4522a73886fa998c6bfebaf,989307,2020-09-29 17:46:52 UTC,382582523159,382582520784,false,2375,989296
b2d6514d471bbabc54d6f7f1038fef29c87daca7e8cdf291b270f52bdbc92946,989307,2020-09-29 17:46:52 UTC,58213521,58204977,false,8544,0
96d25a60c5dd0629dc497663af9df247a374700801707ef8fbe58430c259111f,989306,2020-09-29 17:44:44 UTC,575031449,575003519,false,27930,989295
a0de7898007957e52ec48f153efcf57f397b792aee2648d65a43dff202f0eda2,989306,2020-09-29 17:44:44 UTC,58495819,58487275,false,8544,0
e7ae841e6a58a1ed9fce3b630772b76e0494ea5cf1a24433728be84983828c11,989306,2020-09-29 17:44:44 UTC,10000,,false,10000,0
cda08e6b89032f70ad3ba9356ba49f02127bbfe824dc003974213671861f48ee,989306,2020-09-29 17:44:44 UTC,1393320,1389971,false,3349,989295
2b6fa565464122e30f619697a20b121b2244b96a3bb631be39221495165c0667,989306,2020-09-29 17:44:44 UTC,2000030637,2000020637,false,10000,0
84ff5d1d2e33d581a15da50b74210948385f386df145c1f4325370f1216d4f1d,989306,2020-09-29 17:44:44 UTC,185114943,185111983,false,2960,0
966c3b69402acf21d61f1ae994ae354a5ddc0ce84d42b03fa58c6d07dae2fd77,989306,2020-09-29 17:44:44 UTC,80332918299,80332915949,false,2350,0
84d4c6c792289de15aab314ef5cfee19e3cd5c9531b84dc3ac11ba79d23b292a,989306,2020-09-29 17:44:44 UTC,1901935,1899485,false,2450,0
a1831d63e230c606d1fae8b8828da9ff37256aa67b2d4d67db2d5b50af527fdf,989306,2020-09-29 17:44:44 UTC,888645257,888576905,false,68352,0
a0db343eca245c0149a910379c74c2740c4b8be5f7b3a09448e3d6eb4dcef6a0,989306,2020-09-29 17:44:44 UTC,185279951,185276991,false,2960,0
90cc05246e072111de26a4715b163770fe59ff807f78640e48f86baabbf764fa,989306,2020-09-29 17:44:44 UTC,211751544,211748277,false,3267,0
606bb4579ddad7f33f77687774e636a6f3556bb7d4ba880ed4fb1ef84d3ee017,989306,2020-09-29 17:44:44 UTC,1508124200,1508114200,false,10000,0
96e72da2c2c0392fbb0dc1f2ec18e2e792823168004502ff787d8b6dd6033004,989306,2020-09-29 17:44:44 UTC,1583127744,1583068483,false,59261,989295
61cbf844ba58e74ec078e588849e54e1883924a9b446f5c42447553387b73a95,989306,2020-09-29 17:44:44 UTC,58342696,58334152,false,8544,0
47dd2fd79643fc0604dc4440d85d93417250bc490d5302b0f050058ebb2c8d74,989306,2020-09-29 17:44:44 UTC,293950950,293942770,false,8180,0
5635e70efc30cc719da6f3fc68f2c2548d1f4bdf9ec14e1692af4268ead4f29e,989306,2020-09-29 17:44:44 UTC,58650725,58642181,false,8544,0
6ebe0bb36dc78bf6f9f90006951da43e8c3a18472fa0f39affd734788dd3a986,989306,2020-09-29 17:44:44 UTC,58701294,58692750,false,8544,0
c8417866c7111a5006ea1e075fa93dbe0ce8e2200b57a6000fdf9f744eb75116,989306,2020-09-29 17:44:44 UTC,12797768542,12797668542,false,100000,0
90777c355f2a4bb7ee544272f7fa2f5ec0886c33ef276e6be96e5a797484d1ff,989306,2020-09-29 17:44:44 UTC,77788930,77786670,false,2260,0
3a15cc5a236ceaed4d9cabae0294133ffa420c1d04c2d6c9ca3d1ea504f1ef3a,989306,2020-09-29 17:44:44 UTC,12737991,12722048,false,15943,989295
f6ec027a85902abeb8281c3c97f4d10ccb0a0cc280be7f7af145865576d51400,989306,2020-09-29 17:44:44 UTC,382648207252,382648205159,false,2093,989295
6cda26d596516613f64910be2a5ce4f8e284e22c16179991b3026177a02f720a,989306,2020-09-29 17:44:44 UTC,154794144,154791184,false,2960,0
99c67921097df383f3d9f16ea4eba9fe006a3041d307cc8f3f70063883b49749,989306,2020-09-29 17:44:44 UTC,58284199,58275655,false,8544,0
9c7ca4fa727b39846696452eca66f50f3da357f611ecb29ed05ed6491d523df3,989306,2020-09-29 17:44:44 UTC,20113690024,20113680024,false,10000,0
b33e2d2d18a3fe57188ca5128396ba8e50b8c3ba95e2519ae8825570e48f0375,989306,2020-09-29 17:44:44 UTC,211972314,211969047,false,3267,0
53cd51a450a5d34ffbeaa500be70922ecfc71a45062450c8a91f57db1327287a,989305,2020-09-29 17:35:57 UTC,2181331324,2181329231,false,2093,989293
fb33ef2c980f519c64683894c050412fb335c54d0444f32fb3ab2d25e4501ee9,989305,2020-09-29 17:35:57 UTC,81038635584,81038633234,false,2350,0
d7df04a8d9b5b31873afb9ccf09ee587b31d29169c76357730a34e29dba45d36,989304,2020-09-29 17:35:19 UTC,20457570361,20457560361,false,10000,0
61be7f8fd5f1c3fd454ee5254c420a5b6d2d9bc700f393793e097d2a63e8b98d,989303,2020-09-29 17:34:16 UTC,58743581,58735037,false,8544,0
bf2318f9076f2ca2e3606f002386565f4a752d8f7648b79507ede87745f80e01,989303,2020-09-29 17:34:16 UTC,499990000,499980000,false,10000,0
77af600d8cb5cd620e4eafcc988fe9b4ce3d9c21bf032c0b22eb5bf7146aba50,989303,2020-09-29 17:34:16 UTC,499997740,499995820,false,1920,0
22673b1dcd9112570e4e8ade6c9554e39f353cf4bd9d8ce92c28930695be671e,989303,2020-09-29 17:34:16 UTC,104456,94456,false,10000,0
8a1eeb755fe14e807b701c176d1e604ed7272b6b297bdab9d791241d4fd55ad2,989302,2020-09-29 17:33:05 UTC,212183568,212180301,false,3267,0
c11db7f4db743dfee767b0a97d9d6407bea6610a6b9951d0bbd3a85cd48e9dfa,989301,2020-09-29 17:32:30 UTC,500000000,499990000,false,10000,0
740e02e36156c9cf78383faaaa1bc6bf1ccd1ada6dfcf0852b6550e54dde1a94,989301,2020-09-29 17:32:30 UTC,354314669,354310929,false,3740,0
31eb264ceda234aa15c7d0376ef02bca5f10755691d4d3044cd34e1c1e4fab0f,989301,2020-09-29 17:32:30 UTC,1275170000,1275160000,false,10000,0
22ccb47b226bcf477f88f665951f35fce956db6d69635e45ed0c24c61d72a122,989301,2020-09-29 17:32:30 UTC,101468637046,101468567046,false,70000,0
b6fd33f117779d511d7257597e3e7cb431491969b666a23d518895439e96d692,989301,2020-09-29 17:32:30 UTC,306596453,306593733,false,2720,0
984219a57e8acb6fda41e2a4edd23b3732f221d8bcfa1b9568ff477c057dd169,989300,2020-09-29 17:31:33 UTC,51254366,51244366,false,10000,0
0c44d84ef687d866fca63ed0cd0c5dc13e39c9c9fc416db8af0a36014756684f,989296,2020-09-29 17:30:27 UTC,575775019,575748567,false,26452,989285
d80a479e1888d9cce778f9ea5c95ad47809c769e2d547356f7feece7b24df09a,989296,2020-09-29 17:30:27 UTC,598859115,598829572,false,29543,0
b69a698e9a9a849002924a452cbc5ce2d9974377153efc12654be7df9c41938b,989296,2020-09-29 17:30:27 UTC,1584119534,1584065784,false,53750,989262
f12e3a98691052420ed30d8a8ed9b963aa8a2aa48bbccc581e5de3dcfa8b4ba3,989296,2020-09-29 17:30:27 UTC,1524556278,1524554185,false,2093,989210
84ea8b2af777f53376765ef5fae0fabbe4d3a0596fe25c7ca692e8e55c331799,989293,2020-09-29 17:28:28 UTC,382654783045,382654780952,false,2093,989282
f337b12ed9d7a5797a1c8c77f8626a9b9f89600e2a4a4be769c27c95d14a5e02,989293,2020-09-29 17:28:28 UTC,154958921,154955961,false,2960,0
af8d475ad399d9b54c76c50557cd97e1a5df1ade3969cafe21b5ac5fc7f52db4,989292,2020-09-29 17:27:31 UTC,185438974,185436014,false,2960,0
b648ca8a458adf968173b211d616a9f305b1d250b3f3d89ee3e76dfe8c2c12b8,989291,2020-09-29 17:25:58 UTC,500072285,500062285,false,10000,0
ad0ca6b7f01a460f1bcac2bb10a2f6e6c9f585d7e149d8740a5ccf95dcb03327,989291,2020-09-29 17:25:58 UTC,425315315,425246963,false,68352,0
665a84c8712e14d52b05ba044c4ba83653f41b18bf14d062431308c63a054f19,989291,2020-09-29 17:25:58 UTC,15626,6306,false,9320,0
905a930e92b9b0a1f62614b1620ec8f82030aa77db1c87507ebab82747cd9225,989290,2020-09-29 17:24:41 UTC,212469496,212466536,false,2960,0
dfc7e88333b046b1db5ff8cb9294435d31187bf33e922031cd4a80fce9fa08ad,989290,2020-09-29 17:24:41 UTC,112267367,112264917,false,2450,0
68b5c63927fa8fc3b96afcf633b3b42e2bae1183da7b24a713cec4236b2c16d0,989290,2020-09-29 17:24:41 UTC,42588,38796,false,3792,0
d93c9e1c53f9442d79d9c3792c52ac0dcc4013e8c36590ef1db73b5fb4328312,989290,2020-09-29 17:24:41 UTC,39974819,39957697,false,17122,0
d439437e983dd8d4507f1a89ee8fb650b63966a5d5ef4b9b3c4c873ec10bc32d,989289,2020-09-29 17:23:36 UTC,500082285,500072285,false,10000,0
e5c7b35d0054a1c10276f046d20b403ecb6a410e16e1b8988f3e378e1e4bd629,989289,2020-09-29 17:23:36 UTC,4999990000,4999980000,false,10000,0
cad8ff83fe81f264bcd15ac1940a27b06c7cdc90b60a22180c104cbd5e59f0e7,989289,2020-09-29 17:23:36 UTC,103733213,103723213,false,10000,0
a64ed59e755f817c409af035cf239fe41dc69d73e4ec4b7ab3be7886056dc867,989289,2020-09-29 17:23:36 UTC,576970179,576958094,false,12085,0
bca4d8b63e2c1df66dbfdec9e9065314b7377b885a0f854fb1411559c16168c1,989289,2020-09-29 17:23:36 UTC,58811777,58803233,false,8544,0
ca71e02a1469c2c82f250a6c31f30f911647d51229114e7314e34c605ff14935,989289,2020-09-29 17:23:36 UTC,576669940,576643745,false,26195,989277
759cd179234aa841fe90a1b3260599932ec676eb94c0c9984bdfd618f343bfbf,989289,2020-09-29 17:23:36 UTC,155176443,155173176,false,3267,0
331986f4c0f3af6ddf459fc3c921d5b66fd235ff73fe0743589864c4e6fb076c,989289,2020-09-29 17:23:36 UTC,201280408195,201280395820,false,12375,0
94c159dc88979c5c0e102a84d5caf0b6a267c20b978c66133aa7678fd9342644,989289,2020-09-29 17:23:36 UTC,1585156768,1585103856,false,52912,989277
4f6bf83aa78ff3c7a4feb7cbdcbbc7b1d408ad4eef5f7254c49bc9490c356faf,989289,2020-09-29 17:23:36 UTC,383672785121,383672783045,false,2076,989278
5ed9d513630e8f8cdb8529b0c8d53d27eca99297c6ba5e07747e8273aecfd4dc,989289,2020-09-29 17:23:36 UTC,277289000,277279000,false,10000,0
d72cbaac71c868befabbc6ee85597ef59a7604215c9db5a9c32b94c0b6d53cd4,989289,2020-09-29 17:23:36 UTC,337390263,337389811,false,452,0
e69318b2e96de1edd3c29961214a460ed0122c61a453780da2fffce91f50f671,989289,2020-09-29 17:23:36 UTC,59060342,59051798,false,8544,0
5b4a56d71056753be08f52b09d806f030ce25f90fdc15843e3cd1d7d92c216c2,989288,2020-09-29 17:19:59 UTC,10000,,false,10000,0
5ae6bc1e57c5c84429a8c229273ea13ae5367d4eb1e6d64b62cce8d27ce3082a,989288,2020-09-29 17:19:59 UTC,499987525,499985441,false,2084,989277
9d283fb478ae5efdd9badf76e3f3a7c41367ae29f1184aa51ea13175cdf0cf2a,989287,2020-09-29 17:19:00 UTC,2500000000,2499997933,false,2067,989274
53209b434a0b17b875e6887bc5a4735c68d7cc42bda408c4fb92d9e2b23d6da6,989287,2020-09-29 17:19:00 UTC,2500000000,2499997907,false,2093,989274
ed7ab489f4cb248fd26cd32d67325ebc07d0cdf4b1fd9b10b9203dfb0991febc,989285,2020-09-29 17:18:28 UTC,676080380,676073600,false,6780,0
96d273f8f521e299b3957103b50a48cffdd586a8db6da5f901c747d86dd2bd15,989285,2020-09-29 17:18:28 UTC,10000,,false,10000,0
965fc95d9f28cdcb44e51ea7634070d1dd11b33b1dbbb0f028d1903cb754741d,989285,2020-09-29 17:18:28 UTC,359022374,359020114,false,2260,0
3a7c52fc47a89f81381a3a4748c27eec6560cd24a070dc071db6f1a89eb07800,989285,2020-09-29 17:18:28 UTC,588682844,588676844,false,6000,0
aa2cf11c0f4cee0d7398bd1d761e562167b1bd775b2806bfc03164d22455a1bb,989285,2020-09-29 17:18:28 UTC,136292322,136207019,false,85303,989273
8bdb8c0ac09f2491a0fe5a52227a91a73c2dcd633f1c608770036384ffc0ff2a,989284,2020-09-29 17:17:12 UTC,59468413,59459869,false,8544,0
961b40960edc4a0e4996c3cd7071c7fe1372f405b8b4aae548c74596752090d9,989284,2020-09-29 17:17:12 UTC,59396894,59388350,false,8544,0
b28fd8141dfffbdc2242bf018a2b770a10ef631b2e0e88e27a01efc9dc48fa24,989284,2020-09-29 17:17:12 UTC,50212668,50209268,false,3400,0
c33bd0f4fddeec04bfc15063049af16aa47cc381ebc6e545d7d9363b98582dc4,989284,2020-09-29 17:17:12 UTC,5847509085,5847502084,false,7001,0
2b1d0817548d6146e3c710a70680e9e68639eeef0a76b1a7edf1a4342f1eb76b,989284,2020-09-29 17:17:12 UTC,185674680,185671720,false,2960,0
00bff413b0bc8fe440b2a614f33f65a47818ed187f6669a10463af969eb6e567,989284,2020-09-29 17:17:12 UTC,1275200000,1275190000,false,10000,0
befbacf33f862076a6a50aecd39300e401b414b33eb2575afdc3c676d4d3b2fe,989284,2020-09-29 17:17:12 UTC,4540565621462,4540565575802,false,45660,0
8ff5d7020bc17836e0467e76ed08d5a79a735aedea5382b91189ab181b314379,989283,2020-09-29 17:15:55 UTC,389572287487,389572285121,false,2366,989271
9af723965f9541fc95b3041ee3417909d1ab0932d2c94733c315d8ac4156c8f2,989282,2020-09-29 17:15:25 UTC,6000671001,6000500028,false,170973,989270
6edd6b0bfd3d2f6b07ecfb503f5edda95db4d45dce7edc6c58419a044af05c90,989282,2020-09-29 17:15:25 UTC,16014745,16000067,false,14678,989270
e3aaceec423a4e5868c701ab7764c7a5ea53ffbd894baac655fbeddd080e3dce,989281,2020-09-29 17:15:00 UTC,3212175246,3212063528,false,111718,0
d2af856b5ffc3998aa82e4f75173b8602503cd8aee9f9634ff14823377f4a4f9,989281,2020-09-29 17:15:00 UTC,5000244484,5000234484,false,10000,0
cdb22dd0630d943f6ffdc359340164a10c40cc341feb35aa3ac30a9d28134dcb,989279,2020-09-29 17:12:40 UTC,1963276684423,1963276682330,false,2093,989267
72e15a509ec3d99a5aaf0c2c410bf6067dcf741b25738dd537ec42644dfe0bde,989279,2020-09-29 17:12:40 UTC,266136918,266135574,false,1344,0
4eacd53385d3be61551763de39b12086f2320dfb787199ee9d0d854d92ab4304,989279,2020-09-29 17:12:40 UTC,577174709,577152299,false,22410,989267
63e8dfd292954d1ae9c15006f48e5e75a39e683167674692a3da581f442dbd2c,989279,2020-09-29 17:12:40 UTC,212637072,212634112,false,2960,0
5165909fb256abb287af3622c9acc0f1a9180f96eeeb2ef64acf9ce4fc0ad496,989279,2020-09-29 17:12:40 UTC,106304192,106273822,false,30370,0
7809301a92d7c2312224b66e1f31cc289ba728471a7521bf88f88bc93d8b23fa,989278,2020-09-29 17:10:07 UTC,1586544731,1586485462,false,59269,989267
76da2998aa00287aa108637910ac42ae7306dd9755da39916536b69b4e1a4d9a,989278,2020-09-29 17:10:07 UTC,68738,58738,false,10000,0
be4ced8cb27cd7a807cfe25cc4dc852b0273ce8fe0594f9b9620768f9cae05c6,989278,2020-09-29 17:10:07 UTC,59496621,59488077,false,8544,0
45e0fef5660fa0ae6d9054e117625f2f89c021f2c4fe4bd33139c9b294b1b3c2,989278,2020-09-29 17:10:07 UTC,155396713,155393753,false,2960,0
3f1d2c88f005676f6940223b35e5bd88f16d868b3b77559a91988a2eb71ec808,989278,2020-09-29 17:10:07 UTC,389577430371,389577428287,false,2084,989266
6522b043fc1feb251639cc7d564461af2e3c9b2e366c91da2f969691eb8b1f2d,989278,2020-09-29 17:10:07 UTC,72226484,72216484,false,10000,0
4813b4e86d6b7995ec317030911969abeefb26f7a9f7fc09a912db046388fa9f,989276,2020-09-29 17:08:10 UTC,748573609,748505257,false,68352,0
dfaf10d89514343ec96f9bb260e3e1c7b33dd73aa9eef536a848ce46210f4e26,989276,2020-09-29 17:08:10 UTC,2434852,2428852,false,6000,0
f8260b24a73623cf2b1eceacfacd34e7da256158a865e5cb6e958510540626fc,989276,2020-09-29 17:08:10 UTC,3000219174,3000209174,false,10000,0
3d8ded330251d69c80c31116b5022929575c6e0ecb9affa01fd2f21d752adee2,989276,2020-09-29 17:08:10 UTC,65774,62374,false,3400,0
bd533b937bd0ca07e24d4e7f8cafbcbbe17f4318d883ea309ce08ba0f214b3b6,989276,2020-09-29 17:08:10 UTC,16985704,16983784,false,1920,0
4e3aded14ced5e8ecf2ad6927ac4126bdd00d457ca9f29b972564c70c67d096b,989276,2020-09-29 17:08:10 UTC,185887597,185884330,false,3267,0
b7b6c4ec27b847a6b6d0a5d4224f20ec9af72ced85199d127859673dccd88f20,989276,2020-09-29 17:08:10 UTC,1000352876,1000342876,false,10000,0
b8d79bbf9785357c22138833e05b79ae34342af2de959f651f4fc7468c8bcf65,989276,2020-09-29 17:08:10 UTC,220425059,220415000,false,10059,0
d5f045085a39e7330008182f0308741cd03ee495971656b8db88fc04fecdccc7,989276,2020-09-29 17:08:10 UTC,212793058,212790098,false,2960,0
2d5a39b3549d5e5f3c62a632230a6a41c2253965c3a4315a83bf2b0bc469b6e4,989276,2020-09-29 17:08:10 UTC,4001114918,4001000660,false,114258,989265
c54c47fa714bb18dcdb2926db48aa1a705aad0c0f04a22096911aac53598917e,989275,2020-09-29 17:05:59 UTC,59657964,59649420,false,8544,0
d0c126541eccca51ca5e7f71a8c0ac4fad39df2f00919f4e09ea41614b650356,989275,2020-09-29 17:05:59 UTC,499990000,499980000,false,10000,0
5788fd4d39001bbf7b39b488652e83884b3d17bde8dc1c0741795235a7149660,989275,2020-09-29 17:05:59 UTC,2277335765,2277335694,false,71,0
469cfc09ff8b1a92c3f0b9bfa474181eacc8200dfed81a32d867aff085e22157,989275,2020-09-29 17:05:59 UTC,122562180,122549560,false,12620,0
56f2c762eb90e5d2d89263bd00f54f08696e5f09402bbfc237b2bbb1df5415ff,989275,2020-09-29 17:05:59 UTC,3952993199,3952986907,false,6292,0
361f592c0857659b2d5c1a6a57ddc1de1b41f1a98a81c0413283b5808446a922,989275,2020-09-29 17:05:59 UTC,2000022093,2000012093,false,10000,0
fc9efc5ad633689a8535be404045ed256e0ad354d5a722713abe4b551d66bc8c,989275,2020-09-29 17:05:59 UTC,39641162,39636540,false,4622,989211
4c475eef6d01d726847062595cfd29b4d3d9f05e2b86617369fe1917d4242a2a,989275,2020-09-29 17:05:59 UTC,1949558633,1949556250,false,2383,989263
a39f09cc5f4e91e321b32f8e2210b58fc87e26f85cf525a9e01f1b72473c0763,989275,2020-09-29 17:05:59 UTC,399526404,399524484,false,1920,0
b168ba0c87062526e42788f730fde3e2028119308d2b1b7662dfaded37c992c6,989275,2020-09-29 17:05:59 UTC,240688942022,240688932022,false,10000,0
f8ea23bb9ce087457cf53fe9fe77504088e1607b16945fa6c66dc175f1e3f929,989275,2020-09-29 17:05:59 UTC,207510493515,207510481140,false,12375,0
8eca219c5ff0cac3e605247f2686ad86385b8f8057afff576d7c9059e3731530,989275,2020-09-29 17:05:59 UTC,101177000,101167000,false,10000,0
11635ca59e9897f0fd9ee597b56f99d8b0ecb4ecabd8318d2bfe821727aec354,989275,2020-09-29 17:05:59 UTC,155557927,155554967,false,2960,0
7387a4740b57a9fcbc282ab1da9b501ac9fbfea49eeab25e904cf70be59cede4,989275,2020-09-29 17:05:59 UTC,93708453,93706070,false,2383,989264
6bc5d4b6791ef30f80fffebf1d7dc00f27e0c77f0ab006a27d8d29b5f898e8a1,989275,2020-09-29 17:05:59 UTC,59566247,59557703,false,8544,0
154b9e0cb6fe65f15acbdb48ac28b2a1e94f4ff3471ea1ea027d5cc33604aae6,989275,2020-09-29 17:05:59 UTC,186107605,186104645,false,2960,0
5aff243a74e4f483d023e469bd8523f84ca47da76db1c2d90c697e6de8d4f1ce,989275,2020-09-29 17:05:59 UTC,2501919534,2501909534,false,10000,0
f8f83f448ea6de0edfa5c3dbab771b641a60e1b196fcb17771d5089cc837c87b,989275,2020-09-29 17:05:59 UTC,10000,,false,10000,0
6ce88c69ea82ed44c86337c05e05fd4bb51ea0dd264915ad0905cc6a8d88bf8b,989275,2020-09-29 17:05:59 UTC,731005534,730954774,false,50760,0
71ea984545ce3d4d4f5155e8e54b5628fabaeb2ce14b32217778156a44acb8a6,989275,2020-09-29 17:05:59 UTC,3500081505,3500074500,false,7005,0
92d6cba6e96cf49c3cafc627185e94c7ab6f611262f64a212779122d0e921665,989275,2020-09-29 17:05:59 UTC,81315895432,81315893082,false,2350,0
2430106fecbab88e006ba770a6d15d94e381de99f6df3bdfa47f825d0bc03e6c,989275,2020-09-29 17:05:59 UTC,26857344339,26857244339,false,100000,989215
d4cf24ea5b707d06c6b30a9a0deb18b61bf89aa863439c98c50e9e4cc59efae7,989274,2020-09-29 17:00:57 UTC,1588055745,1587994135,false,61610,989262
322ed292ebc6027ac315eae6027b69343559eca735f57eef62ebbc4815dda4d3,989274,2020-09-29 17:00:57 UTC,1310311665,1310308120,false,3545,989262
794c1edc6326a708dbf274e81d10c23d0339487587b29670ab277d95a2a09b5b,989274,2020-09-29 17:00:57 UTC,578167826,578139597,false,28229,989222
09ae063e4e466e33f80192a41b799451e9d11a22a01f92607f797c4a000f65c9,989274,2020-09-29 17:00:57 UTC,870941769,870933299,false,8470,0
46c75e1ae5efa33f8d09be72c26bb99751fe1cb505381fdd6158787ab4801fbe,989274,2020-09-29 17:00:57 UTC,5374373,5371923,false,2450,0
7de9ab4f9e578795f7a1b4ad3f1e9fd6bf9348b20c9414a4e1d2c87793bbe1db,989274,2020-09-29 17:00:57 UTC,1030575,1028125,false,2450,0
ae675cf86180136a9b5c031a4deacaf3a5eb5fdd6b39a769e335bd71158a104c,989273,2020-09-29 17:00:07 UTC,8130,7080,false,1050,0
1c7ef68634392adee495ad3d9e368214ae143515fe85bc7cd40a0e48c31f741d,989272,2020-09-29 16:59:34 UTC,59697945,59689401,false,8544,0
374f3c515bdf96e873ac4c5dd98cd9c813f4be1a8d20e984159ba0dd9bbd4f3d,989272,2020-09-29 16:59:34 UTC,212963453,212960493,false,2960,0
d834faafdfd5b47eb0d388f831479fb473e6ebd933fe30cc4e0d7b3691a0cc5f,989272,2020-09-29 16:59:34 UTC,3500091505,3500081505,false,10000,0
334c3089fe04d5bb92403514c6948e646f9a91af81035542e9fb9a9fc27c837c,989270,2020-09-29 16:58:37 UTC,3742008,3733464,false,8544,0
2b52651ae98190b4301bb762610417442f112535da83fcc9b80702d436bc7fa1,989270,2020-09-29 16:58:37 UTC,59860725,59852181,false,8544,0
da7f83f7ee80d97fce617e87f19f29f0dca504820b21dc28de468ce43654650e,989270,2020-09-29 16:58:37 UTC,152980,142980,false,10000,0
fe28a8443b59999aca63386dd788f34cc712fb60262f6adb2d870df1ec81566c,989270,2020-09-29 16:58:37 UTC,5700776402,5700769402,false,7000,0
709aa75e7e5e14cbc8aaaadf2cd8261742c468d2e09bc4fa6d1cbe29e95cc286,989269,2020-09-29 16:56:41 UTC,186291917,186288957,false,2960,0
fc8761e8866d6756bbe8fa32191de26f17b7dfb0685dc4b22bb0db2858c74764,989269,2020-09-29 16:56:41 UTC,1733197200,1733193704,false,3496,0
3d049342b0c711bf27f1aea447907d38ae29a27c7015c090d508f051a949a7df,989269,2020-09-29 16:56:41 UTC,170416985,170406985,false,10000,0
0472ce2df407718de53aa69c38a112a3c5988077d3e4dfb4ea40bd1b2c40b0ac,989269,2020-09-29 16:56:41 UTC,155719882,155716922,false,2960,0
ad14caea7f4752285d3402855f3d3cf6304d5e8c39e4551c881cb565ca7f6802,989269,2020-09-29 16:56:41 UTC,2020897740,2020895647,false,2093,989258
01df7d76810743beb52d88f48ac110662eaf14efa345fc94e3bb109cab81d5ba,989269,2020-09-29 16:56:41 UTC,4100263,4091719,false,8544,0
0a7759bd36581108323925987d3ad913ef43ba14c727f1c2f0e7217d22b92693,989268,2020-09-29 16:54:55 UTC,285243667,285175315,false,68352,0
83538146d902492695c3baa703ab0ee75026a6b7e6e856d74cab5386241070c5,989268,2020-09-29 16:54:55 UTC,1975725636788,1975725634422,false,2366,989256
f4444a0bc26ce91ad63f6fd67a4f87bdf5822bb2d80fe2b4ad9353023d027fa5,989268,2020-09-29 16:54:55 UTC,1589340121,1589282637,false,57484,989256
3f5079a947dc5d234f8e350e12044151c4c04e7b683d42033932c8578aa69527,989268,2020-09-29 16:54:55 UTC,94960973,94950973,false,10000,0
ad4d0325b3c117d70f19189717fe19c806071b111f4b55a751d13c62a6497253,989268,2020-09-29 16:54:55 UTC,401676932447,401676930371,false,2076,989256
02a8593b60e771c28543722e15f6761c95c540845a689e3037a9527d4cbbbaac,989268,2020-09-29 16:54:55 UTC,36935944339,36935844339,false,100000,989173
cda02b0a1f831e82f15df315ef54a05b244df0a9ac8303e7b4e624aa631aa46d,989268,2020-09-29 16:54:55 UTC,10000,,false,10000,0
b1d254d128af951c88d459a3a78ee2e40dd1f052b9f72987a824da608d427e14,989268,2020-09-29 16:54:55 UTC,2032112379,2032109274,false,3105,0
fee16b5a08b8ca9a13e0983f291929474c7b31d754c34b56e72c6865c2198909,989268,2020-09-29 16:54:55 UTC,27850937,27844485,false,6452,989256
7f323ef3676a99f9b8eea07e17cd42b1d064b8a1c5bd376d343c7faa15a552ca,989268,2020-09-29 16:54:55 UTC,5114010000,5114000000,false,10000,0
da6fd7ab4673ac8300a26146812547b47876d5afa92eec15771dc757224de31d,989268,2020-09-29 16:54:55 UTC,7887958245,7887956152,false,2093,989256
5db39fb6faff05e15f4fca24c786853f050b40f04f6cec994a2a4e75ec0abbdd,989268,2020-09-29 16:54:55 UTC,50030225,50018140,false,12085,0
4ddaec9798b4c38c971d7c6461246cffa3b0b43683bebdf07bfffc2a7d2d9307,989268,2020-09-29 16:54:55 UTC,266146918,266136918,false,10000,0
49ffc41d6585aeafb28426a274e748ba22e6b61cbdccf79822b498481a4c9f45,989268,2020-09-29 16:54:55 UTC,365288870,365285454,false,3416,0
d29a8f2b77217ddcaada418dc5bd79efe86771302b78b9b2f30399879597e620,989268,2020-09-29 16:54:55 UTC,578892876,578869885,false,22991,989256
62d1b6a6a59e3f9c5cee4530dbb4a6adca755b00fb0a115e5d73f5533558debd,989268,2020-09-29 16:54:55 UTC,59923765,59915221,false,8544,0
079cf916c135976e0763ff5dda95d0d826498ef762cef964bc5d623232124810,989268,2020-09-29 16:54:55 UTC,213123853,213120893,false,2960,0
e604940eb8a743b2eacf271a615f69ddb192af328036595b65722728e8457cf4,989268,2020-09-29 16:54:55 UTC,60194530,60185986,false,8544,0
7637dbcbf763ff4c57047a3ffd12df3a72a2d37a6f9cc1e7804cd43827871c7f,989267,2020-09-29 16:53:26 UTC,19957518076,19957508076,false,10000,0
155551cc7a3907e1bb536e10a0005e7320ebab190e56af1736d555860a247bba,989267,2020-09-29 16:53:26 UTC,239430080,239421882,false,8198,0
8c1129a4867ef8b62fe5ec14d00694620994bd40c4128c3f6ec85b775594955e,989267,2020-09-29 16:53:26 UTC,439962822,439862822,false,100000,0
d675347772937930dfdaabe84fa8dac696ab5ae6e73ffc140dde1c4b160eee5b,989266,2020-09-29 16:49:00 UTC,60244952,60236408,false,8544,0
408ca60c30e6a8645b5f373149c3a0e71ee5f1ab97b1ad4dc325c7ca6b03aa22,989265,2020-09-29 16:48:42 UTC,101015871,101013421,false,2450,0
633bcda233b025c9b9cfb88a62165db1bfd4feee7a3191a7e05cc63cb33d13cf,989265,2020-09-29 16:48:42 UTC,83706693768,83706691418,false,2350,0
05b7ead620943d702f98241e3bd31ff6eaf2405283582a3558062172a6e6a56b,989265,2020-09-29 16:48:42 UTC,7298664,7287745,false,10919,989254
abaa845ee0ecc6a0b951bd973413420b7c4430cb2e8bd7e540a17fc5d77ead83,989265,2020-09-29 16:48:42 UTC,20367766971,20367756971,false,10000,0
352f64a74f5252f81cc8376e33df0f20f9913596478bc8cccbd23625e63507c7,989265,2020-09-29 16:48:42 UTC,500000000,499990000,false,10000,0
d5b0050061440950c8e15cf5e3502d099d8c914ea2c49e3efaca617e819772d9,989265,2020-09-29 16:48:42 UTC,14596320,14592963,false,3357,989253
758c3749d9a76232df76474ccc51cd98070d03c637efc71cfabcc9e82c849e99,989264,2020-09-29 16:47:34 UTC,402076460935,402076458851,false,2084,989253
a44d32f444ce7574fd2b476940ef5a88319242ae20c70cc3a5eb1e1e79cc8804,989263,2020-09-29 16:47:11 UTC,7999519728,7999500000,false,19728,989251
56870bd03f952cf47fb0837a2c635bac282bd3ba119cac7a6e0f4072ccfc2d6c,989263,2020-09-29 16:47:11 UTC,4510000000,4509993000,false,7000,0
5edbc3f3df8d68d4ce4b550cecd73f16040973d2e458c6fa566389b13ce1ad49,989262,2020-09-29 16:46:49 UTC,186474027,186471067,false,2960,0
4d1546f6da1e6d8fdbf18292b67bf790cab863a34de19fdbe45384a4025e426d,989262,2020-09-29 16:46:49 UTC,2667463602,2667455466,false,8136,0
1f724e8edde46d007f7c555d89dfdedb79670256321876fc2d2d76f4a7b9e7a8,989262,2020-09-29 16:46:49 UTC,100325231,100323476,false,1755,0
65abaffe3e57ed92b13d9c3e84a7396024bb9f78eec7f808b34d4848d246b42b,989262,2020-09-29 16:46:49 UTC,10000,,false,10000,0
a49b9ff169abb69262995fb1ec313fe32cd00d2cd6b843007ff37af689e9c802,989261,2020-09-29 16:45:44 UTC,100377668,100374268,false,3400,0
20ea5a4d58f634079e8026c13648276db7518a05586930831fdef5933cd03f88,989261,2020-09-29 16:45:44 UTC,60326999,60318455,false,8544,0
12d58f3d32ed7975923278cd5d812ce0e4742d85c8f1b2620d449923806f42c9,989261,2020-09-29 16:45:44 UTC,400737214,400734954,false,2260,0
55bccca5257193eb412fb0e741d0cc46c6fab2d5b2e5792925e814e45b0ebd7f,989261,2020-09-29 16:45:44 UTC,10000,,false,10000,0
751f2786e166ea32e86db072e2da42a0005aba7ea51fab01d9131a51a3b39099,989260,2020-09-29 16:43:26 UTC,676082300,676080380,false,1920,0
a3c401e9056cabdf5e4eb1f480d4d058d260d5036700e8209bd4ac01c4bd05b8,989260,2020-09-29 16:43:26 UTC,40635944339,40635844339,false,100000,989249
ceb68d2334a2eeef611aced21347b95dd508d832ec573cc3a5abae97b91fee2c,989260,2020-09-29 16:43:26 UTC,100737752272,100737682272,false,70000,0
d366cbb364a5d689a597c154b30c86b50a87c3baa7b9cc5b4fb369476bd4ca0d,989260,2020-09-29 16:43:26 UTC,4510010000,4510000000,false,10000,0
dab29805015f1eb43963addf185db225f72cc159de82e861073f2ed4e31a43ce,989260,2020-09-29 16:43:26 UTC,20367776971,20367766971,false,10000,0
0f143106c9d6a511d08434255fbadda6097a0736b4dbae66f43e217b4342f35e,989259,2020-09-29 16:42:22 UTC,22303054820,22303048040,false,6780,0
5285066250420f7eba372e6fd8bc7054fa2d8212fb22ac1929cd9222f6f1b052,989259,2020-09-29 16:42:22 UTC,29849827,29839899,false,9928,989239
ca0de315b465f2aacbd23b41150e03e656248e738f8279589d74ebd0b815a507,989259,2020-09-29 16:42:22 UTC,14153054964,14152804418,false,250546,0
c80897e5775f73fce0fa68639406e00b20e6eb9d499ddec907ca2b4cafe6300b,989259,2020-09-29 16:42:22 UTC,354256540,354254479,false,2061,0
984f43cf0860bb989fa45a93b78b2d42d3b25ebfe319c96bfbbd256da38af533,989259,2020-09-29 16:42:22 UTC,22299478937,22299468937,false,10000,0
2f2d415835b45b95db2907fbb6c581fdef4c52c52ce025b1dfe3db730a450bb4,989259,2020-09-29 16:42:22 UTC,2000041385,2000031385,false,10000,0
6df7e7b3361e64b9f3a6d220d65016652fec6a12b5cea92780c59126366ea688,989259,2020-09-29 16:42:22 UTC,212400000,212390000,false,10000,0
bd9b3018dc1442882ec907cccecb7c02133aa8ddee64e0a1c1a421920b9f4b71,989259,2020-09-29 16:42:22 UTC,1590605874,1590544845,false,61029,989248
142e4664ea1a7762ed318abc34d3f3c182f8850a9f7e9ecc2754d0b09afe29ee,989259,2020-09-29 16:42:22 UTC,447517901,447515641,false,2260,0
78190e5e95ed9fc53aaa08145b3338e500128a00d7bf0a040548fc51b8e30a17,989259,2020-09-29 16:42:22 UTC,4801356057,4801350179,false,5878,989248
4b236ee661f1a05181f8d778e75efca6a3715db41bb038d2c3b92375e013792c,989259,2020-09-29 16:42:22 UTC,579570951,579544183,false,26768,989248
dfb623896b66b51465074ddb2466861dc52d5c5b4611a74fda7c8d969cd29890,989259,2020-09-29 16:42:22 UTC,28940113,28930113,false,10000,0
6ed187947ae3e5fad8d770ff20e1e251ca408077961bd36a573a06864da24caf,989259,2020-09-29 16:42:22 UTC,402444823028,402444820935,false,2093,989248
1a4f39f131bcea1cd4dd99de250614e1cefa62ed93e852b509ddd695d84eb74a,989258,2020-09-29 16:37:43 UTC,321879100,321877518,false,1582,0
77b5fd38e2a6d51ed3f4ec1ca776ea4ff73fc7d6ea1d979831230a2448a50de4,989258,2020-09-29 16:37:43 UTC,402569825121,402569823028,false,2093,989247
38144fa0a9095f3d198df912c5ce0350185b866bc410572717cf704c879398bb,989258,2020-09-29 16:37:43 UTC,22299488937,22299478937,false,10000,0
cee07cd14b16c4277ea7d8db1ba776c1d7009fe1f9a70750696896d52303b66c,989258,2020-09-29 16:37:43 UTC,156001396,155998129,false,3267,0
73569f6c2b912120297e8079da131dee805f5e677e9f3ef67191852796c50f4c,989257,2020-09-29 16:34:13 UTC,228749393,228735937,false,13456,989244
a7a4b237342b85537df17d9c3e5cc76b7314584bb5484c972a574ffce5479590,989257,2020-09-29 16:34:13 UTC,499990000,499980000,false,10000,0
aaf3e2d1b6da43e7dcf6160935dbedb9975f7437275a34df8133519ebcc51f60,989257,2020-09-29 16:34:13 UTC,3418400000,3418397915,false,2085,0
c665eaea9d012487d90f1f2c8b105c51daaab3f2dad92a9a255452ef2c4f5fc1,989257,2020-09-29 16:34:13 UTC,213616109,213612842,false,3267,0
d8a45cfe4fa10ffce38f3a1b896789d6fbd8c290af17cf48b3e9666b8c46dad6,989257,2020-09-29 16:34:13 UTC,608501961,608433609,false,68352,0
e07dfd84ac4c59adb7894b27e8f1bad3eceb7715fa5e3a899e2d168a39c9c46f,989257,2020-09-29 16:34:13 UTC,884941933,884939818,false,2115,0
7802e0b1d9e3be7bb09fadae742924ff9ab09d507b8eb1c94179cced2be74e4a,989257,2020-09-29 16:34:13 UTC,202675945,202673917,false,2028,0
ee51a7288cfd4e4e11762318a1149a48d848cdf6c03aca5b6636f119cfe1d25c,989257,2020-09-29 16:34:13 UTC,57718,47718,false,10000,0
4fe7a49bdc45b21edc18053bd314714d915a89ab30ce9ef5052ecd389a3da323,989256,2020-09-29 16:32:04 UTC,188616,178616,false,10000,0
4860279c200e2c451e06d2d3f246aef024e7d218eea53ca6992af6e05923cfbd,989256,2020-09-29 16:32:04 UTC,40252,39694,false,558,0
365c5ec6cc65c2eb8d23bbdeeaec89867544c900170336dc7212931d888f2e9c,989255,2020-09-29 16:31:43 UTC,3945997707,3945995614,false,2093,989243
3a40ee9cb18510548e353f602fa38774ef47573fe71dd933e2364ad9e9891df2,989255,2020-09-29 16:31:43 UTC,2500987915,2500975830,false,12085,0
25814e3502ef758a03a74f7899b24e97d64e0fab14e4f24691c49d293551240e,989254,2020-09-29 16:31:36 UTC,38682546,38672130,false,10416,0
f845283fd886bec28e24e5aefbb2c1ffd3a02f99e753612464bcea3da6caf832,989254,2020-09-29 16:31:36 UTC,500000000,499990000,false,10000,0
dd4bc735fa4ec3d94ad1c778797c19d370669e3d9403d39748297cae641c5a50,989254,2020-09-29 16:31:36 UTC,402610127214,402610125121,false,2093,989211
87f029016a6c9792d703227bf13394469f4a3014ea9da5123f416fef4b095a89,989254,2020-09-29 16:31:36 UTC,20896635733,20896605733,false,30000,0
edd98d8a3695e8081d5b81860442aa02ca106844970ee17165a1272b25cb2f0a,989254,2020-09-29 16:31:36 UTC,1592384645,1592316661,false,67984,989243
1468fba7bdb9aa2171afba96702a946b69e8486742f71d203ee0cdcc11a8513a,989254,2020-09-29 16:31:36 UTC,60358628,60350084,false,8544,0
4eaefc725899664d5d9fd0c7a71550d2c953850cfa1118742091de9ec50e599f,989254,2020-09-29 16:31:36 UTC,101402850,101353519,false,49331,0
05c7234b6fac93c831357dac9e8dbbca9a0fad3511dd17ae115c6c257d49cb3b,989254,2020-09-29 16:31:36 UTC,186622430,186619470,false,2960,0
e68907608b3038fb4e1f957988c72bb7f65f90329ba9513893fe5b3d55d44067,989254,2020-09-29 16:31:36 UTC,12124519,12114519,false,10000,0
402c49e03bef85bc44f1625f6ae3ab3d0e8585109530941193b4fb6ff0e73dda,989254,2020-09-29 16:31:36 UTC,22055298687,22055288687,false,10000,0
e4215c1c2b1349cb066a10f1d322fa0019c6a85ac8b2ec9c848f300941b6466a,989254,2020-09-29 16:31:36 UTC,580672588,580640899,false,31689,989187
1497585e80705b5fedc6076bbea7766c726b999966b9ca6b6deb41a4da520132,989253,2020-09-29 16:28:45 UTC,349960000,349957464,false,2536,0
ba9ea49684b0e15b6f9d3ec8ece5657c6ce81064e3831c29c3d4032a915064ed,989253,2020-09-29 16:28:45 UTC,2791990216,2791960216,false,30000,0
8752aa4b36f5f3b52060c47ee79a9a0c650bbed5fdd5460b87f9a3aeb62bdef0,989253,2020-09-29 16:28:45 UTC,219095175,219093255,false,1920,0
b5d021bcd8a3c35d9c5aafccf732c1cc898c1a698ad5d8c38520971b6b54f3db,989253,2020-09-29 16:28:45 UTC,22465989670,22465979670,false,10000,0
d1199bf199603eaeca7002238c450bd08a68fee26d29784c7a3b73dcb82c8aac,989253,2020-09-29 16:28:45 UTC,500010000,500000000,false,10000,0
abccdf8c23d37430562418bd8f103db92e4c5402e4314d6733a39154c87982c8,989253,2020-09-29 16:28:45 UTC,6918912,6810162,false,108750,0
f8f9c9b07f0c34aa264ea9f108a419d5692573fafdf44dc95eea29870ba6f035,989252,2020-09-29 16:26:37 UTC,25812199336,25812183756,false,15580,0
458be8674343d28744ab5167c8c9f30ad915cae7f554631e9ed2f034587325f9,989252,2020-09-29 16:26:37 UTC,60395350,60386806,false,8544,0
618b1701f4969f17074aaa9f5e0bb6d7015b2a2efccb472219b8d33da57b9821,989252,2020-09-29 16:26:37 UTC,156220070,156217110,false,2960,0
998e18884bfd9138702d1d9a278e6c2888cc9e7ae9230ea67abc45c0a4e47f27,989252,2020-09-29 16:26:37 UTC,6912105434,6912075434,false,30000,0
8f39a89d27b6c3e4d4c1d25ea017b84f985f672c5421d1e5b8ede388f7bd5015,989252,2020-09-29 16:26:37 UTC,266166918,266156918,false,10000,0
53c4ad65fc1e79a873bda30b343f718421abbda6e7272962da46954c3bfc7ab2,989252,2020-09-29 16:26:37 UTC,22465999670,22465989670,false,10000,0
fe8ff8dbcabb23926014ec16ac67020d8df173b1110ff833a359b00e397fe464,989250,2020-09-29 16:24:48 UTC,349970000,349960000,false,10000,0
f5d5b590bb272ea1bf0ad5926caa6b75437469546eecec8fbbc65762eee33a3e,989250,2020-09-29 16:24:48 UTC,499980000,499970000,false,10000,0
f1097802bf9828c0ab69c2bf9d9f49b11d242eb8e96b0780d6226d4666c95d12,989250,2020-09-29 16:24:48 UTC,1000174603,1000164603,false,10000,0
1545754abdd3994bb9149baba95434137fcb860b1838beb6bc7f3b9f4fafaf61,989250,2020-09-29 16:24:48 UTC,1231039,1227682,false,3357,989140
06f7a5cbe478d387fde978c4ce492e8a3d23b60def81718d9be07104e222822d,989250,2020-09-29 16:24:48 UTC,1224697,1221348,false,3349,989238
71db69a83457182471a3583b684561cf05e96829b82ca5a78a2d97eca43574a2,989249,2020-09-29 16:23:09 UTC,18200000,18191456,false,8544,0
a35545680325ac9458d38ebe35bfc66a3d15ac8c270b9641e943f8560ecec67c,989248,2020-09-29 16:22:21 UTC,213791598,213788331,false,3267,0
8c7ad05660952a895927aaf6b4f04ab7f7afc980b273c7c547cc5cd08eee5d7c,989247,2020-09-29 16:21:49 UTC,1000184603,1000174603,false,10000,0
ee27d08e973fdb07e4c06b3d50b56fec56a06343700455507d1229a4517ed4cd,989247,2020-09-29 16:21:49 UTC,3276934877,3276927877,false,7000,0
8854d1894e780ae7d23c9b351949128d3896360860fe127913da1b5791176a65,989247,2020-09-29 16:21:49 UTC,121725358,121723265,false,2093,989236
9d792a0d0ec8b5566099973bf112fecef97e18b93354a2a0c71ae5bc21729ed8,989247,2020-09-29 16:21:49 UTC,581718427,581693419,false,25008,989236
8785987b616f9481ee8444d4c9b7bd75c0b2aa9382719ec3afdbd6b19f1f2f58,989247,2020-09-29 16:21:49 UTC,100032777,100030327,false,2450,0
adc6b0f994f13b9d154b7cd1b616941b51337ba653675de702f3516ea81f978f,989247,2020-09-29 16:21:49 UTC,499990000,499980000,false,10000,0
d2b472609fbf303eec1af5fb88e7cac42e2a0fb289b67200a931d30a59e73580,989247,2020-09-29 16:21:49 UTC,1593842897,1593782773,false,60124,989236
153ff27c26614d58d577a6cbbf95553266aa2253c55a249ed1c02853c61c22d8,989247,2020-09-29 16:21:49 UTC,305341,304819,false,522,0
ac95d1e8dca975c886ecc63acbb3e294323b10d0f07e364a75ab870954c17d02,989245,2020-09-29 16:18:58 UTC,456300,446300,false,10000,0
10b05c8d39a08c668363b939c7ea80088ae869c3c83b341bebb714e382f7fd64,989244,2020-09-29 16:18:13 UTC,21072,15072,false,6000,0
4822c6276c58ef886960b09875c8aab294889a6ab90b97b2c775a5b00521b621,989244,2020-09-29 16:18:13 UTC,60445006,60436462,false,8544,0
59c19530e92dd79fffb624faf5da889dc4c3cd9a0ed8c22f02806535c1996d0f,989244,2020-09-29 16:18:13 UTC,186764427,186761467,false,2960,0
41899556ba0fff9bb902adefe7a6759958cf4f757f56ad895639c16ce7152e42,989244,2020-09-29 16:18:13 UTC,156422466,156412466,false,10000,0
6be6113c54a4226b130baf2f8657683a53d94fa7844dd76a3be1a4d43d3f12bc,989244,2020-09-29 16:18:13 UTC,1002496,995716,false,6780,0
1f57b7a2d2ba3cfbaf299661fd81ec6fbf70092ea5f2482f33487d1cd1e8415a,989243,2020-09-29 16:17:03 UTC,499990000,499980000,false,10000,0
ca8dc200901b266e3c2944ddf014c173ad0b6b7f761067d849936a055b4c390f,989243,2020-09-29 16:17:03 UTC,25188985105,25188955105,false,30000,0
fabc185ce0f7f3aa0d7c083ef4a798a1c2c08ee46c206eca411aacdc7336fde7,989242,2020-09-29 16:16:43 UTC,7027335434,7027305434,false,30000,0
a78937dadf7ac9c39074a7c08124151ae3b599841277bc313eebdd589c679412,989242,2020-09-29 16:16:43 UTC,404118253507,404118251414,false,2093,989230
f8cd66400b189a12436be73c16b51967f621d00995c1c7af2b5c03d64aeb1ef3,989242,2020-09-29 16:16:43 UTC,500000000,499990000,false,10000,0
db5e5320d3199c1027e783b6c8727ba5ff9bc4415ba7aea703b9f1e5417de71d,989241,2020-09-29 16:16:34 UTC,145172019,145103667,false,68352,0
c2bf7b9629b0ff8038e628c1bce7a0caa41e68343eb3c0b6bae79f4ff4843392,989241,2020-09-29 16:16:34 UTC,2625558000,2625548000,false,10000,0
ab9441d8144465c50821fa1b9cc24dfea78d1dd7ae9dcc426282743aa86ee156,989238,2020-09-29 16:14:32 UTC,387130000,387127464,false,2536,0
7a9d5d364effd873bbd877958a2add34931bec3ebbe5b8514517ed617ce8ad99,989238,2020-09-29 16:14:32 UTC,10000,,false,10000,0
9dcacd063a68128acc7449348e7ee43ab46f0185512fa45f6887023603f3de5d,989238,2020-09-29 16:14:32 UTC,879826445,879817975,false,8470,0
2a0da2828d51b2fe059d1981937df7171c1d20a1d26e77a05a87bea9632e49e7,989238,2020-09-29 16:14:32 UTC,26616,24166,false,2450,0
4f65e393120318dc7b7c9001273a1bbcc414e52fc872cbfc7c73eb04535dba13,989238,2020-09-29 16:14:32 UTC,156368740,156365780,false,2960,0
ce7fb81a38f5fbb1093c2b7a905c4d29b64d849219728ffc0efdcbda1b77e76f,989238,2020-09-29 16:14:32 UTC,448919222,448915806,false,3416,0
20a1c3842c12e314f163ab0ed6715cc323dd243d10e8e1c245796f8ce3bde6bb,989238,2020-09-29 16:14:32 UTC,387140000,387130000,false,10000,0
b38a0104b97b766f5fcc27ac1764b056c5f655cf160cab01eaf2a0e38b6b56f6,989238,2020-09-29 16:14:32 UTC,500000000,499990000,false,10000,0
234a967c7eb08082798d175cd9d8481ce9b26289483f9f55f77f95d5c27fa613,989237,2020-09-29 16:10:17 UTC,101363182,101356057,false,7125,989226
17066fc18ae3f08f0e8526250df17b95a6cc066b29b3a7ff1b651ef654cba1dd,989237,2020-09-29 16:10:17 UTC,213979780,213976513,false,3267,0
bc115964171031daf7bf0f8fbef8994532e60a417691201afa4599fb748f60a7,989237,2020-09-29 16:10:17 UTC,582788457,582760536,false,27921,989226
c45a46428f8e32f3769c2cce11372f631ee62f4a73c13d09b6b0a63cd7152f60,989237,2020-09-29 16:10:17 UTC,500000000,499990000,false,10000,0
bcff8effc385f5cbdc812c5771d6e0ec8cbfba82eb513e232e7d97d8e63060a1,989237,2020-09-29 16:10:17 UTC,1595299344,1595228216,false,71128,989226
62c2ae40a1e3d7a89591e5d0857513653bd41c5fb4fff42d826a2f734e56f0f8,989236,2020-09-29 16:07:43 UTC,2002120000,2002110000,false,10000,0
ad1df87204559e3ef55df56f0008f1c979a4b46a8b7fd705791e9626257f985a,989236,2020-09-29 16:07:43 UTC,60658293,60649749,false,8544,0
827023a7005109ea65306c23cc94d19f1f18131562f98a84f1ea18ecc6948229,989236,2020-09-29 16:07:43 UTC,519692162,519647642,false,44520,989234
7b4629714885f38a47ae6e2300e6c3f05ebbd2defef9f64d62184cfc1cfe66d3,989236,2020-09-29 16:07:43 UTC,3119285633,3119285050,false,583,0
5290b79a98b37ce38271222696b759dada0d62594d92cd98a887bb9fc375fa21,989236,2020-09-29 16:07:43 UTC,172832853,172830769,false,2084,989224
bf0f6566babfc611ff88ac261ee4ab7d32868059afb09f0d40f27a35893fe5f1,989235,2020-09-29 16:04:50 UTC,60758631,60750087,false,8544,0
610e4f94a9cc481548610743e9976a3fba675faebb7102311d8ce5e393ad7509,989235,2020-09-29 16:04:50 UTC,36506802,36499361,false,7441,989224
9114614e2e1312d65306d6b777789d4b36b73c0c22f563f916f8b35ec30224b3,989235,2020-09-29 16:04:50 UTC,1000002450,999992450,false,10000,0
aa1f47c5932ff33ae5ac5bd512bea88fa1955774a8928e50b4f485f612976026,989235,2020-09-29 16:04:50 UTC,240159808064,240159798064,false,10000,0
3691f96795412a82500f4ddf07bd1fa977cfe0bd2ee5155f7f1c1fb42ed43ec9,989235,2020-09-29 16:04:50 UTC,187120481,187117521,false,2960,0
1c5ee870327afd57ad5d308588445665c5697ac90c092a908d912f5ed999a7e3,989235,2020-09-29 16:04:50 UTC,583515153,583493614,false,21539,989224
bf50a8729596c8ba092c36445f539fa024cd2503ba91d27ad8dea95ec205adc1,989235,2020-09-29 16:04:50 UTC,60803401,60794857,false,8544,0
aa892ae383888bac1df52b3ea944712286fadaff87e70aef56189ed4fa665d3d,989235,2020-09-29 16:04:50 UTC,2501929534,2501919534,false,10000,0
3e0b20e5a9b6d955b30dbb7d82659dda61ec6ab52ed93f031b9bdc872b6510d8,989235,2020-09-29 16:04:50 UTC,1000000000,999997740,false,2260,0
4b94a3717252b02b7af57feabc7e09e910d3e905d2ac71fb6eb37bcb619369ce,989235,2020-09-29 16:04:50 UTC,3380658850,3380651849,false,7001,0
df787ecd6566e74ae8cdd271b0600c7cf3d30e68b60c74950c73fd2f81e6a17d,989235,2020-09-29 16:04:50 UTC,1000008544,999998544,false,10000,0
751a1afb59d91a60b0b49e955c584e73942413fc7402f707b12bfee5d58f3897,989235,2020-09-29 16:04:50 UTC,468430313,468361961,false,68352,0
6e44bac2dc96cceead41eff6e82f9d4bdc19276dfd9387eca058bc41ba5fe8f1,989235,2020-09-29 16:04:50 UTC,493827248,493824988,false,2260,0
e6cc42ddbc5b3c9f9218b2d01cef044dd918e672858d8ee9a52174c140671ecc,989235,2020-09-29 16:04:50 UTC,7868442915,7868438985,false,3930,989224
7f591e8cb4ece7ddf1e1d0d6df5ac9974a2b745e24d4106cfcf029d1aeac874f,989235,2020-09-29 16:04:50 UTC,1130736,1124736,false,6000,0
690b6eabfeeef96ba8a6bcb4e0022911b25c8f53c39497d6dafa7bbba7636db6,989235,2020-09-29 16:04:50 UTC,198190,188190,false,10000,0
fe916d7b97f6fb312ede2cdccd9249bbc2162a876b1c21876993f39d46891d2c,989235,2020-09-29 16:04:50 UTC,15076340,15071727,false,4613,989224
c833d2a92e8df435582507372a334335c99ffc054423665739793c0a73c19fbb,989235,2020-09-29 16:04:50 UTC,61099310,61090766,false,8544,0
b3884019974c24a1c8b3bc195abc60936b250fc0d0004fc1aa2d8f7e64366810,989235,2020-09-29 16:04:50 UTC,113384051904,113384045104,false,6800,0
2f237c58ed7ba6cfddf84c1cf79a166a6a417ec2c68427db5dc1a9c818d63576,989235,2020-09-29 16:04:50 UTC,156515744,156512784,false,2960,0
828e5af07f76a62f57b01c4a93a28e69392bfcba7b3f3d0b995c13a69dd35401,989235,2020-09-29 16:04:50 UTC,266168500,266166918,false,1582,0
dcd6a814f91d72d8ac76d480e3d09c1c558b5f63bff1567bd4f5c8741c604efa,989235,2020-09-29 16:04:50 UTC,14553839,14546688,false,7151,989224
760b02557b8043271d6951cb790093d98ec19f2892791be35e7247ac224efd23,989235,2020-09-29 16:04:50 UTC,1596853839,1596786709,false,67130,989224
3abe8793f28164ba4dc5b8f9213e0439d6733b27e8733a75750c773af6e72a4b,989235,2020-09-29 16:04:50 UTC,186918928,186915968,false,2960,0
48dd1c4fde146f0f30ad3e45b596dccb54c311cc9663b277e9aed8a7537486b2,989235,2020-09-29 16:04:50 UTC,214126238,214123278,false,2960,0
aa3589290827f1abdbafeaa86c101282a017fd1a7c4f38a498e997df2d1a9dce,989232,2020-09-29 15:54:38 UTC,214309880,214306920,false,2960,0
8c29ae482131e1a5c8b60d6699114b961e4ddb4ba23ef1d7d8d725649a4d1e27,989232,2020-09-29 15:54:38 UTC,8492658850,8492651850,false,7000,0
d31c041f85cc10cda8dad964e98860aebce333c832b624f68e30a03fd2c16f49,989231,2020-09-29 15:52:10 UTC,208810645,208807245,false,3400,0
ff44c551495d4cbda92cca6a3585ffeacca716c1cf8d706c3340449878e1d837,989231,2020-09-29 15:52:10 UTC,205425346,205423426,false,1920,0
0ccdee2b429563c254c42fba38c33d9facbbd071e1a31287f0dfe7dd4f7ac7ac,989230,2020-09-29 15:51:47 UTC,416649788247,416649785864,false,2383,989217
7a5079c5ea6c3e00d59b34cbdc8358a08d76e4ee99121e054a0faae0d1ed0d82,989230,2020-09-29 15:51:47 UTC,5112010000,5112000000,false,10000,0
862af7c10247a347e726c29db2366d50c6626cf347e9d5b8e7bbc2b3a2b4787d,989230,2020-09-29 15:51:47 UTC,20832091178,20832081178,false,10000,0
8eb91c291f61c45c298b97fe013320481a8c8fe265f6c4553463beb5626c42c8,989229,2020-09-29 15:51:05 UTC,21054924028,21054914028,false,10000,0
83b9124f898930fffb7eff2eb2c85671c7e224f6798e1e9c4ddabb73228a6b3a,989228,2020-09-29 15:50:42 UTC,1598028520,1597966346,false,62174,989126
3c923fcd41f90a0af67cf96b050c7f74b3281bfee94e54541cd6cfbd3d0334a2,989228,2020-09-29 15:50:42 UTC,82577135,82567135,false,10000,0
9d58238fee8a55d592d3b5305f32bc2c83d138462e2f11690f8aa46b03148876,989228,2020-09-29 15:50:42 UTC,584336987,584312236,false,24751,989214
597a319b3162b6b40002945d3c003d5ce06c9b0c1d0148fd5b2a300c7721d89c,989228,2020-09-29 15:50:42 UTC,205435346,205425346,false,10000,0
eac727fe308c54a7271a1a8c3073d0f5e96038a5aee8fef640f9c9b8790db7c4,989226,2020-09-29 15:49:38 UTC,13655056318,13654956318,false,100000,0
ca910ec88fc5e3df7f0ab7a823c6c50066cf01791e249fb90c230fe4aad43ff5,989226,2020-09-29 15:49:38 UTC,21054934028,21054924028,false,10000,0
e1ec6c5a291d91db08f2d02c5df0cbd6ea513915040dba71109c26de612a674b,989224,2020-09-29 15:48:29 UTC,61163725,61155181,false,8544,0
11f856dbeb416dad89c42350ebbd3f4082c3b41efb846167864cb48d0c51db92,989224,2020-09-29 15:48:29 UTC,14599470000,14599459800,false,10200,0
35fb675177cf26a1fca7961d27547d66ef13cf8065259bb963527933e2090818,989222,2020-09-29 15:47:32 UTC,21482151709,21482141709,false,10000,0
66a8d51e2e4f985519cc82de761848388e2ea943401fabee188778524d2f9268,989221,2020-09-29 15:47:04 UTC,8134658850,8134651850,false,7000,0
205b563c6c73522828a40b6267dc2b1a3af3e05ab78a8f2bdc79d7cfbfa986e3,989221,2020-09-29 15:47:04 UTC,205490282,205488189,false,2093,989209
5e98361ed9eb478ab24449a50523f9ab2f7d806260597886c54a0208cb852df5,989221,2020-09-29 15:47:04 UTC,61238954,61230410,false,8544,0
842275ddafeb63b1c25b7d175a3a787db6c9cbdb7855a6cd936463a7a5533be4,989221,2020-09-29 15:47:04 UTC,156777414,156774454,false,2960,0
6c32be2ece91a43c7df289077c9a4c06e8eb21de0123d2755828c95355fac5fe,989220,2020-09-29 15:46:28 UTC,21482161709,21482151709,false,10000,0
5099ab9399dd9d29e85482b4de338b757fcb0e9fd0cff3a1bd19d7f6be9ce206,989217,2020-09-29 15:45:06 UTC,500740954,500737214,false,3740,0
a91988d750e78649ae4bd54d9591e397976b488b2862b6de5adf4565dfcc229c,989217,2020-09-29 15:45:06 UTC,499983740,499973740,false,10000,0
f114b5d5cc69ddaebcc0eaf301471f11b42301f14871433c39c424d42600680a,989217,2020-09-29 15:45:06 UTC,187279479,187276519,false,2960,0
82d3b9078e6a05f2871310c440db9b44e0f2beb10ca1d12becdf034ce16c7e17,989217,2020-09-29 15:45:06 UTC,4535893640,4535886640,false,7000,0
1c085b3a19246247cd17a134149d691876cf7b852c8e0f137b3e278771492f5f,989217,2020-09-29 15:45:06 UTC,417150788331,417150786247,false,2084,989206
4b3f88b375b30b1a56ade87c120e024939eb2e18f17b3fcacebbd720b4cc901a,989217,2020-09-29 15:45:06 UTC,61361592,61353048,false,8544,0
67a0edc2a54233841cdb6eb20848c5ff5aa2e8c199ba6ca06394c6c0f3ae6fd4,989217,2020-09-29 15:45:06 UTC,585003621,584980040,false,23581,989138
6b05f02b10de5078ca5ab45639158cacb5a89b019f10f25868686359c0742555,989217,2020-09-29 15:45:06 UTC,214544922,214541962,false,2960,0
48833783c242d9fc1de39dd0eb57c1d3cce893126ecbcdfff7d3469230c4f836,989217,2020-09-29 15:45:06 UTC,190291908,190289815,false,2093,989206
8170fbb3b5509e572aa45c0dfe1b0e1731cec5fb12bc2c79c6084eb3f600c74b,989217,2020-09-29 15:45:06 UTC,4211792,4203248,false,8544,0
b0e8ab6f3d3349274999b1630bc4ea8a674899ea0b53a1f6b4371b8214a984bd,989217,2020-09-29 15:45:06 UTC,143795995,143785995,false,10000,989202
59ace7230015e358477d6cb4bc16b2086d0aa337daff65cf7501bb1cd3e64f76,989217,2020-09-29 15:45:06 UTC,4754010000,4754000000,false,10000,0
9f2490b6375ac0523de2602cd14510e3dd4a79a6dfe2b4b7781eab551b675fc7,989217,2020-09-29 15:45:06 UTC,1599468518,1599406327,false,62191,989205
620d8c588e82ed12a817279ab23ed1031627a4dd7240f53ef382f0a4a4bbf16e,989217,2020-09-29 15:45:06 UTC,155982000,155976000,false,6000,0
15c222fe72fb09c4169e282cce5f4188226bf6cffda2f50b09a92bf397428fd3,989217,2020-09-29 15:45:06 UTC,1225744717,1225676365,false,68352,0
5a7d80edd35fffd9fe3859eaf9fe0f516c79d9982e10aec98642bfbe104694dc,989216,2020-09-29 15:40:10 UTC,500004353,499994353,false,10000,0
1fe0abd419862d31376dd1f1cd3791b71ea22384d34b20a19ede0a78fd89e45d,989216,2020-09-29 15:40:10 UTC,212466917,212456917,false,10000,0
266fb144b1767e8ab0053046d155192740e3b6976087dd0060f7ab25aa5823a7,989213,2020-09-29 15:37:34 UTC,499993740,499983740,false,10000,0
2055ded9eb9e6488a02ed62cde7403c602c8b298c96a0564ee3de47d1f0f6e88,989213,2020-09-29 15:37:34 UTC,540292869,540290609,false,2260,0
cc2e6f8ace7481759d78112325af893aecfd5f0f9b9434b7129c616547f1140e,989213,2020-09-29 15:37:34 UTC,7884653210,7884623210,false,30000,0
82eef74c0b2e2fcedddfdf65d8c537e97b08dc0d54e84d197d37af8eaf03645f,989213,2020-09-29 15:37:34 UTC,61426100,61417556,false,8544,0
19df53152cbd1e04ce353832a9cbd8d25dc9acf2c2d32a94bbc98f657325d6ad,989213,2020-09-29 15:37:34 UTC,500014353,500004353,false,10000,0
123ef7ca204729e8e2b7990d884d12dc957657b86c87cd6bd622d0e370293d72,989212,2020-09-29 15:35:19 UTC,4535893640,4535886640,false,7000,0
0e420ba75b5628406c253f5863900426992ba2512aff57d16eeb29fda97f9ba8,989212,2020-09-29 15:35:19 UTC,614665254,614657466,false,7788,0
38bd39a8ca802ab16e4a39f7ba125556d6747805d8b8c1ab28ff1b28e4ca0454,989212,2020-09-29 15:35:19 UTC,567584187,567581927,false,2260,0
b736b37c662f5e606450f53282fce4213c2a71fba3796d9b44f027cff62e7d20,989212,2020-09-29 15:35:19 UTC,132958693,132956773,false,1920,0
e760aa0dc8a94a9ba55125e7b4867031d431bf12a5af42a6ee6f4e72c62b4a45,989209,2020-09-29 15:33:47 UTC,156995499,156992539,false,2960,0
837fe2b303f62c3a3186d4d419f59fc473c1bd8cc7dbeac68ec68d63800f6b93,989209,2020-09-29 15:33:47 UTC,4512010000,4512000000,false,10000,0
87bada050ef6078fc2509cad0d9d59e974dd236b57ef1d1b35234cc50137dd8b,989209,2020-09-29 15:33:47 UTC,500003740,499993740,false,10000,0
f93c5ac4afb95d14113c28e01e5519f5f5f6746e7ea688f8616494083c871172,989207,2020-09-29 15:31:48 UTC,55936063,55926063,false,10000,0
03ec6d72e2cc0ada4f3799156146415811f82145407ffb027df11ac3146b3ada,989207,2020-09-29 15:31:48 UTC,1600677528,1600612440,false,65088,989196
ab3a2a053f4a698b5904d3c5b297ccb07d6029a0572a3b22c0ad3ded8c7bc07e,989207,2020-09-29 15:31:48 UTC,61484915,61476371,false,8544,0
b2edeccf2cf5b86d4c7b8372435367129e030b941588a34a21f8085a172733e5,989207,2020-09-29 15:31:48 UTC,585789523,585763063,false,26460,989196
11190d9968e9a8d8a453dd28d2f7d986dfafda759112255dfe4c8022d1aa1b4d,989207,2020-09-29 15:31:48 UTC,349970000,349960000,false,10000,0
6365ac32d0d3e511468409e2a371ca19e5e03bb73f980bfe7210cd35a772224b,989207,2020-09-29 15:31:48 UTC,500022742,500012742,false,10000,0
aa42d88301c999e3b2cdbd6f798cd34c0b8aa5e642c3fdde1408e14c8a142ff8,989206,2020-09-29 15:29:22 UTC,199994000,199988000,false,6000,0
0ec5953fbf46f577aee319bee3cb6cd932e1151c36a249d016a0323dbd05cb91,989206,2020-09-29 15:29:22 UTC,500032742,500022742,false,10000,0
bbfd8a47731724c128e8096a02772260c8b28e555540236f1b6fb75d6af97e25,989205,2020-09-29 15:28:01 UTC,61677883,61669339,false,8544,0
9f7da425a9639a2c0f871587c4c29e9d9f183e6f958bf1bc126f8498533fa1ef,989202,2020-09-29 15:27:20 UTC,61760848,61752304,false,8544,0
33baf1bef60a55a24bfc728fbd769d330b94455be9f67d8864c1b4489db9353b,989202,2020-09-29 15:27:20 UTC,8041105676,8041075676,false,30000,0
188c89a18b70f133b0587292a9a450e264b1898aad17bc35db4b2bc91eece588,989202,2020-09-29 15:27:20 UTC,8636933641,8636926640,false,7001,0
7c4a7b4496be33bbe34786c4ed76ae7407b0eaff3b38cc69a8627d501f3f14b8,989200,2020-09-29 15:26:16 UTC,53319933,53318013,false,1920,0
53615a091dbc36e2d18245a165c29f759f36d497bc89572031989de7dcd0a1ce,989200,2020-09-29 15:26:16 UTC,417172555624,417172553531,false,2093,989188
c295e5a474948c4d9c4940f1c36f8275bc1808fffcbac62f35754aa1de8a391d,989200,2020-09-29 15:26:16 UTC,187543976,187541016,false,2960,0
ba5eb3c6cb258fa759c02da5c98b059dcdfd44806b9297c5198fbea94a9c2f4b,989200,2020-09-29 15:26:16 UTC,200000000,199994000,false,6000,0
398912015ba04955f74cfd072c049d8e0766660771334630be6ad8b591615998,989200,2020-09-29 15:26:16 UTC,4451010000,4451000000,false,10000,0
bf68809474a480f13211d0d145e05b24205f0d466244cb2d222934b4b8396029,989200,2020-09-29 15:26:16 UTC,161040841,161037509,false,3332,989189
726f09076dc49ed2d3993dca700243b712bb6294eea6aa2d89d5011314502038,989199,2020-09-29 15:25:15 UTC,51448000,51446080,false,1920,0
bc6d90c352ea19ce5b44677fc508d949aad8c8a633361cef739f9b971d417125,989198,2020-09-29 15:24:07 UTC,1597899038,1597895298,false,3740,0
c4c4c144920ee5c500890f3345b2635fc24c45eb888679570f838bf4b6c63cce,989198,2020-09-29 15:24:07 UTC,328358665,328290313,false,68352,0
5772ea19d2c8e81db79ddb21e9080fa763b24df3a8dc004653f5d9d55244924f,989198,2020-09-29 15:24:07 UTC,61938912,61930368,false,8544,0
eef079fb636c65d3b43ef0d21b393183e5ba5828026bf001fac4634c15326398,989198,2020-09-29 15:24:07 UTC,20401848359,20401838359,false,10000,0
3d96766edfe33bb464ce2ed202c43870a49ada38cb49b4e037224cc7a0256220,989196,2020-09-29 15:20:50 UTC,679269050,679266790,false,2260,0
aad146a0b01ddbb4e6dd6b752b1ced532ea4b13510f1e1753aa16aee20f9661e,989196,2020-09-29 15:20:50 UTC,38029321,38020914,false,8407,989184
3c9e414ef6e299b05d039d22134227441e54597c9bb48c8f514bf195400634a2,989195,2020-09-29 15:20:42 UTC,20674853026,20674843026,false,10000,0
f7d82c70d5b3f98e18c600b3eb1a60ade9e47f7e8760d3c792a258bd2deb3738,989195,2020-09-29 15:20:42 UTC,1602401917,1602337094,false,64823,989184
eddeca0d6bd01f7f659e42568123dc0a18aa963352346413785716ed31396a48,989195,2020-09-29 15:20:42 UTC,586599392,586571445,false,27947,989174
23a1a91908b0a36fa0c4cc629002db2e629abbeb66becd2c51f20f6e5225f714,989195,2020-09-29 15:20:42 UTC,62070364,62061820,false,8544,0
edec5684b70ce411b62a9b1b40b61c61e2ab1f3681af3ef6bbf2bc66edd00d8a,989195,2020-09-29 15:20:42 UTC,594813256,594810996,false,2260,0
62cde667e751595407032a5f5d3a66a2b10060bca7680bfc344fe5aeb27e6404,989195,2020-09-29 15:20:42 UTC,106280800,106279654,false,1146,0
be883fc8ca5f30ea5e38da40ef40db8d68f805f0852703146eb22d3ff0080deb,989195,2020-09-29 15:20:42 UTC,188118715,188095960,false,22755,0
1c43789fe1d88c3865376186c56e83c5b3b168648b4091f3346190d663f23f5a,989194,2020-09-29 15:17:46 UTC,278853,268853,false,10000,0
00443cecb641ce91615a082d234595105d6ebdb5c5ba8ffc2077f2ed95ccc2f1,989194,2020-09-29 15:17:46 UTC,418702058007,418702055624,false,2383,989095
490fc9f7541c12b07e3cc6046a701485682062f1ded59a0d77f3b064dc1232c1,989193,2020-09-29 15:17:10 UTC,600062822,599962822,false,100000,0
c0d49521f876a933813853db5ef05108e894559bbf7b362c42550ef61325db05,989192,2020-09-29 15:16:06 UTC,8489653987,8489646987,false,7000,0
b5fd39ee3fc21f3aecd3252f88ee7ef39ca204457ec55770cfd4a75c15725988,989192,2020-09-29 15:16:06 UTC,214756474,214753514,false,2960,0
f894b4bb94cbe342299204a968ac8238f9ce9d5abaa459aac78570458c8d89d9,989192,2020-09-29 15:16:06 UTC,239423704,239421611,false,2093,989181
620a61e0202ed9d0f4955022d825b3d054e659b86384a240884384ec72a9065e,989190,2020-09-29 15:13:49 UTC,221757760,221747760,false,10000,989177
b1cab85afcb9e4eec9c8ea7323ed580869b0f83f6f3d38b41a55881b1e9dc29d,989190,2020-09-29 15:13:49 UTC,418802060100,418802058007,false,2093,989179
44cc1e485fa47cc731e42a9a9dc3fa0b88f013f73c4bc2152a131a45ad214417,989189,2020-09-29 15:11:41 UTC,587350628,587321562,false,29066,989178
9b5c841a13271721deaaa50e59be6175594c5fe7b018b1747b2cafe3ff005a28,989189,2020-09-29 15:11:41 UTC,1258797556,1258787556,false,10000,0
11a3db24bb60c3f8dfade2e0996d9eebbfc506a5344b0abd611fad937d425f86,989189,2020-09-29 15:11:41 UTC,10120109,10117659,false,2450,0
7a6205b09a2aee91aba9baa062ba80875391e41b756ea6145c3169980fe8b6c7,989189,2020-09-29 15:11:41 UTC,4410010000,4410000000,false,10000,0
3d73ad08cc09ceba93b4321a2a5dacefe0d218eb501822960d8d7ed547faa072,989189,2020-09-29 15:11:41 UTC,157169228,157166268,false,2960,0
2e60a45968ef8dcecb4d9d7e8757e36a26b5066529d5c1f2eeeb64608acd5666,989189,2020-09-29 15:11:41 UTC,3167200000,3167155240,false,44760,989187
5ae5382ea1d735c7f1901841564a3556736a07e3226ab92f28af0f92bc1f3eb8,989189,2020-09-29 15:11:41 UTC,20674863026,20674853026,false,10000,0
18a3021a154ddb8e2c9303626ece31c49c300580f9b26a8e467946d5c5fcb69d,989189,2020-09-29 15:11:41 UTC,1603804420,1603736470,false,67950,989178
90c641cb86198b65d67da1f6b66fd9ec9cf5e5ca68f13f5c7207c02f7b35bd80,989188,2020-09-29 15:08:29 UTC,62113834,62105290,false,8544,0
40cf4308473d22d014d9c3f7e63c5c7f6180dd966232572441ff467233635e5f,989188,2020-09-29 15:08:29 UTC,270957837,270955744,false,2093,989177
c1e70b5fe9add88eaee026ed4d4e0f51d8ba56b81bba548315533b154381bd61,989188,2020-09-29 15:08:29 UTC,999973080,999963080,false,10000,0
241b2968cf353dd7eae2e563061fb77bc66cafeff54f6829a12cebf0b7ada1db,989188,2020-09-29 15:08:29 UTC,220598080,220578352,false,19728,989177
1cc69e02f102ab3118be3912ed5acb8fb1a99e6c027e642941b5afe690076e43,989188,2020-09-29 15:08:29 UTC,2500022085,2500012085,false,10000,0
8cc5d3c8e2eafa53f438efb04662910dead2a1e30fa657e557e5f3bb42b1d1ce,989188,2020-09-29 15:08:29 UTC,113990,83990,false,30000,0
9f49b1ae823369c16eb79be3da3d7a11ce03602c431fa983b893480103fe583d,989188,2020-09-29 15:08:29 UTC,74420972,74419052,false,1920,0
65e1cbf28b18e4e6cd3ecbaaf4f951836498eceaf26529a174c18feb7e58e000,989187,2020-09-29 15:05:22 UTC,187708640,187705680,false,2960,0
d900694a00ee2366b6f4671847c3d7225769e3ff7dd7f2235a7ca5d456ffad12,989186,2020-09-29 15:05:06 UTC,500003080,499993080,false,10000,0
522a381aa785cc604bcbff61ee73198a9c763a990a98879ead398971cfdff32c,989185,2020-09-29 15:04:56 UTC,12401937,12400017,false,1920,0
d2e4644a2c20c51655387b96b193776d479fceef073618d2096515022ce07a19,989185,2020-09-29 15:04:56 UTC,819106337,819037985,false,68352,0
743edf3d13b43078a8803504f6a63b191b6b7b79166086c594b319e1021fb8a5,989185,2020-09-29 15:04:56 UTC,1000018544,1000008544,false,10000,0
301a60fd5ab288000047e23ef3ef1c265d46c9db768ad330f9049864f0f7ea34,989185,2020-09-29 15:04:56 UTC,236318701165,236318691165,false,10000,0
2fdcb1bba3ce1f3b55c606039bebd403da749b32ab3b630ab16f8609dd58403e,989185,2020-09-29 15:04:56 UTC,4000178337,4000168337,false,10000,0
6c2b76a1eeca4e63e2859366215d335e6e0d1390cd8524388b1e5dbf3e326d0f,989184,2020-09-29 15:03:08 UTC,214903351,214900391,false,2960,0
a50d137c54c1c08d0e06701343e24a4d2962f5d8e741c3728433fbc24327d596,989183,2020-09-29 15:02:53 UTC,500013080,500003080,false,10000,0
fef852c0e45e30db1856fb0678a6aea633776263d2a41f3a5af6f0a19413df35,989182,2020-09-29 15:02:16 UTC,588133391,588106606,false,26785,989171
a9036b7fd6058c1000a8608ae18d0303d0773e969f1b4e1ced8a1cf4fde58c05,989182,2020-09-29 15:02:16 UTC,5667212901,5667205066,false,7835,0
d62e46f417628cbee716549e5d463bccbddef25ebc6e7acee7c18d7bf79cfbfb,989182,2020-09-29 15:02:16 UTC,2000137938,2000134974,false,2964,989171
6f50a7a92774cdc03dc113d1a9e1249b464e45c7d824788e0520ba98eb0beaeb,989182,2020-09-29 15:02:16 UTC,1431781390,1431778144,false,3246,989171
97f8e96f4b077ea1d33c534c1e9186bc54bc0a8ba30ed58d948585eeb42260bf,989182,2020-09-29 15:02:16 UTC,62199366,62190822,false,8544,0
b5a1b91e287006cfa7a154705f5624fd76468b85941326d66c4cf105fd20841a,989182,2020-09-29 15:02:16 UTC,10000,,false,10000,0
aa661d238475101afcc25200fd7a59b0461cc275c7af84d4aeda45e6e1b1d296,989182,2020-09-29 15:02:16 UTC,1604906062,1604844751,false,61311,989171
d2670c05c60d5895a9a971f6a65500da9d2f918f2a3f25f0efa5105966fe7808,989181,2020-09-29 14:58:32 UTC,35057144183,35057142250,false,1933,0
6404a0172191aed98672e868f2917b32acaff33d830b1117bcb4c4e82351c5e4,989181,2020-09-29 14:58:32 UTC,157339702,157336742,false,2960,0
a98a5fce355a3375e8e81a5398cdc64f1859bfe0ceac349aca226db49043f141,989181,2020-09-29 14:58:32 UTC,1488293543,1488285783,false,7760,0
677c0199eb2ff9c3b3d941ea64d3f82d5f2f7ffe9a3ebb2009a6c3686d2e2804,989180,2020-09-29 14:54:49 UTC,88789422579,88789419889,false,2690,0
c17b70f5b97dbca6f98e36d44255b211678b95b4b4daf9aac4314b0877ef6b6c,989179,2020-09-29 14:54:11 UTC,325468488,325466395,false,2093,989168
cbeb1cb32082c15f3c925915363676c24c685fafa450974df9dd5a97900a914b,989179,2020-09-29 14:54:11 UTC,98735712272,98735642272,false,70000,0
0f14f0c93487b18cf7ccaa38965a42741f6c813d0a77d0b385aafec61d9a9017,989179,2020-09-29 14:54:11 UTC,187885317,187882357,false,2960,0
a0c00aee73b56643d4c55a792fb788f37fddd0c67c2cb8bedbd30d31a4d2b0a1,989179,2020-09-29 14:54:11 UTC,641083969,641081709,false,2260,0
f9bf059b7c6617a2865ff23682d578ff42e9709c724e7fa9a6781f10428dd3eb,989179,2020-09-29 14:54:11 UTC,420914973600,420914971507,false,2093,989168
8a30f602c8b409f3f47f44177c81ecbc7554e2e655af8b4aefa10cf535ec2ece,989179,2020-09-29 14:54:11 UTC,48250,43576,false,4674,0
b2efdb486bdbdaad670def44ad555311e091f44a8d06cc6c827c12766b82d2bb,989179,2020-09-29 14:54:11 UTC,1975826431836,1975826429752,false,2084,989168
9367dca46a9810d0aa4acb12d90a6f23110de3d9f62f2da480b76dea081e9116,989179,2020-09-29 14:54:11 UTC,1514320378,1514318285,false,2093,989167
ce8bfd60cff884c1155b8d9c5ef8688380a2ca77666b105d271a387babe1ae07,989179,2020-09-29 14:54:11 UTC,37135700,37125700,false,10000,0
524331a91df90f6a4a75cac5028b655b430b24405e28141affe8a77d55335e32,989178,2020-09-29 14:50:57 UTC,215106834,215103874,false,2960,0
ef3db865ddd2639831f0e43ae341bdae01f1a937112fb453a00745c5d2b44566,989178,2020-09-29 14:50:57 UTC,1606277230,1606214441,false,62789,989166
c5df0702cacf3c6c564ae4e9f2bcb939c97d2b3e7395a1f0b3c70035e23fed26,989178,2020-09-29 14:50:57 UTC,211520859,211501057,false,19802,0
813c78efbc1b468b9c780fbca52152c2456a9e2e8aadd8eb908e9c5807442270,989178,2020-09-29 14:50:57 UTC,100000000,99997550,false,2450,0
7b4429004200e4f97919ac2627405352d56d1331c6a9a9d1548b6e2584075c46,989178,2020-09-29 14:50:57 UTC,588767913,588748681,false,19232,989166
ce6dc300ea1f4e0b05d631a92d3d9b2a5692e68d5a97a447b568e34039ae3ed6,989177,2020-09-29 14:50:00 UTC,631314475693,631314473600,false,2093,989166
b1f2fd3b16f8780b8224889c0f218c0dc2a2fe2070929276bb575fc9ddfc8804,989177,2020-09-29 14:50:00 UTC,497535856,497525856,false,10000,0
d80038beea4a816b25817ae0fc53a27ffe03c093b43b4075315f25aa6ef0ba87,989177,2020-09-29 14:50:00 UTC,180971648,180903296,false,68352,0
b9a6b2e8b6299159da55f52b9d18f21afd21057fcb6e14d0343f58855425e9e1,989176,2020-09-29 14:45:57 UTC,1277099,1274649,false,2450,0
e90f1e815733222cd71941f7899b06abf021f3580c79068b984118a411edd9dc,989176,2020-09-29 14:45:57 UTC,499990000,499980000,false,10000,0
daeae577cd25c606f1b0bbf6f5a000385741b65db255d3e25e4466926f805368,989175,2020-09-29 14:45:43 UTC,631582993876,631582991493,false,2383,989164
97d27c3db0a32249e9312b09467bdb87080c362789099944661e034692f1a47c,989175,2020-09-29 14:45:43 UTC,190641203,190639119,false,2084,989164
7eb782770cc48cee588f680ff98fd1e280c3c123bca928a34a4a7932a2f84e65,989173,2020-09-29 14:44:16 UTC,500000000,499990000,false,10000,0
d219b7352427c7e4fc8978447c29d5761799a1a38b5933b4470516a88a888fb0,989173,2020-09-29 14:44:16 UTC,10000,,false,10000,0
08a0f57e05a36909a8df4ca519d9d36026c2d21bc125c16dd6e0520961f53bed,989173,2020-09-29 14:44:16 UTC,233041196,233040196,false,1000,0
b0c6908f5b7fdc392a71157f8400db99b50db978f78489cc1905c6cd7b925c9a,989173,2020-09-29 14:44:16 UTC,62279440,62270896,false,8544,0
923185e05c8c134d02937b14a6ca170206e5cb5a9ad703ce48d99b9b8e28ad89,989173,2020-09-29 14:44:16 UTC,27963508,27953508,false,10000,0
a6a0d3e50f6927d4d09336892a557cc4c723756d56a5ce86bb6aa3391ed08f54,989173,2020-09-29 14:44:16 UTC,589602564,589575531,false,27033,989161
10d18cd8d39c1156e7513fc5141969b652341941b6ef0599fa7c1994491105ec,989173,2020-09-29 14:44:16 UTC,595005317000,595005314650,false,2350,0
e3869a066b6704a6dca6b7c3950893df05883aad49b2415f57308b546d8592ad,989173,2020-09-29 14:44:16 UTC,1607625496,1607555786,false,69710,989161
a4b6b82bdca2988053e3b78af69f0554eb09422996e7d5dfac02e44ee2be9299,989173,2020-09-29 14:44:16 UTC,232997123,232987494,false,9629,989162
b0ed7b6d9ed18a50933cc39cd8fd67dbb4627b90e183d887f0909564cc20e6fd,989173,2020-09-29 14:44:16 UTC,349970000,349960000,false,10000,0
2bbe13f6483d07a5cfe41abd46d079b8bc867efdbad4ae9c7dcf62ae5041d1fd,989173,2020-09-29 14:44:16 UTC,8678635,8674995,false,3640,989162
c2e291bf9a4221d428a17f76c9c5df287b389ad549789dd69092f1432789a5c2,989171,2020-09-29 14:39:31 UTC,157493882,157490922,false,2960,0
156aa2aeef0130c267143cb9adae784133622c407a749c52329b528b78616787,989171,2020-09-29 14:39:31 UTC,37858389780,37858386380,false,3400,0
f0a048c6e9213a8df4e7a3f7ffb7079a7687ca3c39f01e7a91447e692df52d1e,989170,2020-09-29 14:37:40 UTC,20000,19750,false,250,0
b839b68d3477c37018785e3d099a89a8ee67ee23fb06b6e577b0b96118152b7f,989170,2020-09-29 14:37:40 UTC,500007090,499998544,false,8546,0
c65bc6b5cb3bb4a416d4d4e5a96f39f09ac267150da23e4cc135565d6f4e17af,989170,2020-09-29 14:37:40 UTC,1500061385,1500051385,false,10000,0
dc9941adb04a4c0d503bac2b3e03d4b77ab0e286ca1b5938dd82e39a63fe78e7,989170,2020-09-29 14:37:40 UTC,10000,,false,10000,0
e343b6ff9276a4e4fe8b1af67a15697dcbc9cd41a6b8b9f0fb1e7c5ab72ccc76,989170,2020-09-29 14:37:40 UTC,631741095960,631741093876,false,2084,989092
f61f14bb3532aac748bcc4bc2ca5f635d7f2f1ac60e20670351128b9c2cea0ba,989169,2020-09-29 14:35:12 UTC,112144,102144,false,10000,0
be9b7b41b3146f843463ad185984f19369792bfbe21f071cab579b58267e10bd,989169,2020-09-29 14:35:12 UTC,57777388546,57777372966,false,15580,0
34e2fcb1e288f987032e4af60410b397dd7c9acb7af6429b8a41a7682ef0608b,989168,2020-09-29 14:33:54 UTC,635740598044,635740595960,false,2084,989157
985b64d27b825ca6fc0d95b628dc2ba33224f368716b5e684e2bb80aeb9fe9a1,989168,2020-09-29 14:33:54 UTC,679034689,678966337,false,68352,0
14a93342fd27fae4fdcd92b84b85f5b06f3e763237498092512f57e1247e933a,989168,2020-09-29 14:33:54 UTC,142931648,142831648,false,100000,0
f8f66c909dd03d6a194a3c3ce4585cad28713414fe0c9105de63ded03229ae4c,989168,2020-09-29 14:33:54 UTC,1608650270,1608592188,false,58082,989157
7e1df9b61e59a333abc27ca12e790449b2c03296aaf83aebeb1cc6c1452f0e5a,989168,2020-09-29 14:33:54 UTC,62401639,62393095,false,8544,0
5486b224c8adab558c61c12c1016859397347f86e6a129afdb50a32c0a54905e,989168,2020-09-29 14:33:54 UTC,20250,20000,false,250,0
26d132a9736d9bec2541c89994d60cbe98f6982ee357de0f59d331e478dc1f8e,989168,2020-09-29 14:33:54 UTC,10000,,false,10000,0
3cb17819703ee7050ec96b7f3f9546dd602d343ebc1feb754c312f407bec2892,989168,2020-09-29 14:33:54 UTC,10000,,false,10000,0
1ec177f5c33248e113d82b6929ba571ffb9ee0ebe904351a9925c7fd68b2bad6,989168,2020-09-29 14:33:54 UTC,1713873512,1713871252,false,2260,0
ab8d3dab04ce2b3668c4c0c5fc042877e020159bcbc354c9548881f53e8bc283,989168,2020-09-29 14:33:54 UTC,10000,,false,10000,0
d9b397f1802dfb0b55d52dc1fa6806daddd048041d9e2e813c5349b463451905,989168,2020-09-29 14:33:54 UTC,188043280,188040320,false,2960,0
aff70777e823b8803da9ebdcecc1aeaf0bf114ccbf199316333291c6fa19782f,989168,2020-09-29 14:33:54 UTC,215452905,215449026,false,3879,0
821e9cc6c25d822e89fd427dfafc5184d70a6421dc57a2e58954ffeb4222f4b4,989168,2020-09-29 14:33:54 UTC,62455096,62446552,false,8544,0
3de1e80f2ae5690ebb83b2b507d2d4977f29350ab662b56445cc3de350f7e801,989168,2020-09-29 14:33:54 UTC,590332712,590306850,false,25862,989157
cb6f5bdd16eceadd9fcf94b23cf3fc987ab42f5838313696c357567da48d8af5,989166,2020-09-29 14:28:52 UTC,139291797,139289704,false,2093,989154
9c2669af00740b8b2cffe5b7a0ae2e3ad5fc3f9fc4d310fb6c33ae657550bb26,989166,2020-09-29 14:28:52 UTC,10000,,false,10000,0
c226686724080295a541d972bb283a9b0fe0a7dc61d0ad346f89ba7f21365e66,989165,2020-09-29 14:28:33 UTC,158126377,158121886,false,4491,0
8e10dbe74a32a128732d8a7ead88178b69378ca57393e091cd4e78d321ee19ed,989165,2020-09-29 14:28:33 UTC,62861936,62853392,false,8544,0
5dd98b4c51a33bc167555f773da19e71b71fc744ee6c7a85ac6c4176c48ca42a,989165,2020-09-29 14:28:33 UTC,10000,,false,10000,0
7a57ac3c1717de76bd350ba03b617f97a291658b8dc1dc06a9e4d9eeb96e4cda,989165,2020-09-29 14:28:33 UTC,635762263912,635762261819,false,2093,989153
36eba600b1cb0dcd78a356ce08e5eb36a2018d4a42453abbcd91712a9bd0a8f3,989165,2020-09-29 14:28:33 UTC,62628729,62620185,false,8544,0
4ac4571b61c30748757891bd39bd2b1438018379c874d0871b020405dd45e44c,989162,2020-09-29 14:26:29 UTC,20335246166,20335236166,false,10000,0
2d8ff31816357d347000cbe6815b87c8a2a1b6ff9a4012cb78443d0237b7f808,989160,2020-09-29 14:25:34 UTC,29470000,29468080,false,1920,0
70863552d72a984d81c52b3e3b76f44c1bcddb009a25b0df9d635100f8f625bd,989160,2020-09-29 14:25:34 UTC,10000,,false,10000,0
fd34226f079aeaf6b86aed2e7fbf2990a1d2056dabe66952b39788aa5d01df3e,989158,2020-09-29 14:24:45 UTC,20935092459,20935082459,false,10000,0
8ae31b56fe55a66b5f6eb33522849d1e177750a5bc14d6f280463b79a4140821,989158,2020-09-29 14:24:45 UTC,499995429,499983344,false,12085,0
72e26f0cc83b2828dc6626c138a2cf65ce006e2c90dadd8599a4da7da709fc50,989157,2020-09-29 14:23:53 UTC,20000,19750,false,250,0
bfac73beba5f7f233c54eb6a4a9577f07d793800029e982dc4ee6a1da5386fd3,989157,2020-09-29 14:23:53 UTC,10000,,false,10000,0
502bee2e1910dbec7eeddc67fac7b7991ecd6fd9433cec6e46180ee2fb4f1903,989155,2020-09-29 14:22:21 UTC,20250,20000,false,250,0
25ccd22b268fb2c8bb6f334254699545a51cf83c36eeea6072476dd9c57e49e6,989154,2020-09-29 14:22:15 UTC,4163910714,4163895390,false,15324,0
f3c2a5788e939d71b32ae1f305fc957db1d9dab07a0f9c3ac950e8f23fa83856,989154,2020-09-29 14:22:15 UTC,100000000,99997550,false,2450,0
4c15ed8c163eb9201b420f8a21f56a503fb8cb10ae060de9aa6875cea67dcbd2,989154,2020-09-29 14:22:15 UTC,10000,,false,10000,0
b87b1ee6d3e9da133aad02b132899e2eb1a4cca0229c9b2f8f08c412327ab0fc,989154,2020-09-29 14:22:15 UTC,100606772,100596772,false,10000,0
95236e1e502f2b70fb7d4caaaa5f64e0e62ef53154ad54ae6f56012f5f2f7ad5,989154,2020-09-29 14:22:15 UTC,188214418,188211458,false,2960,0
cd0a91eca7d3ff30638e96a83d35bea07292d35908445175233c4609f24bfa2a,989153,2020-09-29 14:20:42 UTC,20935102459,20935092459,false,10000,0
2c1a07f0a890e995f80d3a2c3c3ce73e9fd1ad21489f999297f5d0565e14a77f,989153,2020-09-29 14:20:42 UTC,311802367,311780234,false,22133,0
618c65b18dd7f5f8a09e4129e3765512ea51afb5eb8f05605ccbfbfbad4bf352,989153,2020-09-29 14:20:42 UTC,1610645344,1610572695,false,72649,989141
676ff93c083ea7d512ea12aed41402ff44c77e792c0b36644fe0cd279d412eab,989153,2020-09-29 14:20:42 UTC,591367030,591337955,false,29075,989141
c819dfdacc431593b533712f3625c7b03e4de9d0300aba2bab803ff21969dd18,989152,2020-09-29 14:19:25 UTC,10000,,false,10000,0
e4ed3d01ba67f1eace35de8768f7d0a7e61c95c7105dc00739bba0d4990520c1,989151,2020-09-29 14:19:06 UTC,250,,false,250,0
3c50e5e39f2584fb25c0ea88efead0f42b4b114957a241654038a6591ba0a690,989151,2020-09-29 14:19:06 UTC,635862872777,635862870684,false,2093,989140
2b0bf2bb68736a9ec11eb0fa9051bccaf9b8c1ed613f27c01001008d41752d56,989150,2020-09-29 14:18:23 UTC,333593100,333591518,false,1582,0
b714c2a15a470baf9bcae4b725a4ac08653f957f7ef95bb720ecb8da72f3d754,989150,2020-09-29 14:18:23 UTC,351473117,351471024,false,2093,989139
3b892b0ad407ed7df5dca0c4f8d054bb2749a0595b83b983a3346728f7b3b7aa,989150,2020-09-29 14:18:23 UTC,499990000,499980000,false,10000,0
e4af086e4f8874bfd57892a69c3eb382676039bdbe4ab2e8778b38fc870ba3f8,989150,2020-09-29 14:18:23 UTC,10000,,false,10000,0
8b1218d319272d47ad6e9fe224aa71f71076dcd22a1bde3aa7e2a4efefb2c57b,989150,2020-09-29 14:18:23 UTC,215675949,215672682,false,3267,0
1008f455567a1163fc1200f7fbc212a9596aa6e02fff43e6a4e2084e1d2986d2,989149,2020-09-29 14:16:18 UTC,62943855,62935311,false,8544,0
94a28dc3d7dfd07043bb8dd996f36cbadcdebf8cdcad4fc6847ca101cbef8100,989149,2020-09-29 14:16:18 UTC,158341728,158338461,false,3267,0
556587f69a384e867d0ecbccbb803839783049a72904f8c36a3e64d48042dff3,989149,2020-09-29 14:16:18 UTC,188402802,188399535,false,3267,0
6d3ab23a600a73060dbfaa985137d3c5649c4dc9cbc47b98b55d7bebbdd86457,989148,2020-09-29 14:14:59 UTC,10000,,false,10000,0
dac3b0ecf0d752bf391e31c9c1a5ea29799419c0e6b24e443896859ae05add9e,989148,2020-09-29 14:14:59 UTC,40651604339,40651504339,false,100000,989066
5ea2abaa11218f429c24ce837d0240b08bdbef61bac980d98edb804d53aff43b,989148,2020-09-29 14:14:59 UTC,62986121,62977577,false,8544,0
e80720be0bb8f56da3820ec73a105977eda5a4b88b0df475c8529510a28bb8e4,989147,2020-09-29 14:14:07 UTC,499990000,499980000,false,10000,0
e1326757fd696e7aa9aff3eb6a70adcb4ef94276e3da771ca740939438befeb5,989147,2020-09-29 14:14:07 UTC,10000,,false,10000,0
e0cfce4b3aa18a378df9492ac926f2506d3fea38df3b73e074cf172dd1d7b3b4,989147,2020-09-29 14:14:07 UTC,536047800,535979448,false,68352,0
e4276405e9fa5b89e62eb0563b1de39ff339ddbabe926b29cf2950d27e8a8289,989147,2020-09-29 14:14:07 UTC,215822663,215819703,false,2960,0
0e43f489b5d1a26178297d2cf178607d6115cdd4626d979562733c396c578f42,989146,2020-09-29 14:11:29 UTC,1612706050,1612633401,false,72649,989135
cb22009b7d899df1c49e4c8bcae071c30c3d75007b38be1b8cc3e55ba1cbdf70,989146,2020-09-29 14:11:29 UTC,20000,19750,false,250,0
807d03c720b3fee2633bc353f94c94609c02137361690de1cb30a1e3d9fc1bd2,989146,2020-09-29 14:11:29 UTC,592019103,591990618,false,28485,989135
a7147f55cb357ed90b9ba194bf2c51a87ac24a50d48ed37d4b630b6368ecc63d,989146,2020-09-29 14:11:29 UTC,10000,,false,10000,0
1fbac97b3335455304ce1633ec665b22f5d24fd98598685eae9f0cf9d9499ec4,989146,2020-09-29 14:11:29 UTC,289556000,289550000,false,6000,0
bbe29df4a207128f72707b983769530f30784f173b6191c222c5a8bbc87d3477,989146,2020-09-29 14:11:29 UTC,333603100,333593100,false,10000,0
625a9ceaeed30cd7ec0f09a996e06e954b95e0ea0948a3652a94818a2933d785,989146,2020-09-29 14:11:29 UTC,188925024,188919309,false,5715,0
0741485faca64c38fbd74d4ebe9dc74f7626a3a89eeacc7b514ddfffc7d8f60d,989146,2020-09-29 14:11:29 UTC,63101862,63093318,false,8544,0
172c5de7fc9e90c7f562d094c08c2b1b647a110c8ce69e2906e04440552b3569,989146,2020-09-29 14:11:29 UTC,10000,,false,10000,0
a7bacaeb08a140ecf9f688b92fcdd9ad6bf82d171e66c4323f1fd3fcc329a05a,989146,2020-09-29 14:11:29 UTC,500000000,499990000,false,10000,0
8986c72dd3da806b8bb666bdaf34e7fd5b5decd7d38e46d6f6bdafd136144c77,989145,2020-09-29 14:08:06 UTC,10000,,false,10000,0
4c1a43390e6005d447c2df9c7635d1a5dd476aa53e9201880939e997b0547b1d,989145,2020-09-29 14:08:06 UTC,500010000,500000000,false,10000,0
b9370b30a9f53f9d17a036dcb44972da8d1d589613a55d372498866db45bafd2,989145,2020-09-29 14:08:06 UTC,158497380,158494420,false,2960,0
6e8d8d1aed8daa97ee0dad1435ad0590e5129af5186a7361a70c74ea704d16dd,989144,2020-09-29 14:07:48 UTC,2000151202,2000141202,false,10000,0
de827a2a08da62b610f0260ed1eda65fbf5ae32d69671a1b553fda8fe2a36f81,989144,2020-09-29 14:07:48 UTC,63417915,63409371,false,8544,0
c4592cea0283f5861f97d1fc543e35b120f58038869caf386c4abd9900b84ac9,989144,2020-09-29 14:07:48 UTC,63173076,63164532,false,8544,0
3e8ede60f4e76b368a3f629cd71c6420da6070fa8f8b88f1ec31ae0a50323d93,989144,2020-09-29 14:07:48 UTC,216041484,216038217,false,3267,0
2a8f3eaf2709015bb93237e6dd954e3d6c15ba1b53d7b404cd5d2b23e7265084,989143,2020-09-29 14:06:21 UTC,4000188337,4000178337,false,10000,0
e572efea5de2c2010305075ade88997a34675b4cf08ec95f3b793cd8eba38872,989143,2020-09-29 14:06:21 UTC,112754256,112748256,false,6000,0
4f16ec6ab16d9228fd7053f028f802b1a2eef0930eb05f42e162dff6b6d6dea0,989143,2020-09-29 14:06:21 UTC,10000,,false,10000,0
d7c4658807c693f40d1b48ae3f6b4852b40bee72cd737b8225ab849516681ef8,989143,2020-09-29 14:06:21 UTC,1000164188,1000154188,false,10000,0
7bccacfb8742673534cca9be9218e9fb624366c9f6b35e060e8743e6ccd0cb38,989143,2020-09-29 14:06:21 UTC,87227522919,87227520569,false,2350,0
23557b8e454eb3c6571fe3dd3114221e93c65a371c9867f5d483fc618d11873f,989143,2020-09-29 14:06:21 UTC,33388566,33367847,false,20719,989132
256f6c9a28f4fe18e1ec326adb111d43486e1b3d3627c47eb53cc5babe9eb8a3,989143,2020-09-29 14:06:21 UTC,333613100,333603100,false,10000,0
9348a3f834edc8ceb8db16dd302f192069d3aa07bef1d76e40b1186b41915edc,989143,2020-09-29 14:06:21 UTC,20250,20000,false,250,0
76b98b5de7e10177d10589a5f1ebc16a4f4aeaf49499bed25c7d4685000f0c93,989143,2020-09-29 14:06:21 UTC,595286,592836,false,2450,0
f6687090119795efc373855205b6b2f9f5ef3e76d8dd18bb35d8b2c139820f4b,989143,2020-09-29 14:06:21 UTC,63446360,63437816,false,8544,0
a7f307d14e7c5e27773ce26972ffe978298098e325c99cf70490ba5d0f39b06e,989143,2020-09-29 14:06:21 UTC,236627639831,236627629831,false,10000,0
d76a32e3456808d0d86a4390f9e2920ca4e647269c1831a5da5417469422b84c,989143,2020-09-29 14:06:21 UTC,250,,false,250,0
9b43f21fd52552fd59537641ae3b338605f21ddb1e294fa1b3606838a8319431,989143,2020-09-29 14:06:21 UTC,63518849,63510305,false,8544,0
0f632d93b1112d6ed436200a102e2756a0b07aeee39bceecf6149bbec155128b,989143,2020-09-29 14:06:21 UTC,250,,false,250,0
5e0d87ef2c395f950f745fbe9a618b79514425a65de36b5dcf33b81e777ca32d,989143,2020-09-29 14:06:21 UTC,3001861381,3001851381,false,10000,0
e0f8ed72a8e5ed3138621901d24d81360df761081de06fab49ab92642575a267,989143,2020-09-29 14:06:21 UTC,202036433,202026433,false,10000,0
060d99f4db0568673c6f526420318e6b165168a6335ed0fe90bb9a4644ca6cfb,989143,2020-09-29 14:06:21 UTC,10000,,false,10000,0
dd4967212b087a53ecb4940083e3091002738e7b460a2ac89ae1194235d9d97f,989143,2020-09-29 14:06:21 UTC,383747572,383745479,false,2093,989132
6dae61f8569f69625ea159237223e9b389af4030cf816408732643777be6adb5,989142,2020-09-29 14:02:25 UTC,20468621352,20468611352,false,10000,0
99dfbad906c69a78cd40eb33a4e26ccb2553404da03b51b163492463c3529822,989141,2020-09-29 14:02:23 UTC,1521859687,1521855851,false,3836,989128
433e779b77846f002129456de0752d990a62e3929b40a7049d29f12d7751906d,989141,2020-09-29 14:02:23 UTC,280010000,280000000,false,10000,0
d72111e637db0b72d80cd76427c6b1bde997f892bd1f3c214d97c25867f6701c,989141,2020-09-29 14:02:23 UTC,10000,,false,10000,0
cf0ef4c6d22a771ded90c8788886a1229da67bf580599c4983f2e2a4292d666d,989140,2020-09-29 14:01:09 UTC,189349254,189344457,false,4797,0
5dcb2160fd52bb2f38e03af98d003aaf94996f40a36b9911d3791458b1718e0c,989138,2020-09-29 14:00:25 UTC,592688731,592661972,false,26759,989127
61081a300aebc7d7227dc4d5f9cbe065c5ebd1c58c2d055df478f0a663dd5c0b,989138,2020-09-29 14:00:25 UTC,190994161,190992068,false,2093,989127
b718918876fd0f951c7fed218620eccd1ff8e83ed94e7adeb8fc1e19a3e48eb1,989138,2020-09-29 14:00:25 UTC,6494137720,6494131720,false,6000,0
af5bd5a32972d73c81d30ce3f451a37a24f61ecfd8016e04d1d1203f3e25ffcd,989138,2020-09-29 14:00:25 UTC,1559507248,1559504574,false,2674,989127
5f5c0991118d6c2489ce5a1a57d72b96c9b6f3096a321f6022d206731103332c,989138,2020-09-29 14:00:25 UTC,1614085903,1614023472,false,62431,989127
318139e39ff047fc13fe733059eac9d20c3122e0c46332cdcb7fbdc5f7bde0c0,989138,2020-09-29 14:00:25 UTC,158842112,158838539,false,3573,0
facf9d527591c2adfcfdad91ed20db46e98739b58d0b1b4d6d6fce47339b4f73,989138,2020-09-29 14:00:25 UTC,143000000,142931648,false,68352,0
e05ef1f8dce6faa7fc02d5bbd4681ffb25a72ee508e4f8cebca1962f79560e2f,989138,2020-09-29 14:00:25 UTC,500000000,499990000,false,10000,0
e50048c5e88f9095b3d14e278a33d2809f40ce14869e638c4d1f8bc80a73a6bd,989138,2020-09-29 14:00:25 UTC,10000,,false,10000,0
9436d184a473147c6b108af6f00edd4b00252f0d503dbc9e60862ebf67dada1a,989138,2020-09-29 14:00:25 UTC,200863661,200861211,false,2450,0
a44a911df5f0b80d3c00947b86a1b4681e48f6474585d18566998f75f21cfa4d,989138,2020-09-29 14:00:25 UTC,333623100,333613100,false,10000,0
a6fe6699a165538eae45253d43d3ddb19692e430f861b6ff57ed808878878014,989138,2020-09-29 14:00:25 UTC,10000,,false,10000,0
f3ded508100929b0888c14651c4c79ba9d4add72bac70bda52fa0860e4b497ee,989138,2020-09-29 14:00:25 UTC,26790,16790,false,10000,0
a3ef335985c3eb983b1fd3a28b69b5460c8a5041a1acfcecd56621d4f592a970,989138,2020-09-29 14:00:25 UTC,21239581066,21239571066,false,10000,0
aedfa6b7906f61b1468ba5199ffa953c69357039573a2afdab9a323c4f110e78,989135,2020-09-29 13:55:42 UTC,10000,,false,10000,0
749e93122eec9f49ebb5b707220a0ef313c12becb636384c251e359e675bd35f,989135,2020-09-29 13:55:42 UTC,635872060861,635872058777,false,2084,989123
85d738c0b61227be204657adcd32ee96db5f94ef7767c9104eb20f967ae86bde,989134,2020-09-29 13:55:36 UTC,348563431,348463431,false,100000,0
00c116db0dd95c13e803402f122b78d2c443c11a42155bdfd061e8c5a2727e22,989134,2020-09-29 13:55:36 UTC,971312408,971245028,false,67380,0
60ddbf59e071d68ab294d7525b75dd221507b4784328ff0f2a8a17c77ffe0200,989134,2020-09-29 13:55:36 UTC,6514924038,6514920298,false,3740,0
7d71cf2b78326f6b7a172adb748c7a15ae4f41d3d6e3935f466a4dd2524fc1da,989133,2020-09-29 13:54:43 UTC,250,,false,250,0
5ded935775c99bd5a07cb7d88d1a4b728e1a55ed2ee15939d206dcbcc5fa1418,989132,2020-09-29 13:53:27 UTC,56000363228,56000363128,false,100,989121
80f2fb14a6cf8956fdb63157194133efb7d38dc0e7fe8bb809fdd1b1602583be,989132,2020-09-29 13:53:27 UTC,642365700674,642365698581,false,2093,989121
e57bc0dabc4c027584339d8459d097fdd3cbe321e7b2e53b7142607eff41fe6e,989132,2020-09-29 13:53:27 UTC,216195395,216192435,false,2960,0
a5004f31229f646ed935740feee89b35f23652ead397fb1c5a0fdbd953a5ba5f,989132,2020-09-29 13:53:27 UTC,250,,false,250,0
ea555254429d254fde5a35630f24834aee75d9bb39c5e3f5b02e80747db53236,989132,2020-09-29 13:53:27 UTC,539562000,539556000,false,6000,0
5b18fc8b8151b76e7a9d2f3f591b8361505b49a75e526dfca7019dc057b6d079,989132,2020-09-29 13:53:27 UTC,499995425,499983340,false,12085,0
6c63c2bcccc3dad8ff010e1a3bf83aa0ca7a50e2d0e4b7ae3f01d90d92917076,989132,2020-09-29 13:53:27 UTC,250,,false,250,0
a894a60922da7cdf15c0062d6d77a7c3839f5718ad42e5502e8b892a9d297f76,989132,2020-09-29 13:53:27 UTC,189913572,189909081,false,4491,0
c41f844998b54387ebecf20c39e29256f6c0e44a0f4f6883c60c2a9932972d82,989131,2020-09-29 13:51:59 UTC,250,,false,250,0
f2bd89614223a008408525d81c91f73732e8374f2d09b923ff2eadf4137d81da,989130,2020-09-29 13:51:30 UTC,100000000,99997570,false,2430,0
89481cbcd22e4b2ba5c912a8d2507020f653fac3759504d07b354036b6d95118,989129,2020-09-29 13:50:29 UTC,499990000,499980000,false,10000,0
7d278a34f35222f0650a63d6f3e409557800f1af01f95e8f55cd1ed2d4e20d59,989129,2020-09-29 13:50:29 UTC,593768834,593738862,false,29972,989118
9cecee912bc12fc9c60ffa5eceb39c5f364bc60a0e84843cfc5bd44314e98d05,989129,2020-09-29 13:50:29 UTC,125081619,125071619,false,10000,0
d8d84152e0dc695a34a9efa37c0630a5849e7b63596b51bb83002efe8dd15993,989129,2020-09-29 13:50:29 UTC,249798422,249778620,false,19802,0
2d9bfd287cbfc2f9b683e68a43e8e84981f81b15cda3da99a96ab8812c92f284,989129,2020-09-29 13:50:29 UTC,1615961257,1615888898,false,72359,989118
1387aa5f70a0d8b1f8ff8ca3ba1305fbddb1f9f12b2042ea782ccb4e0375737d,989128,2020-09-29 13:49:28 UTC,458724570,458714570,false,10000,0
38ae12fd497db964a44484b483caf2f1b8b8bc26d977bc44d7e3e8082481eea5,989127,2020-09-29 13:49:04 UTC,676560,674110,false,2450,0
f0c74a9d7b1f8c8de22a77c17286b943a60f2aa915e10dfea07d9e3ac0ae2cd6,989126,2020-09-29 13:48:27 UTC,251692350,251689920,false,2430,0
1156901d4b84c3bac6c3a042c700b54801072af2c11c1ecadcd8fbdaed0fc7cd,989126,2020-09-29 13:48:27 UTC,500000000,499990000,false,10000,0
b0101187acb6b8c76b5c2d7c3698339df4c4c6f3e76c23cc2119e74841ae8bba,989126,2020-09-29 13:48:27 UTC,159265809,159262849,false,2960,0
76f8ef21ff5bb26035a05c3c9ec54a471ff196767adf90ccd7d4b5abbaa578f7,989126,2020-09-29 13:48:27 UTC,51703024,51701680,false,1344,0
0f9f0c6958f70054ac0267df0be0705c275b1e9a7f241166de5bdd01a28d1c58,989124,2020-09-29 13:47:32 UTC,333625718,333623100,false,2618,0
f72f6e9695c271b48c3359777129436994799047fae309af8986bc4625113f6a,989124,2020-09-29 13:47:32 UTC,20739611066,20739601066,false,10000,0
bb86ca24cb8643eef7ea53ece89e2d0f8ba26e14ed6252e06893d6d80057974a,989124,2020-09-29 13:47:32 UTC,404314126,404312033,false,2093,989113
42d514e325e58d1a4859141ab6520f49f38c1dca479b65f8587cded16ff4a6cc,989122,2020-09-29 13:46:11 UTC,21617896294,21617886294,false,10000,0
04bc5a4f9c3b43471cc1288204bcf82770ee01f7c5d3dd01716e38a7edfa5980,989122,2020-09-29 13:46:11 UTC,319980000,319977464,false,2536,0
8b526ca8efaa770a67c6df3295aa4c6b4d629b9c0a0c26403f17ec63647a040e,989122,2020-09-29 13:46:11 UTC,255958080,255954680,false,3400,0
1b3b389a0a620becb6984801119377956b2dc00cc956508a31d8011d46ed8a43,989122,2020-09-29 13:46:11 UTC,250,,false,250,0
c3d6bbb0d96d69c6e4eec54bf26c955ff24852d59f801b946c0a482c12ba8f93,989121,2020-09-29 13:45:38 UTC,600839382,600739382,false,100000,0
70a48e3c49b7a5cc26ece1a5ca7b3eba3e084ff5ccdefc215423714c9e74f1a2,989121,2020-09-29 13:45:38 UTC,216438665,216435092,false,3573,0
7405a6c3690c2f5be33e53918f0805da36f34ca454a7b7a5114de2e164475269,989121,2020-09-29 13:45:38 UTC,17217120897,17215854715,false,1266182,0
a46d4f3904319d301beb6ef759e62619d52bc622541cfc88cdc7ece9c09fd86f,989120,2020-09-29 13:44:42 UTC,319990000,319980000,false,10000,0
18ee7a0218b761dbdc13efa11f7d3a1bf5fc4c8a8bfd87b7c144df157b858b32,989118,2020-09-29 13:43:49 UTC,21617906294,21617896294,false,10000,0
ca813d60d52132a28758d55251d63c1765e10c81b01fbe210069b61b7d0d5617,989118,2020-09-29 13:43:49 UTC,58831971,58822317,false,9654,989105
79f22e5263615831c69ec61807a743be7fbb7af5e89a93081ca28676145a755a,989118,2020-09-29 13:43:49 UTC,1928578078,1928568078,false,10000,0
2f868eea80197ea710a529e12920bad8df320be305a3be9da189c23ad7131a9e,989117,2020-09-29 13:43:28 UTC,1019254,1015905,false,3349,989105
7c73b702c6defade52a1a946df484f6a5b6de27f73a3599e710284765bc95095,989117,2020-09-29 13:43:28 UTC,21477977379,21477967379,false,10000,0
ec3dba26cb5775f39978cf10609fc834abe25e45f5d0011d2921499fd48f6c6d,989117,2020-09-29 13:43:28 UTC,190075029,190072069,false,2960,0
44a978e629c833e50fff406796d2fe7ffd2fc49562f8d5c889876a35e7f142bb,989115,2020-09-29 13:42:34 UTC,250,,false,250,0
6ef4a57752157af9ddf513b05bb242552e628b83fb42026c321054efc3bde224,989115,2020-09-29 13:42:34 UTC,10146165653,10145515263,false,650390,0
f608c48eba17fe43dd0a94e5241e0a035eff54c8eca7e6651ee32f6f3e3963ed,989115,2020-09-29 13:42:34 UTC,193863525,193853525,false,10000,0
2e7eb64454b49686c61b88a046f9e02b36bf396a05f0490221a1543f625fce6d,989115,2020-09-29 13:42:34 UTC,499982960,499972960,false,10000,0
e25bfa1ad7c634692cbb75456115a1a091de182bcdd6e32422f2941fa3c43945,989115,2020-09-29 13:42:34 UTC,594438063,594406664,false,31399,989103
55b82457104b18ae3ebfa9a02fb72767e863f54fa3bbb07e99fe65b85b1f9f86,989115,2020-09-29 13:42:34 UTC,1617625153,1617554572,false,70581,989103
1df3f7a2a78409d4941c742089dd9c54a6033ac28817d9a3110a270efdfc784c,989115,2020-09-29 13:42:34 UTC,76354518,76344518,false,10000,0
035680baa768cd4f74812726e0a5cc3e3276e53f3c99fc9d081e3c12588c1ad1,989115,2020-09-29 13:42:34 UTC,320000000,319990000,false,10000,0
9171689d6eedd7dc13cdb66010ce089c7383ebbd1dad6f6556cd646bce96d0b8,989114,2020-09-29 13:40:21 UTC,499992960,499982960,false,10000,0
5884b4ed7bca8f7139e5b919549d835a83023280f084df7a715ad62d375708e3,989114,2020-09-29 13:40:21 UTC,250,,false,250,0
79f56b5644d37f26d18dd6aa2447bd30174acc9a672e03eded7b7a7d4b466c03,989114,2020-09-29 13:40:21 UTC,143000000,142931648,false,68352,0
d220aba4cfb4b6383af5003fd67fd025487841ea735d5dab330658ede12d18c8,989114,2020-09-29 13:40:21 UTC,1226989493,1226983493,false,6000,0
18b66cb2563a6e46f8f71836145017a376da39d6b50d019922c3a352e326c84d,989114,2020-09-29 13:40:21 UTC,188577244,188574794,false,2450,0
48f4f83d3bcbff778eaba54610db8923a651912b6d31ac6a470f553dbc856856,989113,2020-09-29 13:38:42 UTC,159992472,159989512,false,2960,0
b9070d74bee34048392084b6090eedaa8a82811e9294521018a3503a62af1230,989113,2020-09-29 13:38:42 UTC,21477987379,21477977379,false,10000,0
29af4b648798c17de2415f2fab82033d85fc28bb422dca98a84aaa1a05572cce,989113,2020-09-29 13:38:42 UTC,352351206,352335626,false,15580,0
b81233d1d1581dc1933824bc4d91bde98d6e7d4f32476d325473460708a9667e,989111,2020-09-29 13:37:37 UTC,1000083841,1000073841,false,10000,0
9c979584704b8f9d7e3bced7c70cee5c62589ca26d18395dd7043ac084e392a1,989110,2020-09-29 13:37:13 UTC,500002260,499992260,false,10000,0
c3509d927e75d37f58d281d73699c7d6f7bdcb159cbbe6106962e0fee7e921c4,989110,2020-09-29 13:37:13 UTC,500002960,499992960,false,10000,0
04328654a0543bf0cd0842ab179052c9a9eb227a03d53183681a7dfb4f0348a9,989110,2020-09-29 13:37:13 UTC,21189487517,21189477517,false,10000,0
552ba5ccc6d89da8a1a5c72d36fd4b631b339daba8477c50071954cd6629334d,989110,2020-09-29 13:37:13 UTC,102047909,102032329,false,15580,0
0b49dcd17dc8e4c56e029c6596cb4878328956bdcc580f5200ee93db6114e8b1,989110,2020-09-29 13:37:13 UTC,424054504,423954504,false,100000,0
60103ac545b995b9a22c8a8631caa890f9adee385a70cded7af8834f9a1ac3f2,989110,2020-09-29 13:37:13 UTC,500000250,499991704,false,8546,0
fd9732455cc332fd9ec9d7545effa152f0ba331fc6ecdaa24b21753882f687d0,989110,2020-09-29 13:37:13 UTC,235051543,235035963,false,15580,0
7b0b6faac55da3bddf51bb420dd792c06d26f60517e4dea06d12c8149870dc17,989110,2020-09-29 13:37:13 UTC,15227119,15221899,false,5220,0
9932fb5453700c69600ff0a0f5b98e3c04abf27c505bb5083fa925b757eadce2,989110,2020-09-29 13:37:13 UTC,216955414,216950311,false,5103,0
f3b72b16da5d3d0c2c00bfdbac3bd9e37f2edb8c8385e791f084217e7477bf0f,989110,2020-09-29 13:37:13 UTC,500004613,499994613,false,10000,0
361d1e0a5d58ea636ec128357e90c0553bfa3cab8da8dac4e03d5dae61e9acc6,989110,2020-09-29 13:37:13 UTC,60239200,60236275,false,2925,0
941d8ecdfe0d9c4db2fc370d75d262d84a25aba7ed8bd19a3a7088e494b4bb13,989110,2020-09-29 13:37:13 UTC,2000836945,2000141045,false,695900,0
f0687b8fb31a43d5646733eaa8017d7a226cc7b3b2d0b10b5d6e36574c6555ef,989109,2020-09-29 13:34:18 UTC,3550386230,3550015150,false,371080,0
a4994e6e10ed86410d1b673757eca9179f9858891583553f104de6a66cf5b23e,989109,2020-09-29 13:34:18 UTC,190324973,190322013,false,2960,0
66a3edc6c3829a08e0054a9accb1b8362f3ad1ce181f523806fb82b870cbf11a,989109,2020-09-29 13:34:18 UTC,500014613,500004613,false,10000,0
e3031720ddaa9adfb9b6453162a5c35063fcbcbeb5d1eda7709e85640227fe05,989109,2020-09-29 13:34:18 UTC,76364518,76354518,false,10000,0
46ca2a944066ab104af57337ae07995eca484d0ea06645b85700b01824d5647f,989109,2020-09-29 13:34:18 UTC,100264358,100144582,false,119776,0
d483d337279a4b2cf5752eea31c9654da744d2290c9cfefbefb367834d65c7d1,989108,2020-09-29 13:32:28 UTC,21189497517,21189487517,false,10000,0
6fe30bab0d2ac84f0549315905f081261f31064035af4cd12d02b7f8e8a5f7ac,989108,2020-09-29 13:32:28 UTC,3202034381,3202032121,false,2260,0
607d659c6b286d6750607baed5d0d39d32fc3462dd9301a24c479a44bd8a18aa,989108,2020-09-29 13:32:28 UTC,642425941967,642425939874,false,2093,989096
4458562d31c566d34358aa4e43e070be3e6395b9721804d86b97230d9c281899,989107,2020-09-29 13:31:37 UTC,99069820,99066080,false,3740,0
466453f46b8b78430266e94e738517c63f78ab47cf09415ae02e8a3a5d7b453d,989106,2020-09-29 13:31:22 UTC,117552,107552,false,10000,0
cd0872916f9b88f4ece25cef6232191459104d99a2694fd0db6c5908bbd5d3fd,989105,2020-09-29 13:31:12 UTC,15486236,15481631,false,4605,989093
1101cf8c64d39bedb4c8a5933a465a63ec1b6265566d854b858931a5df44e534,989105,2020-09-29 13:31:12 UTC,160238531,160234958,false,3573,0
2c53854ac40b6273879b8300e1558b3c8b3d29de188e7271b05f4784e5cfb847,989105,2020-09-29 13:31:12 UTC,203061090,203048810,false,12280,0
af897edba8934719aac219f7734fb08f205fdd16b122b780983e215123f9a24c,989104,2020-09-29 13:30:19 UTC,603503546,603487966,false,15580,0
c8636007353894fdab3c071b5630249c14372ea7a1f79675232cf85baf838bbe,989104,2020-09-29 13:30:19 UTC,54015802,54000222,false,15580,0
db83725452a4e01e91431948f04f6336a421ee36ce19454766cf40f9d1fe9bf5,989104,2020-09-29 13:30:19 UTC,581756999,581741419,false,15580,0
d79a7a6926aee38d137ebc4357a3cac2f4920cadaab4cd2778efc7287b15f5f3,989104,2020-09-29 13:30:19 UTC,863807564,863791984,false,15580,0
138a60ccf844c1f12bd173df77b58e35295884a2941e831f54d1b59824ec1fb2,989104,2020-09-29 13:30:19 UTC,1987849357,1987833777,false,15580,0
40b8738034b2a765d35e1026b6dc03c2def565a367b3a4df300b03ef3ce5bb65,989104,2020-09-29 13:30:19 UTC,789568000,789562000,false,6000,0
feea7b5f9b31c49cecbf30e5121220d0b2c1298d7dec2e59889fb854cec8d3aa,989104,2020-09-29 13:30:19 UTC,595055812,595031642,false,24170,989093
54dd9882365a8f0b949a1468a56c86b2f8d0a9aa9c944f48d2e7569ab9842327,989104,2020-09-29 13:30:19 UTC,1228993211,1228977631,false,15580,0
241694c69c7beec183661687cbffb3b6aeaac1122f99a76da79449bda0e05b36,989104,2020-09-29 13:30:19 UTC,1056271046,1056255466,false,15580,0
6030930401231f696457d2988cb5d3eef47eb137569e89e82a88d793ab89be09,989104,2020-09-29 13:30:19 UTC,30320469,30304889,false,15580,0
f1fd982c52c3bb8275591709c6eb159e10a9f014e8f47a080e51c7a903b2ae52,989104,2020-09-29 13:30:19 UTC,304896897,304881317,false,15580,0
d38471199e001094016f9b415a64900d305916938ddab5348a26ca3082b18e23,989104,2020-09-29 13:30:19 UTC,1618762861,1618706522,false,56339,989093
d7fa8ce468c0dcd797d751814cf7294b0883eaca4d29b411f7f2bbd818512128,989104,2020-09-29 13:30:19 UTC,1876284461,1876268881,false,15580,0
765c10a66c0b018fe39183a9c703b3c268cca7af286491740a8ac57c24ae73b0,989104,2020-09-29 13:30:19 UTC,253236829,253211588,false,25241,0
53c5dd56f481c216ba6e5bf07d431ff53b3eed6cfedaad086609b1571ec8af33,989104,2020-09-29 13:30:19 UTC,1044579063,1044563483,false,15580,0
393e35bae20026ff6895934f953858cc885287aa53954fdb8a235b365f069d2f,989104,2020-09-29 13:30:19 UTC,824741248,824725668,false,15580,0
45f5b547244368a95456833b8550b46f837a1a73a2fe7fe78e4c1b34b98a782c,989104,2020-09-29 13:30:19 UTC,5368617285,5368601705,false,15580,0
a2e9a5952f76c01aad532f8c19fea1aad4fa14c3188b3ba7049fb1afe25d0fb5,989104,2020-09-29 13:30:19 UTC,620512573,620496993,false,15580,0
bfe5e9c6890949cc2fa5db73fde032e8d6504ae687bdd071fab08bbdf0e2760a,989104,2020-09-29 13:30:19 UTC,389155133,389139553,false,15580,0
b186a76147f640be4b6c7bf883dd52edd033af2eccc592ee63c711f151d03a37,989104,2020-09-29 13:30:19 UTC,7873420631,7873405051,false,15580,0
0670e35d5bd905f818869f29ed35303990602c1e8bdc0a931aba3766341365fc,989104,2020-09-29 13:30:19 UTC,2445085563,2445069983,false,15580,0
ef0fb6fd3b235748f80d9d71346ed05175d665a2ad1a9646a268068eb28b1c18,989104,2020-09-29 13:30:19 UTC,415750962,415735382,false,15580,0
528ba7dabf97fbb4ecd3bec299b42b9de0a4d23829b3333cf4aee19ccaa15709,989104,2020-09-29 13:30:19 UTC,1334424179,1334408599,false,15580,0
d8993959989dd494d36c49f480141d4b9393e9696354486f9021ec6772083e98,989104,2020-09-29 13:30:19 UTC,29405143,29389563,false,15580,0
4bf1b30056a96e62531bec8ea219a81843b764e4070ca784277eec3a52081adf,989104,2020-09-29 13:30:19 UTC,1234303978,1234288398,false,15580,0
49a8e601eff87ce217a133e829ce38232636b7389f22f99c90a62c955ac0fc9f,989104,2020-09-29 13:30:19 UTC,1497437389,1497421809,false,15580,0
765880a7db73b167eee74b63fc5557d335efb30b531bd2c56729b0b27c548099,989104,2020-09-29 13:30:19 UTC,217327039,217323772,false,3267,0
441ad8c315052776f35bb51fbc12e8f3cf3f363e3d90b735748a2cba819aa0a3,989104,2020-09-29 13:30:19 UTC,644321647060,644321644967,false,2093,989093
f2796a97f64ff4861be79a2c7a06f316d05837711c8c13e8a33ea026ee7fc952,989104,2020-09-29 13:30:19 UTC,449990000,449980000,false,10000,0
09bfc2a940ceb47eabc62b593b9a7207a051ddde483789934662757794e7a34d,989104,2020-09-29 13:30:19 UTC,308807427,308791847,false,15580,0
ddd1eb6cbf79630a3633ba309618d1920a5c84c68db17a9f2ecafd1d1000d39a,989104,2020-09-29 13:30:19 UTC,206312970,206203150,false,109820,0
499c31552c74119038633b000c82bb2a57a8ea6b2bdd10b093dc1ad9a489a9ce,989104,2020-09-29 13:30:19 UTC,81160,71160,false,10000,0
e7f351fdd87a086bcce486612ced259f9d1bedf607d645bbd3a0c56a36844b21,989104,2020-09-29 13:30:19 UTC,1713086475,1713070895,false,15580,0
91e6ca4c572f1a4ed804550cd7c48ee2de6ff0f03c91d5771a97d87eff3bca8d,989104,2020-09-29 13:30:19 UTC,21725553923,21725543923,false,10000,0
08b1148b767318b03dbf2a7c573321c48c607fcc1365b4fc8ce5efb1b281fc94,989104,2020-09-29 13:30:19 UTC,1212210320,1212194740,false,15580,0
570c527ba51a6517439a14efdc4d0e9ca74dbbeff2d51f178e34eb73ed617c3b,989104,2020-09-29 13:30:19 UTC,3868938182,3868922602,false,15580,0
b64de472ffaba981b441c4d8c83d6c0bb921a1a05b3ed69c5e2d7c3b670d69e7,989104,2020-09-29 13:30:19 UTC,773814218,773798638,false,15580,0
de797c98bd1ba41d8af6dd6bd8ae67c5cd4d0d3e82c2ea154f3dbeb38250c2d7,989104,2020-09-29 13:30:19 UTC,89080792950,89080790600,false,2350,0
69b73dc4e75c36f22b6f7684d7663219a3a8b14a83f6527a8e05451d45b2001c,989103,2020-09-29 13:25:22 UTC,76366100,76364518,false,1582,0
5488c4144b275c1b35998bc58e6421b24a386ad22580ad8b7e0c2cd7c0f655dc,989103,2020-09-29 13:25:22 UTC,2138957118,2138941538,false,15580,0
a23e1c5f5b8cc477c082ebdfd43a6aafde252529840882ede482504bc55ba21a,989103,2020-09-29 13:25:22 UTC,365820390,365804810,false,15580,0
4a0ee795ef4b20d6d6cb0faa834c3ef459e33a0dae597a559860255c3ee6d145,989101,2020-09-29 13:24:51 UTC,250,,false,250,0
d834fbdf9cbb29905734cb16688551d476b771f61a477d8bf44b08de2385224d,989100,2020-09-29 13:24:28 UTC,187184614,187178614,false,6000,0
5cdf4d6ea37da009640d9745c5a175cf9553e51e1e01062a8d7abbdc82f1e307,989100,2020-09-29 13:24:28 UTC,1010749330,1010680978,false,68352,0
2893f9ef434eecb01d254dff4cd4e031ad54fbbe3eb3f7073587117d1f75b47b,989100,2020-09-29 13:24:28 UTC,450000000,449990000,false,10000,0
ce3ec582c69b316558b5bc2f8dc5269a238a8d61ec518ef344430fcc6dcfef02,989100,2020-09-29 13:24:28 UTC,190737208,190732717,false,4491,0
434945e83c49f389dd22ccc8466693ba02f3d48ecd89a243f392ebe50b96d710,989100,2020-09-29 13:24:28 UTC,21225573923,21225563923,false,10000,0
4ecedd5bb068c7d2b3ed5a8606a0a880fa5c4584debe6d28387d2d30a916da94,989100,2020-09-29 13:24:28 UTC,2811436597,2811421017,false,15580,0
7721de28f9a4bac56c169ca951763eb8ffacbd0427fdffbcf8d3947a55f1c150,989100,2020-09-29 13:24:28 UTC,184306241,184296241,false,10000,0
5e717357fa56a3100a5546096fa9a60d99c7a40faeab9eb2cb8f2064c30f358b,989100,2020-09-29 13:24:28 UTC,1717252210,1717236630,false,15580,0
45354a200222f0f2e9d8163566f1b60196e052719928b8f2bcab2a336f066b37,989100,2020-09-29 13:24:28 UTC,239618700,239608700,false,10000,989088
a2e2e69b01e4df5fe8b70593afaefb15b0fbc572c7a8bb9fb86f3f567baf42a8,989100,2020-09-29 13:24:28 UTC,176532117,176529667,false,2450,0
8449d2e0e7b781c64f5bdcf5b8908866b9bfb3f7654cf5315d7461b110ddcac2,989100,2020-09-29 13:24:28 UTC,776628734,776613154,false,15580,0
8c131d7b98acd05105f39af72f67f3acaefd775a9fe4614104122908f134641c,989100,2020-09-29 13:24:28 UTC,700000000,699990000,false,10000,0
165e79f9ff5cedb4540eeec0d4352c9420d8f205548d9616ec68d43ed702a359,989100,2020-09-29 13:24:28 UTC,22019408,22013408,false,6000,0
477943811a876a0f9a766bba69ca2f0c006deb7bdcbe5828739c21d1c9286313,989100,2020-09-29 13:24:28 UTC,500000000,499990000,false,10000,0
5952169e83f5c962d47aed5bcbedd6f24ec15bd85f4460445d06243a403d59f2,989100,2020-09-29 13:24:28 UTC,257291200,257281200,false,10000,0
6cb58a2ce0703069a5f9455b1274fe6df63ff905f3cd8b6ac7f8c54fb4aad4d7,989100,2020-09-29 13:24:28 UTC,1457241749,1457226169,false,15580,0
942c6dec3bb2ddf6b6eb8b6327e44de520d02e80ada7de1fe918e60d094b93d5,989100,2020-09-29 13:24:28 UTC,98531958,98516378,false,15580,0
49cd8687382a4ba067a5890a2d7bfad340cdb0ec33adf67d17ebdb8dae91dff3,989100,2020-09-29 13:24:28 UTC,1984020421,1984004841,false,15580,0
024489defc01668622bd3ec6491ffe7ab51c45f2be1b6883ea02fa0ec36581bc,989099,2020-09-29 13:20:23 UTC,500010000,500000000,false,10000,0
39e1b7c8d5929aca25e4e937dbc531f94a9ebc54bb1c024ead00814f9bafff65,989099,2020-09-29 13:20:23 UTC,217539973,217537013,false,2960,0
cedbaaa9b53a20dd0e23969312778003d0cb756840593c93348560846c3f99e6,989099,2020-09-29 13:20:23 UTC,1000165421,1000155421,false,10000,0
f201872a021bc5b8f829f98f316ee22eddda28d7260635105a5c1c9923490856,989099,2020-09-29 13:20:23 UTC,687990019,687987759,false,2260,0
78708199a988329495a91974829970c0a5a673297488a28a7655919942375619,989099,2020-09-29 13:20:23 UTC,14255,10463,false,3792,0
c843ca67653d83fabbc92cec2833bfd3c0a59f03b47210d3995e0a880bac97db,989099,2020-09-29 13:20:23 UTC,595648408,595624562,false,23846,989088
14299ff9e43375381fad0e6187a9e293fb240d40a74ae534a8d71ad567afef49,989099,2020-09-29 13:20:23 UTC,1620073330,1620003278,false,70052,989088
76c4c7adcb32882d1bd7069e9ea1ca8edb110b25db0e8eec16145d1f8fabec03,989099,2020-09-29 13:20:23 UTC,5044267,5039593,false,4674,0
114988db81c74743b507ba1260fe59701272c5bf5669ea3e85aaa6a29c736898,989099,2020-09-29 13:20:23 UTC,644358784853,644358782760,false,2093,989088
e2a5d338b1fba79f36e114b4e2131ec72901dfdf83650fb16b5ccbd100496634,989099,2020-09-29 13:20:23 UTC,160447880,160444613,false,3267,0
bb50aee9e4353536dcfdc513ebe9c48035f18ba1dbec1cd6e4a9a2c2c93e5bcc,989098,2020-09-29 13:16:51 UTC,499997525,499987525,false,10000,0
7677c4e64fca858ccad33660d3e5a3e488143416019e63f9bac00d1b587d98e8,989098,2020-09-29 13:16:51 UTC,424390090,424387997,false,2093,989087
a0dee3bbcca8318e1a23216acebbde736cf24537c0befad99ab202ec0ce7866a,989097,2020-09-29 13:16:22 UTC,190971036,190967463,false,3573,0
28fc09d0da4ba86bfde9d46a31a21f1dedb78e05205f1c005b5df1401b505016,989096,2020-09-29 13:16:01 UTC,113437332,113421752,false,15580,0
c2fceacc36edd11071e5422b7a906dce6e6cf0b7399ba6cb4012ce1d33c41ffd,989096,2020-09-29 13:16:01 UTC,1595641081,1595640081,false,1000,0
3707ea1476a082d3b163c7d340c4f4c4e0b4dac52def619e35b90142d2680316,989096,2020-09-29 13:16:01 UTC,500191681,500181681,false,10000,0
eeb521de68e39a42c5882091547ce5651be98c70e03d42c425c41b523c356ba7,989095,2020-09-29 13:15:21 UTC,122350961,122335381,false,15580,0
3f7754058d69bd473071eca3cd69e284262ff0669bb43ca32ce2969319e4aa12,989095,2020-09-29 13:15:21 UTC,128004096,127988516,false,15580,0
075b7edc2f5cfd6fa32d31de619a613567c31532e83e0ce35ce1e6cea33928ea,989095,2020-09-29 13:15:21 UTC,1163315020,1163305020,false,10000,0
e249482306d193c37ab3cebf42f6917e4aaa694b56d309b85079a43330a401ca,989095,2020-09-29 13:15:21 UTC,11069,1069,false,10000,0
1e791dc002acf4e41eb9ec55115683e972fd839b2f99ab2886e79d7f5eafd57d,989095,2020-09-29 13:15:21 UTC,117393758,117378178,false,15580,0
cb4ba017b8451e301f9d54d36698c86454eca14115f41a4a318532ada48a4466,989095,2020-09-29 13:15:21 UTC,786299009,786289009,false,10000,0
e020da8bc47e57a8695f01f7c1bcc49be251a16ec80aa65c206a0f7e0294cf77,989095,2020-09-29 13:15:21 UTC,212297896,212287896,false,10000,0
e5b775ecbe84335c46e49c1dfb6baacc2258e52fa5da1bd8ac456084e6bd27fd,989095,2020-09-29 13:15:21 UTC,250,,false,250,0
e9fdd48f66019b7c926b9d172784c03c30a08ff13a3c284335676937eaa7de7d,989095,2020-09-29 13:15:21 UTC,136840648,136825068,false,15580,0
36dc5b0750b187e96d7921655e60b59da358c48eb1d2d03d054af17d44190a5f,989095,2020-09-29 13:15:21 UTC,155857102,155841522,false,15580,0
a6dfbed628eb995d1a54d92541c17f64114c4e26c91b0c61b171946dc0b6cd9f,989094,2020-09-29 13:14:26 UTC,96574401294,96574385714,false,15580,0
5d41635b9087b571c059163a4b806619832cf826cc70baf00fadb9e40d9886f5,989094,2020-09-29 13:14:26 UTC,644360286946,644360284853,false,2093,989083
ebe5cfd89b82343f6e70f57f8b43531704af1b170cbac7d52142aa21bbab036e,989094,2020-09-29 13:14:26 UTC,562336289,562320709,false,15580,0
2ec6f83aa6ca7a6fa94fa18dd0a02a9837bfc4c19c5e6fc759247a76e40fec17,989094,2020-09-29 13:14:26 UTC,236507195,236491615,false,15580,0
3d3731370070d2dda5231599c83c4d49df53856866d9d1cf6f0e344e91daf5e4,989094,2020-09-29 13:14:26 UTC,257301200,257291200,false,10000,0
abb56ab8353fc489c909ab4e139cfa93ffbc2311bc3404b21a7238a43576fceb,989094,2020-09-29 13:14:26 UTC,4033710,4030353,false,3357,989083
a35cf00b2a55884351934414d6a1f6955d80c882c7bbcb9158c1c66b8a762c34,989094,2020-09-29 13:14:26 UTC,408472565,408456985,false,15580,0
f71c4758b748d7bffa1b43ecf82962e8e77165bb29ecf22b2d637e58f0921e9e,989094,2020-09-29 13:14:26 UTC,372576887,372561307,false,15580,0
137a7b03562fd453a8ab4ef83ee2559936f1c6e2adb78e88a129a001674574c0,989094,2020-09-29 13:14:26 UTC,196887445,196871865,false,15580,0
f7710676427a6b216fd10909dbd81d018751ebdad284af1f801da51be29d33bc,989094,2020-09-29 13:14:26 UTC,335690339,335674759,false,15580,0
d04897377edfa6428ed08f8bca60d88eb76a3cbf4a34e56c2c2ac96a220cdb81,989094,2020-09-29 13:14:26 UTC,1055756176,1055740596,false,15580,0
f0677b5c59af2be202e5f75484bbb9f80f14cc57a357e9ab2f62406d28707f76,989094,2020-09-29 13:14:26 UTC,1559666552,1559650972,false,15580,0
239ddb4aeb7c2068f9de9d826e4bcbff43083d946316b5cf630d5506ae907245,989094,2020-09-29 13:14:26 UTC,1375118218,1375102638,false,15580,0
a0127738c51804f56aa818c7e055006cd968fcac2508eb9785dcc553937814a1,989094,2020-09-29 13:14:26 UTC,40970000,40968080,false,1920,0
b80c3527d5b7de054dd61c3764196b05cbcd99bfd255034eddefc06d14b306c9,989094,2020-09-29 13:14:26 UTC,511042043,511026463,false,15580,0
8b90366cd78ab1bd213e26f70a82e9cf542ab592dd6fec2451932795d970de5e,989094,2020-09-29 13:14:26 UTC,456951233,456935653,false,15580,0
7773d4a022a51daba6a450dec24fc1cb6849e4f123d327357b4b0c87365ad1a5,989094,2020-09-29 13:14:26 UTC,178875901,178860321,false,15580,0
670d4bb14ffa3ba7a004a48d5963b9def3d7711d0cbeabe17557e10a0af19c82,989094,2020-09-29 13:14:26 UTC,499993740,499983740,false,10000,0
5810e3e2751d019cdaeb326cde3a18ca31f4bb268c2cef9fcf28ddc3703e55a0,989094,2020-09-29 13:14:26 UTC,596332130,596310864,false,21266,989083
c11323706e47a88d8eee02bd6ac265b25e36895fb68a2e0e43d8c2e79117b5e3,989094,2020-09-29 13:14:26 UTC,9674196565,9674180985,false,15580,0
e2a996e5c26e1959f5d577019d511e6ad440972fcf17d9aad9e949248c60a34c,989094,2020-09-29 13:14:26 UTC,1170827848,1170812268,false,15580,0
2f32d7d18c58840c3674f2a3300d5df1020a88346be8619021189659bb013dc7,989094,2020-09-29 13:14:26 UTC,254695292,254679712,false,15580,0
a0db50b18a730a205d89226f9e29910f5528abca9b3881eb438baee974565bcb,989094,2020-09-29 13:14:26 UTC,4919886413,4919870833,false,15580,0
fbb3f1020f57ac86b81e207b4d42b19701d41e5119542900687f54f664602385,989094,2020-09-29 13:14:26 UTC,63607563,63599019,false,8544,0
0582bba32d30c8f20da08d72f84aeb1652026e846ee376168478bd12fbba611a,989094,2020-09-29 13:14:26 UTC,221594067,221578487,false,15580,0
3d0fc8692cef7c4c9ef10dac859c9b6c5725d331f8fdeaf2468f71e85c32561c,989094,2020-09-29 13:14:26 UTC,1625187741,1625133957,false,53784,989083
8a20f43a72c3700e654b3efc5b3094fb44a82520e11abb8dd455ebfef3540be7,989094,2020-09-29 13:14:26 UTC,217821588,217817709,false,3879,0
59acb7a31419c2f61db666be4c8ab3a2e54c65730ad372c0f63d8c1187c4309d,989094,2020-09-29 13:14:26 UTC,610988597,610973017,false,15580,0
75341fae8422dfea9eba3817d4321e4e8b214c7166deb1a5a73efb799f4a1448,989094,2020-09-29 13:14:26 UTC,160752418,160748845,false,3573,0
2cf7f00dca3f1820398b0ef2323c5fdf02ef0692e448c58048e4f01a59768416,989094,2020-09-29 13:14:26 UTC,955234653,955219073,false,15580,0
4158f9318fc003bc78e8e8bc20cf913c934c75cda375d86f22c8ebcd45c75f0b,989094,2020-09-29 13:14:26 UTC,844417999,844402419,false,15580,0
c1dc420b86e8dda91f86b0b80777fde5b132cfc4a9961b3e3ccd588473f82a0c,989094,2020-09-29 13:14:26 UTC,703639800,703624220,false,15580,0
177af270338031b72448704f2f992c93d669326bba8d111a1c3db7f762101510,989094,2020-09-29 13:14:26 UTC,168008017,167992437,false,15580,0
790e590e1908905ed536389ac00388a8bb7752c21cd882cfb6c78a29e952efad,989094,2020-09-29 13:14:26 UTC,1857752768,1857737188,false,15580,0
c1a527e20f4f2157f80903495eadda02fd9598697b2456e12edf8176fa59eb76,989094,2020-09-29 13:14:26 UTC,2411726726,2411711146,false,15580,0
54ba2dedf306ba049abb0ccf70eac1d8b6d64c1dd9b0d8c5a58ddd2fc7f2b1bc,989094,2020-09-29 13:14:26 UTC,500201681,500191681,false,10000,0
a3e1ac63f0da53959bc5f3af0717f7cb1085bd330b74514affe59af25a3d3a36,989094,2020-09-29 13:14:26 UTC,299478307,299462727,false,15580,0
bfe5c43fd587de4bf16241e0ab0322bad260a6219d27cb89acc64ef8ac46591b,989094,2020-09-29 13:14:26 UTC,3251367746,3251352166,false,15580,0
ec6bf86b9b647d3d42d07e48d5853a5147d9f78986b9e97feb66ae3d83a2cd18,989092,2020-09-29 13:09:27 UTC,500003740,499993740,false,10000,0
8c6f588d1fc7a36a17e4e76eec1aedb61cb2804c24de3fc8d5c832b7509df82d,989089,2020-09-29 13:08:46 UTC,20912440794,20912430794,false,10000,0
e47a0198f55510451fba481ed21d0c688b3ef5c31becfd669195846bcd0c10e3,989088,2020-09-29 13:06:43 UTC,767522,765602,false,1920,0
eb196fb75c92bd0e7c8689cbe597f47be1752226c2ee1b0918b1d9b312868875,989088,2020-09-29 13:06:43 UTC,500010770,500000770,false,10000,0
f8a72c29708747c01b8188b8d57aeb2074c11cb763f800abd8b96a6adf6db097,989088,2020-09-29 13:06:43 UTC,500000000,499990000,false,10000,0
ea5a9e1dcab247cfa0d12af1c244028054fa73be50a1eb08836490f8c8039f93,989087,2020-09-29 13:05:40 UTC,644844532503,644844530410,false,2093,989076
70e6c773005585c02d1da96ec230623d9c7b426ffa45da667e250c471a5de69f,989087,2020-09-29 13:05:40 UTC,1000000000,999990000,false,10000,0
9b721f2ffb7a355c31d2260ec0e57ff91686ea88df89d38139527cd5c4f0c82c,989087,2020-09-29 13:05:40 UTC,3025764223,3025754223,false,10000,0
ef47cd9ab446c3426e549f0d18abab7eea1e4a63a6511ef6579ceca8e85a15b7,989087,2020-09-29 13:05:40 UTC,2545006740,2544982740,false,24000,0
ccde0c19d443e56290bba71da8d15380930195de42356080903f00a4acb5944c,989087,2020-09-29 13:05:40 UTC,191133050,191130090,false,2960,0
3ebec7b91590afcf619fce59c56123e86b9e52dd6f6fbd230bd9637c2473ed4a,989087,2020-09-29 13:05:40 UTC,500011514,500001514,false,10000,0
51ca5272a43c55cf1bfa5d66831b31469eb6f1cd320803e0dd9be888ddbab07c,989087,2020-09-29 13:05:40 UTC,257311200,257301200,false,10000,0
479c3ea51ac078a16f56cef02323585337fd46f630547437eaeabbd354b4f8e8,989087,2020-09-29 13:05:40 UTC,50754451,50752001,false,2450,0
0a4a79be6335700b2853ba61ace881fc4bf1bbc350b05d0a36819ce28fbbb9b2,989087,2020-09-29 13:05:40 UTC,339082434,339081434,false,1000,0
e906b64fe05e7f94a97db32e5792e50c48e306c934e5e649527bd394d836fc95,989087,2020-09-29 13:05:40 UTC,1039574000,1039568000,false,6000,0
2db140fdef4dc5ffbf8781702346a5222c822cc574bb2b0488332a1739c82d0f,989087,2020-09-29 13:05:40 UTC,500020770,500010770,false,10000,0
ca2ff4058dac53d5766c0c58b5fda3e441e199f73132e7756ce18f14db0fabba,989087,2020-09-29 13:05:40 UTC,424122856,424054504,false,68352,0
1a250d717ccdd1856d8ebe2387e9edaa01720a5371f9a09db46d3b37c14ba7af,989087,2020-09-29 13:05:40 UTC,218173493,218169920,false,3573,0
7d5bb3d84e6e1c6844078ab89b234afd6a537edc800ff90b97dc91a6a69db611,989087,2020-09-29 13:05:40 UTC,452945037,452942944,false,2093,989076
c34cdbcbee55e69046cbc0cd9c51bc5824b6f6e964653dfb4603a2e42b0805d7,989087,2020-09-29 13:05:40 UTC,100000,99750,false,250,0
cca474e34e258831d022f6aae03e892c63c9c562fc18563916a2c0aefb43d11c,989087,2020-09-29 13:05:40 UTC,500007525,499997525,false,10000,0
bfe5eed4a461c0ec95c2c147ad70c8538db43b45427b8bcfd2ea645917c3950a,989087,2020-09-29 13:05:40 UTC,1667877166,1667875073,false,2093,989066
83723cce9f022818238a3cb78b39019cd794c83f92b4073c79e35cd14fba2d11,989087,2020-09-29 13:05:40 UTC,246028675766,246028665766,false,10000,0
4c82be0fb9b6f88d4ed15f7dd698dac77081f99f8a024ae68d5aa68d5ffedc5a,989087,2020-09-29 13:05:40 UTC,1000174188,1000164188,false,10000,0
55dac3e7287ab19832d4ad62aef5c2d7b07415d6c4b1de011ed29a5e4e3b2b5a,989087,2020-09-29 13:05:40 UTC,35016,30136,false,4880,0
c8a1e68c70de72427e5de4fc17cb02823193ccc3072b8c3dc637c69828cae2e3,989086,2020-09-29 13:01:48 UTC,250,,false,250,0
c05a61ab32046eed7803661f30852e9ddaa35ba760c8c1ad19a2817521db7b72,989085,2020-09-29 13:01:25 UTC,1712360341,1712357667,false,2674,989074
d182a19008d3363377c195177d5aaa35ce93a8d51168972aac3466125d4a043f,989085,2020-09-29 13:01:25 UTC,160982029,160978456,false,3573,0
135507ce11d0295cae5a6c7fc56b126090e0f8e1dca255ddc547a0ad4b83680b,989084,2020-09-29 13:00:25 UTC,15370,13580,false,1790,0
84be3feee0d7675e488fd340f38153af74c9e17a7be0a6618a0aa4badab8a005,989084,2020-09-29 13:00:25 UTC,54470,37750,false,16720,0
a5789dbc82153e37cd386e64c0a75bdca8b0912c6f325f6af0718bc892a060d7,989084,2020-09-29 13:00:25 UTC,1877121589,1877118625,false,2964,989073
a4c4cb6cac3c8db65e2a127226be72b1cc98487139f9195654cdf42df392b7e4,989084,2020-09-29 13:00:25 UTC,1626415117,1626356138,false,58979,989073
d1d377d4474d785e82920dfa1d4237cc2d58a0c6c3a245b7544d48e89324032f,989084,2020-09-29 13:00:25 UTC,142096192,142035983,false,60209,0
369d3a5fcbe3ec2c0a9064a011236676917d76c9e558320ef3b7dfa415f5a1ac,989084,2020-09-29 13:00:25 UTC,596969625,596948958,false,20667,989073
4bcd5277a249d484c26674fd61256184b04c417aa8f9db694350e2a7b3774055,989084,2020-09-29 13:00:25 UTC,100010000,100000000,false,10000,0
b1d7815b50d24acf3d83a42152576c771e820a42c5715e695f4dd486cebb42e2,989083,2020-09-29 12:59:37 UTC,398196554,398192231,false,4323,989049
da9dc0ff647b1a0efeeef12c15e1ebcaa61d51c495e80f4d7558762b350393cc,989083,2020-09-29 12:59:37 UTC,358133472,358131717,false,1755,0
9facbb1c7a3808c44f1e52a1fd479a08b16a72be52f2c40c8f35f4bc2e467e45,989082,2020-09-29 12:57:48 UTC,111897473,111884393,false,13080,0
6fd87def503cf07a42537c85bac6a72186ee52af20ebbe56cc5261b7a08ac75c,989081,2020-09-29 12:57:28 UTC,3025774223,3025764223,false,10000,0
1e0867472d542be2719326c18cec2d14d077819b59278f80c2def96b8ecda5ef,989081,2020-09-29 12:57:28 UTC,562175829,562170949,false,4880,0
d9bd03148638ab502af7a22e07a699df165834e30d626fb7ef57a5a9946cf434,989081,2020-09-29 12:57:28 UTC,499990040,499980040,false,10000,0
2c2a8513f60b5eb43f8e017be0df6ec305e37d2e7da7cc72de98a80882011a97,989081,2020-09-29 12:57:28 UTC,110000,100000,false,10000,0
63f85e32393a46d84c46ea8dc3cc1b6e327fd2e70c5685bed22064635b893b5f,989081,2020-09-29 12:57:28 UTC,653638684,653623104,false,15580,0
cd90400c86a35420e9e1009f3e018cb1b17b4a2ac6a351af156b97e9e1b14038,989081,2020-09-29 12:57:28 UTC,7500010000,7500000000,false,10000,0
d813b93bf81a94b00c03acba3205bbd4bb8a6f4374179712194addff34aea68e,989081,2020-09-29 12:57:28 UTC,7213355845,7213340265,false,15580,0
1ebbb276fb51c75b3ee0a4fe6be47c93936d849e1cd719ea1034f2fa4019893c,989079,2020-09-29 12:55:06 UTC,191520051,191516478,false,3573,0
f539621a1a0745ae078565826bfa38774efb68a16821e7503a911be0aea1cbce,989077,2020-09-29 12:54:08 UTC,5736898,5734514,false,2384,989066
2645fb3052a868f66924ed102682dc471ab81196589393fbf2f7dcbea0430e78,989077,2020-09-29 12:54:08 UTC,61367698,61357698,false,10000,0
d79ae21b52fa6aef5273e898b5f6e3af96804e9a51d1e78e0ce5b5d37512d1ee,989077,2020-09-29 12:54:08 UTC,645178212178,645178209803,false,2375,989066
7bfb148358ee8e1bf906526965796060c136482afd87d1ebcb244b052446824a,989077,2020-09-29 12:54:08 UTC,1627934186,1627861349,false,72837,989066
2906a1ee5e7bfdc3c038b8b7a16c91d1ae2a4fd0566a6aa210c3af0fb83a72d4,989077,2020-09-29 12:54:08 UTC,597664406,597641107,false,23299,989015
1b5e684f6d13ec44b0497b54783cadb536529571074ffb96be9b2d1628b52379,989077,2020-09-29 12:54:08 UTC,1307000,1301131,false,5869,989013
7a96bddd7ab6095f284fc556bc738b97aa3b20853dbabdc0a944b02774cd5d6c,989077,2020-09-29 12:54:08 UTC,132018,118258,false,13760,0
7cdcc3befad6b1651be9422aad1fea3768e0298cd3a79a7aaad71d7e230f0231,989077,2020-09-29 12:54:08 UTC,69768233,69758233,false,10000,0
8942c8ae6a75897b8c8102d8c093b7e0519cd511f932cfbe0e8b15d6149b1b9c,989077,2020-09-29 12:54:08 UTC,161415642,161410845,false,4797,0
2189cfc5055ff73f0f638ef9177d5f7d2e92861f7eb746e882ec557f0f8f3d80,989077,2020-09-29 12:54:08 UTC,218617842,218613963,false,3879,0
b1f9f73a8b243f0f382d229befeeedffdf5fc766512c37f37be9abe2e721f0b0,989077,2020-09-29 12:54:08 UTC,91528763,91527008,false,1755,0
e0903858a03b0cd44ef91a8a5c9077c4ef45493273886de9588ae7f4abba518e,989077,2020-09-29 12:54:08 UTC,500021514,500011514,false,10000,0
eb98445e0077f1eef47218947ddd4ec91c3d7ec3bd7d9de3235b07547204874e,989076,2020-09-29 12:47:47 UTC,735127044,735124784,false,2260,0
d5dd8ae5f8adc49977de7d0f7ca9fd8fc89b9bbf5a6b6fee49d09c91750a35d9,989075,2020-09-29 12:46:59 UTC,500031514,500021514,false,10000,0
87e58de47eeda8faeeafd0d1c531ed60cb387bb5ce21c35a602e00bf90f48751,989075,2020-09-29 12:46:59 UTC,870677682,870609330,false,68352,0
4e007b2702ca9ae96ce0335b9b3377f9b8eb00db04f003bdad535a48e82c83fa,989075,2020-09-29 12:46:59 UTC,445017935,445016935,false,1000,0
3709474567fcf297521eb92b37e8528b1344d8a9f11cc843f7e98620089bc7a2,989075,2020-09-29 12:46:59 UTC,603010630,603009484,false,1146,0
1b4863b4b4a8a1f6f240faa992979b651ef5a54679f870fda79b588ebe804e62,989075,2020-09-29 12:46:59 UTC,191818032,191814153,false,3879,0
d30332458878dd24f2443447c79663e34b81c9577ede7c18148faffb564eddcb,989073,2020-09-29 12:45:56 UTC,4978279048,4978269048,false,10000,0
568698dec63096a9516c966d0963721f38bccfead61cc38f15e8e962e7b31667,989073,2020-09-29 12:45:56 UTC,684845250,684833165,false,12085,0
a0f3bfd0c7768de5fd49da9fb053f11a393fcac0cb75fb31bd5a7b784f2b4a86,989071,2020-09-29 12:42:16 UTC,67124939,67114939,false,10000,0
cb08731d40866b1939492b9838b1d8e713701a8e30dc7737d12d8eecf3ed5bbb,989071,2020-09-29 12:42:16 UTC,799990000,799980000,false,10000,0
62318e7868c3095a707b6cd8900a6e1bed60e8ec55bc038da88d3e0af9ff8023,989071,2020-09-29 12:42:16 UTC,218909841,218906881,false,2960,0
8721e7d119aed971d49376b571f3e9aae7baebc9446913c95cf3947cfd740aff,989071,2020-09-29 12:42:16 UTC,598427732,598401836,false,25896,989060
11e2491da135879eff638307f09a95ad7778e35b63454501bb55cb2e2330eb20,989071,2020-09-29 12:42:16 UTC,1629983559,1629909218,false,74341,989060
84cd7aa2e9afc78b6f27c08a9bcd5ccbb79018f016f7f4854a64691860af3d08,989071,2020-09-29 12:42:16 UTC,646341529291,646341527198,false,2093,989060
2faab6a85b3ad01cb3747ec60cce387e3b6ea7993468e9a2747ad42e0ea78307,989071,2020-09-29 12:42:16 UTC,8960,7040,false,1920,0
718d8514c527e06978ae0daf5000bd155bae3bae0ed7c9e5cc9c8d2109d97da5,989070,2020-09-29 12:39:27 UTC,63866882,63858338,false,8544,0
ef78f63a7ac08eedc53e10301089c0c783a3365c7e9022ae5b527035c37026d9,989070,2020-09-29 12:39:27 UTC,1000087361,1000077361,false,10000,0
5d70ffd4020c66fb2f9b0b8a16e043cb1e96e05ca33d95455929e4e7007b7711,989069,2020-09-29 12:37:18 UTC,34650,29976,false,4674,0
66ac542af14c105be85cd8e78d4a2c83bab694057bb40f34568fea89cf52498d,989069,2020-09-29 12:37:18 UTC,161570920,161567960,false,2960,0
fe25fb5d9b8d524d2ba032d5a7d464568e6615591377b22211c56350f685be62,989069,2020-09-29 12:37:18 UTC,477238366,477236273,false,2093,989058
01bf986c8ced28cde3c6ff5192df9e16aaa70ee6e6305dc13e1531f5ece19db9,989069,2020-09-29 12:37:18 UTC,64062625,64054081,false,8544,0
614816e70036f04a09bac86fe5199edf86caa2e7091d8ac79317ba0b28c0699e,989069,2020-09-29 12:37:18 UTC,192770654,192767694,false,2960,0
3509ed4915f76518ea0a8d4fcc2fa6c87afd3cdbabd17afda62806b9cb29efbb,989069,2020-09-29 12:37:18 UTC,20162,14162,false,6000,0
5468aa7ee1ae251d16bc72d80cd8e1d510fc1d56235a139fd3c92cd61d3d24d7,989069,2020-09-29 12:37:18 UTC,5195684784,5195680120,false,4664,0
1e2db8a743f0e81ccafa42879f3bb966dccd79879519347fc7fc2967779d8ca1,989069,2020-09-29 12:37:18 UTC,120939453,120939261,false,192,0
acf025207017d157f71bbae83684bd399860f607db1b550eeb47a5181d240884,989069,2020-09-29 12:37:18 UTC,439600000,439594000,false,6000,0
6ac95b728463f6dd3c04218b085cdbacb22438dad7cdf7ef499350fcf25cadf9,989069,2020-09-29 12:37:18 UTC,10000,,false,10000,0
2480ac688b65a6c41ef8d9bf3db0628f87ce5d6e01678a18804c8a789c77d482,989069,2020-09-29 12:37:18 UTC,3517522845,3517512845,false,10000,0
e96247f37618f4d2dcc8f6c67080db110749cc8e6198587261c7890d56e7ab7a,989069,2020-09-29 12:37:18 UTC,648544429384,648544427291,false,2093,989058
cdfd3cc9d35f81f9b22244260c947916e434e10af813479d7f6b133e6751436b,989068,2020-09-29 12:30:42 UTC,8158283000,8158279260,false,3740,0
bcb0f2fff82288acbc6be02c3da2cf73f11cdc3daf52d88f5fa0eec111203688,989068,2020-09-29 12:30:42 UTC,26627991,26624641,false,3350,989056
b409476cb4f8045fe74aa46223b0777cf8decb3886b30218d5b4aefb8e7570b6,989067,2020-09-29 12:30:20 UTC,1631262970,1631200505,false,62465,989056
ce4cb45af303cc7f1591961e690e608a680d94db9427c081dc187445bab26d26,989067,2020-09-29 12:30:20 UTC,219149913,219146953,false,2960,0
082819a5cfc74634b35230a394a6fdcc1f8626851f8f855ddaaf085a277a1aa9,989067,2020-09-29 12:30:20 UTC,598913477,598892211,false,21266,989056
38e8d96e83206dbf38439b444b289613b9dedc2123483e1a673a18a055a4e135,989067,2020-09-29 12:30:20 UTC,192984115,192980848,false,3267,0
d4ec6438d9555c0fa54380a6bff279f532fbf1b864f69f3651722b67b4847ea8,989065,2020-09-29 12:29:29 UTC,1200000000,1199990000,false,10000,0
c88fb346e3c5bd3cfbf7ea1930682e33df3dcfe294867f875d46ba1527198461,989065,2020-09-29 12:29:29 UTC,6413,4713,false,1700,0
2af75846d6502233933ad4d387e16da58411ce5557722e848d4d81b55ad3660a,989065,2020-09-29 12:29:29 UTC,419990000,419980000,false,10000,0
18839c2ff1edfc06a755d7f2c199f15323ace06a40d7eb559d23170d8646db19,989065,2020-09-29 12:29:29 UTC,116780,91180,false,25600,0
f5e725f2c9914047b5366effa65959dbc765233a80844c1175b7f1c2ff3c1f5a,989064,2020-09-29 12:28:05 UTC,152864079199,152864063619,false,15580,0
470cc63541e5e1837dbec192b942da1f6c69c1037d12c93eae5464f6fdbd10e0,989063,2020-09-29 12:27:03 UTC,1200010000,1200000000,false,10000,0
ee9bacd079a5f0566744ccfc8a54055aba35ec03ea08b82c0f50e48ea990ec5d,989063,2020-09-29 12:27:03 UTC,284051208,283982856,false,68352,0
15335fd274c46996de417157b08a94f68816d04df1fb9748f369f88bfccf1ff0,989061,2020-09-29 12:24:58 UTC,420000000,419990000,false,10000,0
a31b028ea3e32b7fcd7c76cbaf57d05613729c5fc5cb3f0dedf34f7764241b74,989061,2020-09-29 12:24:58 UTC,1058759645,1058659645,false,100000,0
70e1a8b8677bd11ef3d0eeca902ac97507bb13943522be72a71845933b339e26,989059,2020-09-29 12:23:22 UTC,1009625,1005012,false,4613,989048
0282fe57de24328731717e39f10c6d39f6306fb285fe5f467514794079ed6236,989059,2020-09-29 12:23:22 UTC,161755764,161752497,false,3267,0
fba66dcfe9cbd58952274d7a0f0cce7e9cab3148779117d6d5c3492d01313b5f,989059,2020-09-29 12:23:22 UTC,474439,464439,false,10000,0
a00879cf860d65991247af23c758ce2dfebf5d75e8dc0bb6bf7da0a80d0ccaa9,989058,2020-09-29 12:22:17 UTC,99978500000,99978497650,false,2350,0
08f08d7238b57f321e39ab44873e631eef92dba6ec72dfe12180cf5ea0e80fc6,989057,2020-09-29 12:21:35 UTC,250,,false,250,0
1c990f1b5e8afac5217099a38ef8470e9d718b29bfbdf06b658ccd4018ed5698,989057,2020-09-29 12:21:35 UTC,29860527,29832238,false,28289,989025
aa9f3b231de5f930ac0be677aa5ec7fd7443bad78527ff308f3339e16550f497,989053,2020-09-29 12:20:40 UTC,10000000,9999774,false,226,0
09b888a35e402c21f5c3f8f00a5526e45705181b737d2a258ef1ac4461bbe18a,989053,2020-09-29 12:20:40 UTC,10008096,10005646,false,2450,0
f3d7e09faf24892ed9118442c15854eaeb247170e9f6177d28d388bcf7553138,989053,2020-09-29 12:20:40 UTC,169990000,169980000,false,10000,0
46cb419307f992a67ff809a9d7a026267edc1876b2cb3638a2e8104fe7b14c77,989053,2020-09-29 12:20:40 UTC,1632459872,1632399116,false,60756,989042
5ca64cbd64bd530787afa6d55f66edf280ee8b16c6e95c6e923002eaf63c9b2a,989053,2020-09-29 12:20:40 UTC,599411672,599387527,false,24145,989042
3d1d7396acb8cbb98f60c358748753daea5b5ee9403aafdeee18c4e233d555fa,989051,2020-09-29 12:19:01 UTC,64109413,64100869,false,8544,0
6f3538028c9951b5e83c1d88f43ac4f7c7a89187b50222c9a7d4af1a1c176f3a,989050,2020-09-29 12:18:42 UTC,349970000,349960000,false,10000,0
7ca04b70c84b7f1ee4ef116a143d7922439f5370a7125b6640cf6eb1b798657b,989049,2020-09-29 12:18:10 UTC,193210051,193206478,false,3573,0
b17e3b4de719a4be8084c440311bbbf6edd0cda7b337a50939726fb6b007bec6,989048,2020-09-29 12:15:39 UTC,21544200,21543054,false,1146,0
fd588c689e21393399d3ed41924083b81a303b0af6a39fa11349b347ec980295,989048,2020-09-29 12:15:39 UTC,4785500,4775500,false,10000,0
698e1e6413574bc2ca6d4ffac6cf9e6abdb1277a27f5c5a20fe1a5a3dab0da15,989048,2020-09-29 12:15:39 UTC,10000,,false,10000,0
3dec169b22bd86cda32fbaa27def933e001c7eb547ea06af3fe1ab63e06a7f8d,989048,2020-09-29 12:15:39 UTC,170000000,169990000,false,10000,0
8120df7f2c66e885c2bd54509e9ef1930eafe5e8ef70e2cd3e79fd0358a4114c,989047,2020-09-29 12:11:53 UTC,375628253,375618253,false,10000,0
028a2b12cb527883f7bc78ecc74e7e625e66f87cf9811d050bad5e50443d0a2e,989047,2020-09-29 12:11:53 UTC,158652827,158650377,false,2450,0
264d0ca21debd148836bbe542c43a7c717c2997ff22f3cd70dfecc91bb0f8322,989047,2020-09-29 12:11:53 UTC,250,,false,250,0
52fefaaabc811d560c15b4394f627d7ea84bae3c21fa986d5228db6641977889,989047,2020-09-29 12:11:53 UTC,1681712471,1681710378,false,2093,989006
75ea9fc2c39a54f547e7cbb60f94539751f28eb5b4e74aba70a7ce9cd6e486a9,989047,2020-09-29 12:11:53 UTC,250,,false,250,0
0ddaf02d4c37c16f99648ac428fb81bc2678419a8b9dadc6768da9641e399237,989047,2020-09-29 12:11:53 UTC,1361392421,1361389971,false,2450,0
72a31982a7e38ada5e344d5f9ad16eb5fe0f8462be5ec446455e25d646d9e295,989047,2020-09-29 12:11:53 UTC,1033575876,1033507524,false,68352,0
9ef343243669185558cfc62a74efdededdb556bd3ec49fb44901a961c5cddd4b,989047,2020-09-29 12:11:53 UTC,129799500000,129799497650,false,2350,0
964a43c6b5753d7777b77a37e90dd7741061ce984e1b3265a227ef49633f9531,989047,2020-09-29 12:11:53 UTC,1730101920,1730099660,false,2260,0
7d40088d7eb5383605ef89b57cd0e762eecab514e0ed58e94374e3ba51c1b85c,989047,2020-09-29 12:11:53 UTC,56089330387,56089330287,false,100,989036
6cc1073403b7fbd47dadbb441ecd5328362b4799562e04f45005928754168ee7,989047,2020-09-29 12:11:53 UTC,64440804,64432260,false,8544,0
b8a7522d18352521daca3ca7e4cebc52616076f6542c27d51af216c3737758d2,989047,2020-09-29 12:11:53 UTC,2000147938,2000137938,false,10000,0
e1d5d2700b30974b91a3ea3379dff1f61d485e586623afc41b34c825bd338d70,989047,2020-09-29 12:11:53 UTC,1013855,1010506,false,3349,989036
bed1d95cf2cfde46bed4d70204a6421fa85694462966fac789f3363133eb32ba,989047,2020-09-29 12:11:53 UTC,602458578,602392952,false,65626,989036
b723b5805aee76efe91ee7c9fc491e02665e6af207d077addaf8649ab138b987,989047,2020-09-29 12:11:53 UTC,64139849,64131305,false,8544,0
cf01f6dc4e562aebef682660e509fd748247f6b67192a4f9b7b47240ed408ab8,989047,2020-09-29 12:11:53 UTC,219466372,219463412,false,2960,0
5eb3399c73ad6d5064d678f885910cd164ed91d4332bb23a3ac8e58b441a06d3,989047,2020-09-29 12:11:53 UTC,161984014,161980441,false,3573,0
3447d1f45ffc1c0d192c0122e43c02f37af79431681e18bea509db60686b0b01,989047,2020-09-29 12:11:53 UTC,1293171669,1293169749,false,1920,0
1929242ea55fe78cb36124382de3c54a936faa287f9e62de3b8b204db5b7b580,989047,2020-09-29 12:11:53 UTC,250,,false,250,0
47bb3dce67093d284f1383a1b8236f2d0fd1560f790a22dd2e95398f902070ce,989047,2020-09-29 12:11:53 UTC,500001920,499991920,false,10000,0
83a745f5f8ad03d06e5c0ef0d5c2807bdfa462258b9df103e20a195f55e0d995,989047,2020-09-29 12:11:53 UTC,250,,false,250,0
b346b833003f21209d4d58da20ea4573d6a29a4bf99ce05ecca2534fa0769c82,989047,2020-09-29 12:11:53 UTC,1633540050,1633480260,false,59790,989036
15b656b3614bc50eb72e7a0063c890f312893863a1536210fac17a034befc01b,989047,2020-09-29 12:11:53 UTC,2056101995,2056091995,false,10000,0
c5fb77111c183f9cc3ad9efa93582c102d4bae76dd669071bd828a9d5dcbabd8,989046,2020-09-29 12:06:13 UTC,10500750954,10500740954,false,10000,0
23d1a4b333c11c419f9e571c9f89996eb1f8e8f1cf1e04a8970d8c3e68cd756d,989046,2020-09-29 12:06:13 UTC,29814,27364,false,2450,0
c0ed3708a05cc73ce38e715768c8cfe1792bd6ee6446338eac29770e18434e0e,989046,2020-09-29 12:06:13 UTC,453143208,453000003,false,143205,989033
eaaadbf10834186e09dfde0c825af4f7ce5e07403fae767b97715c3695ee61a8,989045,2020-09-29 12:05:30 UTC,64471180,64462636,false,8544,0
fe4db06df929b0450fa12bbee7e37130dc75c3ce613acac458edec3ac3fd769b,989045,2020-09-29 12:05:30 UTC,244981974548,244981964548,false,10000,0
d7d40cc225691f7129347e0b634da2bf2c46e90424b227f8d07d22cf29517239,989045,2020-09-29 12:05:30 UTC,1000010000,1000000000,false,10000,0
aca00be86a8f5ffc4573a7e61b89de1585ff01b46b122f1b0abd6fc548abca44,989045,2020-09-29 12:05:30 UTC,1500017968,1500007968,false,10000,0
d739396dc0811daab0875e509487967b7076ccef87f973b526aabb4b6b2e2d70,989045,2020-09-29 12:05:30 UTC,499990000,499987907,false,2093,989034
ba0859e520876ec5151a6716ee34c2a0eab0a4823a426a076ffebb7048a41952,989045,2020-09-29 12:05:30 UTC,501008733,501000335,false,8398,989034
cb33f082a59d372312d59037743500d02d049e7b53928a39396c1344aad5c42c,989045,2020-09-29 12:05:30 UTC,245010000,245000000,false,10000,0
1b501903e92e5b99eeab7c5ae6903d9a853e244b6cdf7c6e222d3f8b1179dce6,989043,2020-09-29 12:03:46 UTC,720199442,720189442,false,10000,0
5411c2e722293d21af54ff5db032011a1fa374c21c15782695da2d412e364e87,989042,2020-09-29 12:03:33 UTC,193511034,193507461,false,3573,0
5ee08e78f790e3693e136094009ded0cbec793fe61276922f32333b1565d27de,989042,2020-09-29 12:03:33 UTC,26671208,26667140,false,4068,0
fab9f14adababfe4f0e9bc5c1dd177f643c4715d9eb7cecf3dff133f5c9dfc81,989042,2020-09-29 12:03:33 UTC,4540598804429,4540598747518,false,56911,0
9228417b23695fe5883627539b1ccd113943c989454b92c0c2757473293ec789,989038,2020-09-29 12:01:16 UTC,1937417524,1937414269,false,3255,989026
b404db311e5610d9392eb61f5b03156448ab3c329adf60ebfd9f12c6c1add12b,989037,2020-09-29 12:00:48 UTC,604662418,604587992,false,74426,989026
420f99eac88ea40dda602d845ab989129c6f37bb703ee0e01fa409f5520064af,989037,2020-09-29 12:00:48 UTC,47239857,47237474,false,2383,989026
0f29848b63a0c821e8c28e3368356dbd73c15dc74e44be82a0ea715ecb2f3e7b,989037,2020-09-29 12:00:48 UTC,343118,333118,false,10000,0
7c9d164aa62f6f30316b45c3246330eebe951588045f6e4579bc2427df46f8d7,989037,2020-09-29 12:00:48 UTC,601327309,601227309,false,100000,0
68d6169f3b60c4dba0343c5666855151942ae477eced2c7825322aabbadcdd61,989037,2020-09-29 12:00:48 UTC,1634472281,1634422889,false,49392,989026
865024c056b71825bb3348b3c34df4be9212b2a65584b27a341c7868584c680b,989035,2020-09-29 11:57:15 UTC,68386959,68371299,false,15660,0
680c6e3b6aa0c445a962cb2c4ded7c26d6b657994f00fc4f4a1235abc4371293,989034,2020-09-29 11:57:00 UTC,499993997,499983997,false,10000,0
d2891351ad3b25a181f406ed51f838039871f7797f9d4207ee5898c4563049fc,989034,2020-09-29 11:57:00 UTC,183000000,182998080,false,1920,0
5e29865519e36c83e63a9b9707ee86b5704d71dfa18a6022ba316a5490d7173e,989034,2020-09-29 11:57:00 UTC,162763801,162760534,false,3267,0
7dd46d990ba4d587c2e24861eda7426b1de6fdd5d7df43fde699e7580fe8678e,989034,2020-09-29 11:57:00 UTC,250,,false,250,0
bb917ba53ac35f42e0760c8bb1b3e855b7f412a6611d29521e8cd3c083f52595,989034,2020-09-29 11:57:00 UTC,64500127,64491583,false,8544,0
e16318e67ff685b86a02c509f1cffa5a9ed2f03277f001503e9d4372db6754a9,989034,2020-09-29 11:57:00 UTC,250,,false,250,0
b068c0dc0653ef3570b178d0a4bb1ae530417c50ad9cbb2dc863d0be6725644a,989034,2020-09-29 11:57:00 UTC,500000000,499990000,false,10000,0
2e0fc0f47d037a858ea34b604ef8d4bd381cace96246ba3de6752dddf43b6f72,989034,2020-09-29 11:57:00 UTC,538117416,536851234,false,1266182,0
195403ea169eb1b1bf567c6809ed93ed65c1b5193133b33b040b633df9189859,989034,2020-09-29 11:57:00 UTC,250,,false,250,0
8e41828e021e181fd6ff30648a084611aafe7f23181f1b2dcd27e11f902ef95b,989034,2020-09-29 11:57:00 UTC,250,,false,250,0
e59f7d6b3f95c4e0470eb535b4b348ed115262d451d26d4f30aa2c6f27765626,989033,2020-09-29 11:53:41 UTC,124998122455,124998106875,false,15580,0
2c6876de18980ff655935c9d4a8eb588f43e79699c300d248915f162f38bca92,989033,2020-09-29 11:53:41 UTC,321037383,321000003,false,37380,989020
1757e7a693e8df23d31afdc3a48df258925f57a645ae32e5a505ba5eda425072,989033,2020-09-29 11:53:41 UTC,64532165,64523621,false,8544,0
eff1af1184571e031cb99068dea8a3c94662978907e193bb46c10e81332e467f,989033,2020-09-29 11:53:41 UTC,349980000,349970000,false,10000,0
11b1001798bce2c5019cc3d7d77cca4308599c470adcdd23dd4471463e821456,989033,2020-09-29 11:53:41 UTC,371397020,371394959,false,2061,0
c88c87668bb0c84127899f5897f607892f3c61d97fadc045e3414ce44d78a0dc,989033,2020-09-29 11:53:41 UTC,1014128,1009515,false,4613,989021
48d6172990b32b4cd8e07fcd88139933e76f0bac4256847bc2bc3d89ba495f02,989032,2020-09-29 11:51:23 UTC,250,,false,250,0
971126bced2eee18f6a6e25a0d8635c1aac93c3b46d1f6e74c3eee08cda2a1ee,989031,2020-09-29 11:51:16 UTC,10000,,false,10000,0
582d189d09294693e66913c1347d114021de8ef053b3616dfe0260ddc91fce95,989031,2020-09-29 11:51:16 UTC,1862870180,1862867920,false,2260,0
614159173567d1fec2162f7a5da0bc67062deeab730987e9739375070443f5ea,989031,2020-09-29 11:51:16 UTC,606836012,606761586,false,74426,989020
c6ab0b72934eb5830db2ea494fb3c78804e229bb3c6f809f075b0c21bc95be9c,989031,2020-09-29 11:51:16 UTC,3518032845,3518022845,false,10000,0
842ddecf942f786dbfbf8c0cdbafd0a37ca15c945d0ae3f06dad2650dd43cc72,989031,2020-09-29 11:51:16 UTC,21294,18844,false,2450,0
d7c3c61d99c6718051bd6edf94d69570773782e246293971649da21eefd3af86,989031,2020-09-29 11:51:16 UTC,143979560,143911208,false,68352,0
ff69fe95c52b605c0f14acc9d86ba4ae13a2ed300f4cced3618cf3e8a2447e57,989031,2020-09-29 11:51:16 UTC,1635559645,1635506801,false,52844,989020
9a93a9c7b2c72e925bfdb41ddcbdc11f14cb4f519b67f39c74701f266bfb12db,989031,2020-09-29 11:51:16 UTC,64582899,64574355,false,8544,0
544627601a3966390994a1801d6c8361fb6adaa530ef0c19e92292d5a465ee30,989031,2020-09-29 11:51:16 UTC,219658697,219655430,false,3267,0
6a92329474e6567b45a1a77cea2004887b12076c033a9fe3ae1dbb24e380b573,989031,2020-09-29 11:51:16 UTC,92430891,92418891,false,12000,0
da4bbccf5c3227fa872fc84b38115334f242db27378f8dc835f66c527ed28d1a,989031,2020-09-29 11:51:16 UTC,1965361,1955361,false,10000,0
73269299faffee9c7222c7557055b5057fb7a0b60fefafb88310cdfd7c43a2c2,989031,2020-09-29 11:51:16 UTC,15142193,15137579,false,4614,989019
c74e642dcd86466ee15c37f1345df5f2e9cd129d93a9c749e49fb06f1ccfcfab,989031,2020-09-29 11:51:16 UTC,2066658018,2066558018,false,100000,0
0808f1a7d9fe4fbf745b058458d4c02af693afde075c45e2f241b16efec8a5b4,989030,2020-09-29 11:47:42 UTC,1636582304,1636530013,false,52291,988963
e038cfa79c1fb43e2b871445a6c709964701db166c60092d6b155fdb104a6cb1,989030,2020-09-29 11:47:42 UTC,30396948,30394855,false,2093,989019
7865a5096a641d56c1722f28e7b1d231c04bcbcd417f96a42ddd6ed9b2a2acef,989030,2020-09-29 11:47:42 UTC,15466150,15461554,false,4596,989018
5773c6f6469fd062cd8a4e677a8f60b3cb71dd1cc026c4f2fede85d96f4fd42b,989030,2020-09-29 11:47:42 UTC,194400986,194398026,false,2960,0
13ee9b8cb22964342a7a9353bb551eb6bacb0ff2157febb622da171933bdc4f6,989030,2020-09-29 11:47:42 UTC,162914742,162911782,false,2960,0
ede674effdb99caf0ea8441df58a99868c57ec4c9cd9c77f2561fdd576b91a45,989030,2020-09-29 11:47:42 UTC,300010000,300000000,false,10000,0
1ecada5f25d87439b3798000fec391ac940103823c529aab7ac32ec4b9937d45,989030,2020-09-29 11:47:42 UTC,164178306,164158659,false,19647,0
9d4f0a3390e6f6d458eaf8f03e0c7c48820458cd4976484b3db2857daaf18d16,989030,2020-09-29 11:47:42 UTC,64670877,64662334,false,8543,0
d443826a85b21b7ae729209c3c5dc826e4bad0ce91b54881b1b8288bc3413d80,989030,2020-09-29 11:47:42 UTC,2558334700,2558324700,false,10000,0
29ee373c965378b74fe8165b5ad617508a24df6a9bcaf561a1cf71346d6e9d75,989030,2020-09-29 11:47:42 UTC,30507250,30500117,false,7133,989019
540ff956b2935a0b7b7dbda47c0e002eb7f8866f3d6e407485fd01f9a4c75a40,989030,2020-09-29 11:47:42 UTC,20348506133,20348496133,false,10000,0
f9179d834f8c7f22e5f48b65a2dd7002e668f140009f5e4a81a4305e06a61317,989030,2020-09-29 11:47:42 UTC,500000000,499990000,false,10000,0
9f57faf671bc7640aab62ccd94d40e3627f24b68aafa18ef49fe26d907992731,989030,2020-09-29 11:47:42 UTC,2546119340,2546116890,false,2450,0
3e90fe4c3ca7fbd4de4ec5c325fd38166c8dc93642d6775e37a8d4ea78178a12,989030,2020-09-29 11:47:42 UTC,207650,197650,false,10000,0
10d74611606c0030c0d91589f6cc9bd70f044e0852df03f82ed459ad03f2b9d7,989030,2020-09-29 11:47:42 UTC,102162199,102159749,false,2450,0
099b966ccf494ed1310299849032842409ad81feff9683274b1f1ff2d2b9a7cb,989030,2020-09-29 11:47:42 UTC,608869968,608795550,false,74418,989007
fddcf1ecf375c8698da7295bae7936f5c9cd58a66f064122c7fab5c43366107c,989029,2020-09-29 11:39:46 UTC,21073695522,21073685522,false,10000,0
43030c63a9bdc3e7a3b20bf30c72c467d5b5d0323be73c66abbe662f8ec0ef61,989027,2020-09-29 11:38:49 UTC,386910000,386900000,false,10000,0
0fc81be01c4dc6b0d10b9b3b359a13f6a88beb0941deb94d5eb8166417cf6cdc,989026,2020-09-29 11:38:18 UTC,10156422,10155276,false,1146,0
21848defac66e663fd73ffc8eb91c98152b3945f0ecd2ede29a3f5d61b44a3cb,989026,2020-09-29 11:38:18 UTC,218042,200042,false,18000,0
bce5cfecf922ccdbcc9cb41cfa317b05ce2a935823c3cef7a8117dd03192d2a5,989025,2020-09-29 11:37:28 UTC,648546835089,648546833005,false,2084,989013
b5cd67ed25d83cef4b86ea2f15df3d62bd0ca3ffc6338d8c26481c529959637d,989025,2020-09-29 11:37:28 UTC,68904000,68901550,false,2450,0
2855ef547b80f3bf029bcafdb87d5f66e7ad3eba6d264a3bd051b165c554a4e7,989025,2020-09-29 11:37:28 UTC,220219351,220216391,false,2960,0
af775f45ac382e9a660ff9ad7e0966262de54bce890a58182f9f41bb048cf531,989025,2020-09-29 11:37:28 UTC,21073705522,21073695522,false,10000,0
28b633ddda0667387b01941d3e3a7fef9c4f9c49cdc192b2ede9887a970c6c65,989025,2020-09-29 11:37:28 UTC,520290860,520288799,false,2061,0
e1e18de835b8d583c12f1f33f407882d2775b2df65fa4e538b6513321abb1fd3,989025,2020-09-29 11:37:28 UTC,76412864,76392844,false,20020,0
825ec45c64d7cd84d85422ff68ae89ce0a6a6f683fac9f69e5f7d0d38b191f33,989025,2020-09-29 11:37:28 UTC,1500103070,1500093070,false,10000,0
3920241fb2a80b1fbbb5228bf61765d9d87a65e4e1ca24bad05b761a875314d2,989023,2020-09-29 11:35:18 UTC,21085365663,21085355663,false,10000,0
2d4c367efec84d5eb070ead40ca918409ce46aa995a9e5d0567301979588eb2a,989023,2020-09-29 11:35:18 UTC,64781259,64772715,false,8544,0
9625a5be8b3d904d9d3c8ebd050edaeb95e3f4c777001ed3632d3f4fac84b2db,989023,2020-09-29 11:35:18 UTC,569793418,569790800,false,2618,0
9f2185225fde0d50ffd3a6f4e70fa0f4097204a8149f6291c4b8c816cb03e388,989023,2020-09-29 11:35:18 UTC,194547007,194544047,false,2960,0
4840cdf4a0969ce17eea2acbf6f387b311fb5a9b0a3bb9e3d9f903e13359ce41,989021,2020-09-29 11:32:41 UTC,349980000,349970000,false,10000,0
07540d834ff162060bc1bffcaef4239f456b473fc6f37db1ef3fdfce6ffb4228,989021,2020-09-29 11:32:41 UTC,565606210,565537858,false,68352,0
8dd6f22707f251c8d440c3030a9383d27df98c605b1dd7a26dba602b1c046c6a,989021,2020-09-29 11:32:41 UTC,273382,255382,false,18000,0
09aad3faca7997aadff30c02966c1eb832ff6b516ce030298c0806aaf1527b94,989021,2020-09-29 11:32:41 UTC,651105171882,651105169789,false,2093,989010
7ffd0984b53f2976ae72b5ef9e2f8ed6c33e41c69ea8c4f43cde5703c0acb64b,989020,2020-09-29 11:31:22 UTC,56130960487,56130960387,false,100,989009
3a9a7b36d4e8c81c0847b914405a43daccde11645ec43e996be5b4b9bd883a45,989020,2020-09-29 11:31:22 UTC,64822871,64814327,false,8544,0
fcdd3399125a81bd365cab815dcdbde1eb3aa2b748c11de50824bbfebd169532,989020,2020-09-29 11:31:22 UTC,2050080100,2050070100,false,10000,0
ff5f2e7acc84ffa744e5a0dede9a4a8d445f431439d74b50033f40298e1e9e31,989020,2020-09-29 11:31:22 UTC,60863592,60852673,false,10919,989009
19de3abec9dde808ac77b86ad8672191cbc438625a0d2ccd13ef48a4972a7a2c,989020,2020-09-29 11:31:22 UTC,21085375663,21085365663,false,10000,0
f427e14cfc4e12d7b749c958ee558333672316455c513efc41783b30d2a6cf14,989020,2020-09-29 11:31:22 UTC,163177752,163174485,false,3267,0
188e6c85ec90869a602235585c7c62e3c1c369545e436ede1b298b7ea87aa737,989020,2020-09-29 11:31:22 UTC,64875580,64867036,false,8544,0
da7e9eeb6df220ae024ea2ca35d461fb9f286c4779bc7c33476f8a79dc43704f,989020,2020-09-29 11:31:22 UTC,651829729465,651829727082,false,2383,989009
c45ab12915b84536915e2a65739a47162a4848077f89958f69948fef86f38076,989020,2020-09-29 11:31:22 UTC,1638245402,1638179434,false,65968,989009
ead26bbd42404fcd485be2c86d890a11579765ef699abdc51e5817445e0c3afd,989020,2020-09-29 11:31:22 UTC,611148454,611074036,false,74418,988974
88d8743523dc8b1cce8fcc743a582e5af9f50e3688cdfcc9f4b522c3f48cdb9f,989019,2020-09-29 11:27:12 UTC,1995793440,1995791180,false,2260,0
dbb9457a4dbad3e20d0ecfa3baf95adab180d8ddfb89f1d1ac8d14be402a227f,989019,2020-09-29 11:27:12 UTC,1000066935,1000056935,false,10000,0
eef7629307e1a54e7d46b6bf2e6915d8814046744234d44c94d2a89865825b36,989017,2020-09-29 11:25:07 UTC,220675891,220672624,false,3267,0
e54f0c9cd80ddb6e92838588ea3f0ee1d49282721e36f0ca9dbea81d19b8cf19,989017,2020-09-29 11:25:07 UTC,1459753561,1459751301,false,2260,0
61b4c57a95ca5adaecf98e7218f6e234a9752f1300dd4fa3aea6b814104ff606,989017,2020-09-29 11:25:07 UTC,10800010000,10800000000,false,10000,0
1f1eb0c7febbd623b3e345d21fc2d18d970de4b18b0e84af7bbad4edb7fd562d,989017,2020-09-29 11:25:07 UTC,26990000,26980000,false,10000,0
083d586346f8440e59cbd1989822e9dc0ca9a7c2c691f297134e2f910a399774,989016,2020-09-29 11:23:52 UTC,32698302,32692302,false,6000,0
0391a2ac766a2da7b78cddf1e194e0879541fbe0538f321d77514b38eb2cdc33,989016,2020-09-29 11:23:52 UTC,250,,false,250,0
f005b9afacb7e2583af58244612588805fbdfbcad7b9a367cc6ae94d2a6cca1b,989016,2020-09-29 11:23:52 UTC,455097984,455022894,false,75090,0
69240d5e7046cfd2b98634fd80c5f7b23313de76856a23a93c811f1f5e56cdba,989016,2020-09-29 11:23:52 UTC,100000000,99997550,false,2450,0
22faa8725fd387b25eed73fdc1023f7e4ecae7e5adb5811d339082511021f938,989016,2020-09-29 11:23:52 UTC,180526,162526,false,18000,0
8e0ddadba683fa3e3d5584fadfab5e4c7668f6fc339504ca7bb031fce512a855,989016,2020-09-29 11:23:52 UTC,504063998,504053998,false,10000,0
3f45fbf43d27c98cc6d915e4d160bf502a319154f9e3212e71cdc47702d1fe04,989015,2020-09-29 11:20:16 UTC,613428568,613354142,false,74426,989003
6fc349c001d1e72b32190f378efdc4a69f1f6751791544c070373426565223cd,989015,2020-09-29 11:20:16 UTC,1639494502,1639436719,false,57783,989003
2a2c89dad3cca6ab5c33ffa5fcb1ddfd1a47e4c1654ed821acb2ccfe9b64a41e,989015,2020-09-29 11:20:16 UTC,56139131210,56139131110,false,100,989003
da2a7687b81cc93c6486a053f0fecd990121785505b9f9cf7d8d779992eaed2e,989015,2020-09-29 11:20:16 UTC,111183516,111164646,false,18870,0
d83ae8191611258502f5afd522d16bf45cf0d50f962a2fb583f2561fb016f8f1,989014,2020-09-29 11:20:06 UTC,1000076935,1000066935,false,10000,0
593ea0c711df4a5ae6512a5eeaab76ea71c2ce9bea48c8d2fde5464315272523,989014,2020-09-29 11:20:06 UTC,305718799,305688799,false,30000,0
4aaf9bd2fc400b8645a0e4ae2cd570e00b81c845b67f992786366ede5280c725,989014,2020-09-29 11:20:06 UTC,838132090,838130508,false,1582,0
02044624f23ec0d1ca7b603f67bb8a42fc8b898bc827a0e4af711d591f9da980,989014,2020-09-29 11:20:06 UTC,146813,136813,false,10000,0
0cc7fc33f471a5c3f556bc4c44aa68b673b3d06ec1659c7522f21fc6df479122,989014,2020-09-29 11:20:06 UTC,337168,313168,false,24000,0
b42bf8b1aba7a8c3f1356ee4c36079c73bb07ab75e93239971efc65a4729c230,989014,2020-09-29 11:20:06 UTC,139791356,139781356,false,10000,0
e92002d78e27b641bd8fe65a7bf4b0bfa50396d5935802ebd6f1f102aca27400,989013,2020-09-29 11:17:28 UTC,27000000,26990000,false,10000,0
7b3656b10311d10ef398de4194e100bddc3b143baae7b5e7287f916dc269c3d3,989013,2020-09-29 11:17:28 UTC,1000086935,1000076935,false,10000,0
235a9887996010dd1febf893792d5056a44beb34ff8cc7a23e1be94a15ca2c9a,989013,2020-09-29 11:17:28 UTC,56408644,56406551,false,2093,989002
ab66d41de9b0c5c8bfa270aa86b38253ddc4015250c53442f9ae66a6b6ad4bc6,989013,2020-09-29 11:17:28 UTC,200010000,200000000,false,10000,0
6e11a5aadc526f64431de6c08836ed2ca48a29b60c100a1ccab2d5020dfcea97,989013,2020-09-29 11:17:28 UTC,614974309,614874309,false,100000,0
5c2e1326e7cd679f5537ed9a060f62ae6c060ac8686e5b237a6541c6a48c35f7,989013,2020-09-29 11:17:28 UTC,1014019602,1013951250,false,68352,0
f84207c394eca7ddff143171477d2eff3012886c5f5e27e493dc22b1c5e15c36,989011,2020-09-29 11:15:13 UTC,214653039,214568799,false,84240,989010
ddc3d0fccece3f783453f98412b668054cccb1d487b61b1f4283574ec0e37c34,989011,2020-09-29 11:15:13 UTC,20096428567,20096418567,false,10000,0
2e1bd51eccbaa9ac893c2fa3d81365582b912a1e3379125711527729fbf28569,989008,2020-09-29 11:14:20 UTC,195077890,195074930,false,2960,0
c6fcfa5c00a6c0eb6febd79e1a0b0c82f145faa223db5927aa1bdc275b85227d,989007,2020-09-29 11:13:57 UTC,163650,157650,false,6000,0
8a18d0fe1b661a2f439ee527358da9a9f1343880cff862b4577e6e3579a0bf40,989007,2020-09-29 11:13:57 UTC,651986931848,651986929465,false,2383,988996
5693bd0ff02ee562dcb9a8026fb6555664ed8c4dc8c0ceb48e2885dc1252f48e,989007,2020-09-29 11:13:57 UTC,21163000,21153000,false,10000,0
9859a9f73344848c467e268c3b8229c6e7f389aeb5b962e5903744aed3b91b94,989007,2020-09-29 11:13:57 UTC,501017265,501007265,false,10000,0
89bd3ed32fcd6d8fb86ab4dec516993840cf529596295f2f20a4aee633f03e58,989007,2020-09-29 11:13:57 UTC,580912005,580902005,false,10000,0
bc1445e2a13bc806c75cf76279a4e0c708223713369293e9cff4cfb7a787ba91,989007,2020-09-29 11:13:57 UTC,20097719245,20097709245,false,10000,0
0881d6c6eb3507f1eaa6de3220c8008b03b3f4b65b9f339f5da9e2b39cc05707,989007,2020-09-29 11:13:57 UTC,250,,false,250,0
78d8791bc647b5000fa187d96531b653de4e68a93d0911391a10846dfecb528d,989006,2020-09-29 11:11:51 UTC,1010991,1006378,false,4613,988994
068ef2e7be88b646e35e221ebee41058616ca888b8be115584f105a3583bb5b0,989006,2020-09-29 11:11:51 UTC,500000000,499990000,false,10000,0
2c554f42b21405b293b23bd017ca0ae37a9ee6f269220800c8903ea87bd455be,989005,2020-09-29 11:11:33 UTC,2129267700,2129265440,false,2260,0
9709388b6befbf659051dce76654299eecb3ccd4d1018a3dc1fd18296a897eb8,989004,2020-09-29 11:11:11 UTC,65152856,65144313,false,8543,0
3ee23817e39711e64d079a5b402a694f8d802416aa3223c3686a26136920abf0,989004,2020-09-29 11:11:11 UTC,349980000,349970000,false,10000,0
8d4d1c177147ea887ab76c51c152873b665262b5a08dca4523ffd1cf87d88d76,989004,2020-09-29 11:11:11 UTC,105259687,105257237,false,2450,0
442b113a07059811e3b258f5ff1e1137ebb8c42b913cfef1f8d705fcba68eb40,989003,2020-09-29 11:10:30 UTC,632074309,631974309,false,100000,0
16048676b46645d85c4d7f4e7f2cd688d87ea1c1fdb3e720d85f40cd99a5b06b,989003,2020-09-29 11:10:30 UTC,616023635,615949226,false,74409,988965
75a7d7e51fc2b5b7b9ef2ba360de5e35707f0a3194bf180a5535b753a91dffa4,989003,2020-09-29 11:10:30 UTC,100000000,99997550,false,2450,0
692ef201018fcd5448b6fccbba5cd52152a03e84c43bbaaf4e6c222636fa2a3b,989003,2020-09-29 11:10:30 UTC,565530000,565442020,false,87980,0
71a35e11e10072116c0a4ab3d432f20c6704dbbc8a59783e589929494b83a6c2,989003,2020-09-29 11:10:30 UTC,1640763080,1640707901,false,55179,988992
2aa9822540332a0b2205b5559644319f1ca23af3002cb2843fbf8150c21a5430,989002,2020-09-29 11:09:22 UTC,652034934231,652034931848,false,2383,988991
8106b89dabd7971e22b79b1e9224760e173bdb83ba7756b766f53a61cdb8e455,989002,2020-09-29 11:09:22 UTC,56317831310,56317831210,false,100,988991
ea068ddec18c4c5be4ef263a63c45cf43f3b65ecbb25e1d1278a7e8977235479,988998,2020-09-29 11:07:25 UTC,500064868,500054868,false,10000,0
3c440cccbd07a1092c7a3d287dac48f9c595802644c6979c402b65773ca41b65,988997,2020-09-29 11:07:14 UTC,163830559,163826986,false,3573,0
a1bac91cd7b96f28c029b9c42c7c8e1b67ddb3f8c1ff93a5eaca52a51c68b8e4,988997,2020-09-29 11:07:14 UTC,3326350993,3326340993,false,10000,0
04a08e41b54e4cd626f7458da6dfd53cc28d5801fae13313582e4a4fe9b6593f,988997,2020-09-29 11:07:14 UTC,643172671,643162671,false,10000,0
3adf1a4c9f97879e9a9635ab1ed22dc3a9f028e5a603b226192ea9a8bcc87af3,988997,2020-09-29 11:07:14 UTC,656261369450,656261367076,false,2374,988986
306341e6dbd9ad873500f5bc2cd3fc60ef281f7672689aab2350cb5fdcd7a3f7,988996,2020-09-29 11:05:27 UTC,1500027968,1500017968,false,10000,0
669187c05033fb211822b862e17122d9825ed46d55ba7b1619df87b4e17880ab,988996,2020-09-29 11:05:27 UTC,2000096119,2000086119,false,10000,0
e4aed6a4c848db1779fdc0fa9d131c2fa7dffd79a205b63fe8cc0b581a7f3ece,988996,2020-09-29 11:05:27 UTC,243282558111,243282548111,false,10000,0
d8ae56f46f6d2480d7e084597e40dca6c836467087811346a5b6270461a54a23,988995,2020-09-29 11:04:33 UTC,201010910,201000001,false,10909,988983
17cbf7cc1e2c143d251040f3363fd41fb1da6d29f82b0b7c9ac42cfedb35e7e1,988994,2020-09-29 11:04:20 UTC,250,,false,250,0
0643c4d17391d38bc08de6b2f98e085a09165e853687af9059e404fe79bb4593,988994,2020-09-29 11:04:20 UTC,136808,126808,false,10000,0
944bbf0fddfe7fc04896f2ec165c01d0450f84ce9e9d01381577381d76b39638,988994,2020-09-29 11:04:20 UTC,56764,44764,false,12000,0
044dc2f3562b66faa4124e12f57db159ddd9c3c785b7841c0cc40145d6da824f,988994,2020-09-29 11:04:20 UTC,643198675,643172671,false,26004,988983
e5acda21bc02646eaaf54cae888b724595a2268074219c462e1d77e1dbd8e180,988994,2020-09-29 11:04:20 UTC,159346,147346,false,12000,0
cfa983deccceb662c343e93b548dbbb8ff5eb18ae6fbb740349cc17e3eb3262e,988994,2020-09-29 11:04:20 UTC,663341455862,663341453778,false,2084,988983
5ca770a4db15879633cada6ef22fc3dd9913065b4bedb6dfc92c8a3e11ad82a3,988994,2020-09-29 11:04:20 UTC,65181260,65172717,false,8543,0
bc6e3901360334914e4ed33af8574b3d08a6d46663d21693cd602f312e3c18d2,988994,2020-09-29 11:04:20 UTC,221131037,221128077,false,2960,0
917d355c0459d1a6691c841a684f989739f79d829a51a29ef0b581738a30f161,988994,2020-09-29 11:04:20 UTC,500254903,500244903,false,10000,0
66ab05a152c5a7ad840390563af9e4055b79f1e751b66aa08b30be2f355d9a36,988993,2020-09-29 11:01:17 UTC,2000860285,2000857031,false,3254,988982
0e92a642591659046531d95a79f193e8d7a8d8e47425ba066d02061165faa5a2,988993,2020-09-29 11:01:17 UTC,1642131551,1642072895,false,58656,988982
09d05b675671b50f94173c98d31d0750acd9d96341ec105346c8ee0c8c63f6f6,988993,2020-09-29 11:01:17 UTC,618358572,618284154,false,74418,988982
8b9c1c62a19430bdc2351bb216740931157dd3007838c65f07a7a8b45d3ae8e6,988993,2020-09-29 11:01:17 UTC,114626959,114605913,false,21046,0
97cec14a74b717bc59a2cb89649eae97734939de847d641d44f43619ab42dbbc,988993,2020-09-29 11:01:17 UTC,65224207,65215664,false,8543,0
ec4353bea9a29e3e39da45a29bccf5466eb3575645fbed5fe09a096e54281178,988993,2020-09-29 11:01:17 UTC,4720,3670,false,1050,0
8c038a8b4bda385cd34f8a48a9d7353c3977c7fee9c4157becb3980bd61ac11a,988993,2020-09-29 11:01:17 UTC,61238526,61236442,false,2084,988982
983a5b85295302c90011cfc57e106baa9d39a857413f05fde71dfd6377dc942d,988993,2020-09-29 11:01:17 UTC,10000,,false,10000,0
3eb2c370cea85cd51f2e8b746d81e9b850bd26fff7098b5e38c1ccae1a1f6447,988993,2020-09-29 11:01:17 UTC,23342993,23333323,false,9670,988981
f410da8c85974baa048ad79971f20337c21d109d71b3afd99755e57946e5b097,988993,2020-09-29 11:01:17 UTC,195555910,195552950,false,2960,0
32813f4f16bb5d1a7de7251ef8f748274378f28b05db87998a73f01f05df84d6,988993,2020-09-29 11:01:17 UTC,10600010000,10600000000,false,10000,0
ac4a3420a54f302e51ac6a90e6bf140c99745214c981c9b79b7bbeed1a40e9cd,988992,2020-09-29 10:59:31 UTC,65424930,65416387,false,8543,0
a4180440644f65d6252fd5aa0c0d4d640bf8282098ad558d6fe026d84a8035f7,988992,2020-09-29 10:59:31 UTC,664884957946,664884955862,false,2084,988940
3412e1dac8e28bc3054ca50e476eee385e97287deb5f637c0ff5f5acf3a877d8,988992,2020-09-29 10:59:31 UTC,2000000205946,2000000000000,false,205946,988977
d1a1da840e51dec1ab61df1308e21e87bee533e047214086c49ed6e0934ab915,988992,2020-09-29 10:59:31 UTC,164116524,164112645,false,3879,0
63af5bb9582eba5441106f065c92623eeca842d8bc0486136f594e770e85a01f,988992,2020-09-29 10:59:31 UTC,425515757,425447413,false,68344,0
b5d4f89e2be69e590519fbbea3eb2606eabd672457e6682c22a315ef552ac00d,988991,2020-09-29 10:56:48 UTC,250,,false,250,0
45b90372a9447940c76b32a61cb3ba84724f3fc5626d52b7cbb8bad119b77c2c,988989,2020-09-29 10:56:00 UTC,781963610,781959870,false,3740,0
37100cc5d1095b27542ee1a330dd52444c57e9c00b69f2d81fcd87a0af8a8471,988988,2020-09-29 10:55:52 UTC,1029526169,1029483869,false,42300,0
80a3ab654dbfc5d6cb5c03d190c5596c7fd700dd5511be056cd43473b0b76fe6,988988,2020-09-29 10:55:52 UTC,31754229,31747096,false,7133,988977
cc43fef5eccba364d21141b591680350e0acdc37e584fd4b76813054d3114514,988988,2020-09-29 10:55:52 UTC,20097729245,20097719245,false,10000,0
b0d1ee32c4e402443ac0af0076aed056bbb3870c297b7a3e5018f7ec5261e43d,988986,2020-09-29 10:54:46 UTC,20629638405,20629628405,false,10000,0
0c2450737f621c2c324d7d7f2878d37b7a2c63f1b95812ee056189e079c16a25,988986,2020-09-29 10:54:46 UTC,221332905,221329638,false,3267,0
6a5b1deeabb40eed1164e05cccbb10ec8f9acf879b8f6895e2bcd83529cac4b1,988986,2020-09-29 10:54:46 UTC,195710041,195707081,false,2960,0
9eab776c56e59725ef6f1f59945289e3f50165afc4343436548fbab06ecbc5c6,988986,2020-09-29 10:54:46 UTC,665666648068,665666645975,false,2093,988975
b867c106cca4b1189741fe56fd7106bc2cf24cd7fc77df5a2aa371afd353c2df,988986,2020-09-29 10:54:46 UTC,1293581842,1293579392,false,2450,0
87129f44863e520e53f48f3d2e3fd799aba1fe9b4a45fc93a1b93294c7c24f57,988984,2020-09-29 10:51:10 UTC,14494370,14488501,false,5869,988970
d028429a2b59e20007df2458a49c0a23645e987ad2fbfc72ad42ed1481d37554,988983,2020-09-29 10:50:31 UTC,56324598520,56324598420,false,100,988970
d3bd0d9e8e22180bc7ef64a5afe142bbcc04c5b09c5ae05d8e44a68f219cbea9,988982,2020-09-29 10:50:29 UTC,20629648405,20629638405,false,10000,0
3550dfac184e37e5da207f4cba182439954fc741e4cab42c33c7c4c27578ad64,988981,2020-09-29 10:50:27 UTC,30208089,30171789,false,36300,0
d850a1dc38d4f1334d4d46d177a2a77019279b8aba7cbbcde9449eccc4d0c602,988981,2020-09-29 10:50:27 UTC,1643359750,1643306280,false,53470,988970
ef5638d38b0ccdd65fba3edb12bd3865586a0cfb8d063edc3d2476bd3bf8b33f,988981,2020-09-29 10:50:27 UTC,620739901,620665483,false,74418,988970
478f43256aff86b12dc7f4eaf7ac0fb0ec13bfd8da4dc04f6aab2a3fa1a1373a,988981,2020-09-29 10:50:27 UTC,10000,,false,10000,0
fc787637d008532c0e2c863aeede395f53f8d5b4e69c612aa5553fc3853b8166,988980,2020-09-29 10:48:44 UTC,154195209,154191793,false,3416,0
c668f3405f6240e0d9f5e8ab436de0bb3bf2ab52ae3cdc0bc6c1ca2277e6439c,988980,2020-09-29 10:48:44 UTC,21870110379,21870100379,false,10000,0
5d2460d328e265b160c8df0eb54118385031064c55509ddf59bab168260e1e9e,988979,2020-09-29 10:47:58 UTC,102472226,102469846,false,2380,0
9fba7ad3de1ed5bb361fc6a17423726292d9ed4cb9c0ffd792eb948e4aefce63,988979,2020-09-29 10:47:58 UTC,5110302000,5110301040,false,960,0
0aa0a072e602f36d3e19c04f321dedbbc2dc1454472d971adf7e400bb8a42910,988979,2020-09-29 10:47:58 UTC,164416902,164412717,false,4185,0
781fff2439ca1c1be5f317b565a589b05b20ea860634c29ae83f4ee4a51c77c8,988978,2020-09-29 10:47:01 UTC,46611034,46608774,false,2260,0
deb15285cca6f6be4cf111b1970fe996cd9c21a2847980f82b11e633c983500a,988977,2020-09-29 10:45:32 UTC,21870120379,21870110379,false,10000,0
b80d7d3a94af7c97e7b013d6823dd39ca6e0af65b4d4e29ce2012b58b32f7558,988976,2020-09-29 10:44:49 UTC,360000000,359997550,false,2450,0
7c0ec8fca03c338b339ab93ff2676407efd2615a4c638471ed184b720f0568ab,988976,2020-09-29 10:44:49 UTC,34353430,34343430,false,10000,0
c2af7bfe57660f52994a0326d80f387e681212ca79c2dc04154a48bec690f007,988976,2020-09-29 10:44:49 UTC,500063210,500053210,false,10000,0
412acfce93fc14c60c4d5bdb18d3efd4047dedaa8950b35ba3256fe625ba5d2a,988976,2020-09-29 10:44:49 UTC,196077348,196074388,false,2960,0
5e70b4fbb9c74884532cfd64b09e7f7335f87836958ff0004dba7557c474caa6,988976,2020-09-29 10:44:49 UTC,623229818,623155409,false,74409,988938
4027fe4a50bcfbad342ec56ae30e4adda8279c7d34cd5e102c5312768b77c058,988976,2020-09-29 10:44:49 UTC,22998,21852,false,1146,0
0a95d4094518df6d1db5cc00e5d60794d200289cde6b08f225dc709f031ec74a,988976,2020-09-29 10:44:49 UTC,375631653,375628253,false,3400,0
2c0338e731847665c4ae2f9c7e9fb270547f9445609b7fd3da0e6d3163e97960,988976,2020-09-29 10:44:49 UTC,65727802,65719259,false,8543,0
8c73df8f37b05cf8ef7e4c1b7d9cc752e36f44c5579f6119abda4ec2cd4ba335,988976,2020-09-29 10:44:49 UTC,9141968,9139875,false,2093,988965
af250b4cdb28a7659cee72726b9fd898429fc60312e8c3ee20c39024266a1bcf,988976,2020-09-29 10:44:49 UTC,349980000,349970000,false,10000,0
610276e60284c81abea882542f9912bbb82d99e40e231971c14076daf20c8a26,988976,2020-09-29 10:44:49 UTC,250,,false,250,0
b52a329798c9aadddd3929ae7cc8f19f0c2f79f8010648b767e04292ae9ec8d6,988976,2020-09-29 10:44:49 UTC,665766150161,665766148068,false,2093,988965
9199f0abef9280f02806a83798fc2a5e48b015226c9a9e8f7abc4c37e3ba1c5f,988976,2020-09-29 10:44:49 UTC,21589104458,21589094458,false,10000,0
95a5052f35c10fa3a18cdeb3530f8c6ae043cfa3119c0146b133f9427b51752c,988976,2020-09-29 10:44:49 UTC,1644521687,1644469720,false,51967,988930
8ac4acc80752e8a63585c486db667ba71f0c5d3b9274198385c7c759562c47c3,988976,2020-09-29 10:44:49 UTC,221490242,221487282,false,2960,0
efc40283ae5314127a2fe94aaaaed21eb97e48d5895b22d040be969e3d33406d,988976,2020-09-29 10:44:49 UTC,531033,501663,false,29370,0
9a51c06d4cc971bc5500e9d0a56a29ddad769a0a48058b2f7f12778f0fbcb0c0,988976,2020-09-29 10:44:49 UTC,331359,322259,false,9100,0
875f999616456a3b325a009b1a0465397b1a446e00f2cc1693cad05c738ce142,988976,2020-09-29 10:44:49 UTC,2263289960,2263287700,false,2260,0
f54a60f711bfd8908823b83f8cfcd3a5a7f2dc71136dea906e4a645c795d8438,988976,2020-09-29 10:44:49 UTC,1977971803929,1977971801836,false,2093,988965
3a51074f357b1503e354ad3763ffcffd27f494a28bdd5fa5dab2011525d61694,988976,2020-09-29 10:44:49 UTC,103804715,103776521,false,28194,0
1ac02f63a58a7f297bad006c384a6eb0c39e4fd0bd6c449088d4e95e269ba51d,988976,2020-09-29 10:44:49 UTC,873915362,873847018,false,68344,0
7251826ef336e6a40cbab76142cf210c89233cdcbdba11cefa01c40f0805c8cb,988976,2020-09-29 10:44:49 UTC,10000,,false,10000,0
5c9ffc0fd301d71c22568fd305ed8cf4618b919b5b98b023231342a874765a72,988976,2020-09-29 10:44:49 UTC,135975498,135973238,false,2260,0
4ace7042b2b741f158e18d5d900b44517eda62cb4d94d1a1c322e4bfd3af3bca,988976,2020-09-29 10:44:49 UTC,4090758636,4090732930,false,25706,0
d1d115d6e6fd6bb5d259bcce8abc1441635ff0e9b57c81dc34e9916210305f60,988975,2020-09-29 10:36:36 UTC,164656217,164653257,false,2960,0
a3a457bbe334d1485211c35dd63cb9bdd1ac8044d1bb36315c24ef00917c5451,988975,2020-09-29 10:36:36 UTC,41552,39102,false,2450,0
368ff2b70b2baaf2c71839a7bf43077eb05c8d3e1ce3713a27dce843b406bbcb,988975,2020-09-29 10:36:36 UTC,98782,88782,false,10000,0
ffcd88d1bee3c1e1de0ff794cd5b0284a647e2ba8549aad909853e67288ac122,988975,2020-09-29 10:36:36 UTC,81131837876,81131835526,false,2350,0
03f6b9f106ffac9b3f87cb79ade2eaa846c63c57644aa135d3f40dbf191cf3d1,988974,2020-09-29 10:35:16 UTC,24087340387,24087330387,false,10000,0
66af387444fe86b896f1939b6216c04133a7d788b1a590b3e0ab1aa60c57bf32,988974,2020-09-29 10:35:16 UTC,21589114458,21589104458,false,10000,0
7dcadd1911b32a09ebef2c835b7785f8d9c8fcef9b1db89492063ea468fa032f,988974,2020-09-29 10:35:16 UTC,500073210,500063210,false,10000,0
2dbc8efa19640151743944ac4d581741490090fe263b24c8094bc7b74eaea60d,988974,2020-09-29 10:35:16 UTC,8743768344,8743766830,false,1514,0
a92a2f664f5d0de78ca2cd1c80545be19a18e64d50ab2a70068646aee5db5c30,988973,2020-09-29 10:33:29 UTC,120433716,120431332,false,2384,988961
0effb931d507d21ca6b0dcc60e0da3026cab4635006986f7e7df6c9acc088f83,988973,2020-09-29 10:33:29 UTC,1460433995,1460421995,false,12000,0
a45387fef9cd718ce90a88f8428896c0aa87a6cda0416821cb6a288abe6ff158,988973,2020-09-29 10:33:29 UTC,196516888,196511785,false,5103,0
0fc1a4ae6198399850d2c9bc1c0674e3033d8566f9865987a85a0b3108364367,988973,2020-09-29 10:33:29 UTC,81183247412,81183245062,false,2350,0
8711e47bf8e51f166eae1168e88f318ad1cf922009ccd3481bb2c9bf0cd77139,988972,2020-09-29 10:33:07 UTC,30000000,29997740,false,2260,0
4b95ec6aa11060b30e7c3e5fa4ebe0380cc72d29cd1492416866f5c43a2fe521,988972,2020-09-29 10:33:07 UTC,21831935396,21831925396,false,10000,0
e6628152718548332e156d29290f1ae1ffbd0b68224345136235abb424d04ddc,988972,2020-09-29 10:33:07 UTC,65772893,65764348,false,8545,0
7d429f813a4ce259fd1437a17bab82411a7635754e143048609951bb2cca5e17,988971,2020-09-29 10:30:52 UTC,81375875774,81375872744,false,3030,0
d67e846ef54ee54e20f851cc416d94f52e489964dc6bb81fc5903880680c8a3c,988971,2020-09-29 10:30:52 UTC,26202436,26194994,false,7442,988960
18bc5db4f5650bc48c4c34dbf0618b6598be254b03ccd1f6cb31f72aa8f45f9b,988971,2020-09-29 10:30:52 UTC,625461088,625386653,false,74435,988959
d714106bad1db2bc07b11a196f70a85bff57ce251648bc11dd50324c731b4238,988971,2020-09-29 10:30:52 UTC,21831945396,21831935396,false,10000,0
f247438b02a84bc1969eee36e4c0802354abda91de820cea0bb9af03b837acad,988971,2020-09-29 10:30:52 UTC,1645341150,1645289120,false,52030,988959
d3c9b600aa5d7fd95746af3db8edb03c950f07be01a44908492a2176a289a57f,988970,2020-09-29 10:29:48 UTC,3852751796,3852749272,false,2524,0
5a96448c65142c3a0c1019024886bf89320701712a89824630356a8a7bbd9ea5,988969,2020-09-29 10:28:36 UTC,221849204,221845019,false,4185,0
b87a41c6303807288fff58004d18b98c40c17cb2626dbe8d0554a7551410860f,988969,2020-09-29 10:28:36 UTC,21890990729,21890980729,false,10000,0
a0c8f0b742a77823df3ec8553f9d409f51bd2d7cea1ab69e101c8952c4e627d3,988969,2020-09-29 10:28:36 UTC,499990000,499980000,false,10000,0
07b351db88774857087c68f1a54513dd5354e670057f19057f4ee4bfe97b1cdb,988969,2020-09-29 10:28:36 UTC,81382276446,81382272736,false,3710,0
1d5d514720f1039617602d06e4b3409e1846ab48cc1acb7e4b9f00711d0cdae3,988968,2020-09-29 10:25:40 UTC,3019014953,3018906953,false,108000,0
7795a19a1f4cfb32f801d1b0bcb2fe7b7e2fc5302726613c6ea9a09b30e13459,988968,2020-09-29 10:25:40 UTC,10010158,10000000,false,10158,0
b4313a364e7203b74344676a64afa724021901e8e7f58c282a2d833eaba92329,988968,2020-09-29 10:25:40 UTC,81461251333,81461245923,false,5410,0
84a1f6a1080e673acf4a8b1b9127210c6476c7d3fd0282981615f5a069fe6ca3,988968,2020-09-29 10:25:40 UTC,81677919855,81677914445,false,5410,0
9c74c72d7f6e66bac6f109fc1462a5faf879d79b1cad311acc557e954c847b62,988968,2020-09-29 10:25:40 UTC,21891000729,21890990729,false,10000,0
ca096fbc198144b672d67f554a50245258cf943497baf7d85586026a809d8202,988967,2020-09-29 10:24:22 UTC,499986688,499976688,false,10000,0
9b8b4508f0f703eec0804e9b79ebae3439f8dbea0d872e56202b4d7502922b93,988967,2020-09-29 10:24:22 UTC,500000000,499990000,false,10000,0
758c50c3cf6e778330435ebc34926c39639c433b10169ef362c4be8e81c95187,988967,2020-09-29 10:24:22 UTC,56882298620,56882298520,false,100,988956
4a4cc1394318d39d9dbfccbf1bdbbbec8eb71735568da8e0aa96ab3675f2c32d,988967,2020-09-29 10:24:22 UTC,81708338422,81708333012,false,5410,0
a7b96c2391624cf9cd23d4b0066dd7740e97dc83e0fe1fc87bc4f167f83d6091,988967,2020-09-29 10:24:22 UTC,285394061,285325701,false,68360,0
4a182470ab525c514e32989ce1e8f3ee5b6d1f9e7bef13b611a497827deb9764,988966,2020-09-29 10:23:06 UTC,164821727,164818767,false,2960,0
237d542adaf4e3a8adf07ee84c1d843538ef10864b5191b3d6a541f2458fcbf6,988966,2020-09-29 10:23:06 UTC,2016420393,2016312393,false,108000,0
0d299a0fcdaa3874549bc620773b77474e44975ed875a65cdea4cb7f5d058d18,988966,2020-09-29 10:23:06 UTC,57175198720,57175198620,false,100,988955
b33aeb6429fbefa7bbfb6bf28824fe219c10358c5c31e8088aa74689effbccd2,988966,2020-09-29 10:23:06 UTC,499996688,499986688,false,10000,0
4729670112fbd4324ac3ee32c5179c13b812d1d0dc97867443eba8763ecb62d5,988966,2020-09-29 10:23:06 UTC,47421708,47412648,false,9060,0
d96d7dc65b511a5ddb805932804bbe9fb4ce3b7c6ef93ba67f20c25055c1b6a3,988965,2020-09-29 10:21:42 UTC,196719212,196715945,false,3267,0
20c2d422d0d04eb56a236ea596d98d567f3225769e9777aafdd9b365a8d175ee,988965,2020-09-29 10:21:42 UTC,112838926177,112838910597,false,15580,0
eee53e85bc842f94dd2763f2f243de0ca47d3ebc299ba2a644190cdc7b76f473,988964,2020-09-29 10:20:45 UTC,500006688,499996688,false,10000,0
1c75643dda76a58560d4f285d9bfe20e6dd862aff19b477bafd175803c3c32d0,988964,2020-09-29 10:20:45 UTC,167717266,167699266,false,18000,0
13bfa8adea07a3fd1bb07062f0507713d5b8fa29017c0e6ad861a4e336e2cf30,988964,2020-09-29 10:20:45 UTC,7124532081,7124529261,false,2820,0
32127877a1651066dc55013a8d0b5cf23d2b52c1704fda93dd02a2f532f9ccd7,988964,2020-09-29 10:20:45 UTC,627523526,627449091,false,74435,988953
39430079e72f5d1ae01006267d6464928db03e05830e5164cdd94aede298feb8,988964,2020-09-29 10:20:45 UTC,1004140522,1003984522,false,156000,0
254cb00e518dd4c163f8c4956e573022b069eb202816e10ffb8e9abdcad80dde,988964,2020-09-29 10:20:45 UTC,668217460880,668217458505,false,2375,988953
43cde59f3c3db83380a6a2420bef9ed433c00be4074629b6bc221c0f458019ec,988964,2020-09-29 10:20:45 UTC,1646328127,1646274097,false,54030,988953
965fd1311446ebe31ad683d346d2d40902fc38431450fcc2fcb27f9213d19028,988963,2020-09-29 10:19:18 UTC,471921840,471920840,false,1000,0
0a64317d2e6f2dde2082c5edbd35e04c67e245fd571cb1f0eeb197c1a05f0e49,988963,2020-09-29 10:19:18 UTC,10000000,9990000,false,10000,0
0fccf50a5a27b0c3a6806fb785a8047a2c8ddfa15632378e12d8c9f7488d02df,988963,2020-09-29 10:19:18 UTC,81803051484,81803047094,false,4390,0
51becb1f4f0ac8e7ebc998a3ca367ae51c8555085e38d063d1a2a46b76ff08b5,988963,2020-09-29 10:19:18 UTC,349980000,349970000,false,10000,0
a370f223b3a3084af7b27d87a1b7e0d89a8bc3d8e69eaf7e624882af328ba6a3,988961,2020-09-29 10:18:02 UTC,1000001800,999991800,false,10000,0
167c1b82b1da4d305f61a67e02b7cbdc3249625a40eb99ea9bcea1a9e6cd645b,988959,2020-09-29 10:17:05 UTC,768127962973,768127960880,false,2093,988948
2f6b780d06ae63ffe99734e268d5111fecb9a6723b946b595c6814f18023b916,988959,2020-09-29 10:17:05 UTC,82380742150,82380736740,false,5410,0
7ddf34bfc171ba33895f218d3d15b1d0b62665008f7134b6d7fd2031a3ea4a36,988959,2020-09-29 10:17:05 UTC,79444531,79434531,false,10000,0
c59ca373cb4ca6de4f851b0fe694e2c21bbb0f33efeea8937b5dc125c1516353,988959,2020-09-29 10:17:05 UTC,82149143631,82149138221,false,5410,0
e73f2cc7ceea1e23411cc95993f460c47df06f9c0daba4e372caddbd823fac9f,988959,2020-09-29 10:17:05 UTC,499998690,499988690,false,10000,0
21334fc59255142da955394378cc848b2ddd59c85616268aac9d290f92dad3c3,988959,2020-09-29 10:17:05 UTC,13023649,13013649,false,10000,0
0fde17cb6ebccda4018fcd30338793a06a239d470c4e028fb9701bbac7c75904,988959,2020-09-29 10:17:05 UTC,2820479437,2820469437,false,10000,0
2ff6e4b0a603b807c067be94769a9baf85fc41d98858e39e1c4be5504571147f,988959,2020-09-29 10:17:05 UTC,1000011800,1000001800,false,10000,0
0dc2e71f33136e06c111cbce8067a4dffb0f1f09b0803b6c59db09973b5cf66e,988959,2020-09-29 10:17:05 UTC,645416309,645316309,false,100000,0
7fde5f174fe3a1a95f861a819082d73f4ac53c6ccfff8f0e7063e3ccd70bde5a,988959,2020-09-29 10:17:05 UTC,165042895,165039935,false,2960,0
2ae9362ee27c3bbb68a01d180e2508fa268cc72a85486abf5c095355c9f40f42,988959,2020-09-29 10:17:05 UTC,122229378900,122229373490,false,5410,0
2141014df616baef65bf209ac6e758f1893a5bcb89430b471933c3e2e390a04f,988959,2020-09-29 10:17:05 UTC,85824492950,85824487540,false,5410,0
4ca1524402bb8a1f6b49ec6b6a070f7d7941e42d73edb173001d8bda5ec1db99,988959,2020-09-29 10:17:05 UTC,573640283,573638199,false,2084,988948
efd2c0737bd97c6a0238d0030ef91e01d586a3cc3c4939a8ea4c23ba281cbc5d,988959,2020-09-29 10:17:05 UTC,154607081,154604988,false,2093,988948
a182b24477c4cf8516a6d564840408fed02beeb909686b4b5b58f366e006f64b,988959,2020-09-29 10:17:05 UTC,222004127,222001167,false,2960,0
7ca597136aff067eb76d326b6d3ff4bb028365b9bb94053447adb1e771839c2f,988959,2020-09-29 10:17:05 UTC,115314700,115312250,false,2450,0
43fcd6714bdf650e8d75de1b8a81dcd497598be0df47178f1aea0f9e0b2da32d,988958,2020-09-29 10:13:02 UTC,610625463740,610625443740,false,20000,0
bb662319ecf2e902a6d6e934db9ce8243ed7885f1dcbb403497f0e6ea161395e,988958,2020-09-29 10:13:02 UTC,250,,false,250,0
c412056e8e637fe4a943bbd516f14ddfd0a6b69e8f5d4c4732f941ef569f445b,988958,2020-09-29 10:13:02 UTC,771916756877,771916754493,false,2384,988946
635359489000c747e5de1749a43750bd872341fb4cec1b08e38b1f4f65130241,988958,2020-09-29 10:13:02 UTC,182844052,182841792,false,2260,0
d34ab38a170b6ed23f10a39cdc7f7c671bccdb3b64bbe8f25981ed605b5ad13f,988958,2020-09-29 10:13:02 UTC,35248256584,35248246584,false,10000,0
bd85b7731cf9fe2e74acb7a25a1d7c8a89bc0fc7432720fabe7a9f1d69fdf8c3,988954,2020-09-29 10:12:00 UTC,2868420580,2868414702,false,5878,988943
0365c8ec4e1166ea93552b4afd78ebc9cbc375365fac3409cf39991ad8cf6db6,988954,2020-09-29 10:12:00 UTC,500008690,499998690,false,10000,0
9cf4962266fdf19892255d9ee513626d5748d1e07832c8748173e98bf3ca1fad,988952,2020-09-29 10:11:08 UTC,810625483740,810625463740,false,20000,0
a433de141af71e1fa77391e592f3fb46a9e4bec803b646f20ded762470cd182e,988950,2020-09-29 10:10:27 UTC,145410783,145390514,false,20269,0
b710159eadbecb308a2f754fdf7fbbf1f61de3bcc14c1b1e7db0997d67b68d40,988950,2020-09-29 10:10:27 UTC,196993134,196989867,false,3267,0
bf365fe812290325d303d910019432895bf96b8e58385a3193f7592f89fc6fe9,988950,2020-09-29 10:10:27 UTC,492572966,492571046,false,1920,0
1ff8ecd68c237a8e623d9b2e65a0d091a64fa894be70aaaf7bd032199642124d,988950,2020-09-29 10:10:27 UTC,1647425162,1647372055,false,53107,988939
075720b9c8dcfe1cdb7f51e5704616c03bfbc0166b4be6e30bb83ca6415dfe9b,988950,2020-09-29 10:10:27 UTC,629820049,629745614,false,74435,988936
d16d52c513381b98d66fcf60cfb2f820167e4f40af36e1ffe60d6c404dc19a17,988950,2020-09-29 10:10:27 UTC,250,,false,250,0
cb0f437caf5f259196176f56b0cb4c0ddeeae901f5c534026c1cd1c1628e8580,988949,2020-09-29 10:08:28 UTC,657516309,657416309,false,100000,0
c15a1f8dc91d07da2ddc57f67271ff7958df76a9e1f24b5203a81104e40d37b6,988949,2020-09-29 10:08:28 UTC,781644779600,781644776926,false,2674,988938
e17619dcaa41e2dd5ae30872f202ac2c87f1930e88a04b6846eb122fd9abb900,988949,2020-09-29 10:08:28 UTC,69288975458,69288970508,false,4950,0
01802a1e88cd759bcca2aa036b9509c3ce6215b94b6ae75516bb767e4818fad7,988948,2020-09-29 10:07:27 UTC,98630192,98627932,false,2260,0
ac218fd29160e72041dfde3266b412439110d9ce80ebbe91ff62dbfc403c6da0,988948,2020-09-29 10:07:27 UTC,636163217,636094857,false,68360,0
4d924f881ad4a443a6b465127c2fc026969e725b6672031c1d5c8596193438b8,988948,2020-09-29 10:07:27 UTC,222155960,222153000,false,2960,0
dfc5603a2b3063e96f7e62149eddb153fafb1f1ab05767532caca6ef9ba06822,988948,2020-09-29 10:07:27 UTC,241063035833,241063025833,false,10000,0
a936ef296c0edeef3f8b1eb05b7d7055facf26c97eacbeb675d36cfc521e6e3a,988948,2020-09-29 10:07:27 UTC,3000300825,3000290825,false,10000,0
e2c17bb20c872eac3468bdcc23dbbd6be5973eff4df73fe61c09fb7e127ff57e,988948,2020-09-29 10:07:27 UTC,165193457,165190497,false,2960,0
13286bfd20be212e9de0d25ca77b9a363edf0758d51b08b7b521d07608886f9a,988948,2020-09-29 10:07:27 UTC,237542562,237528164,false,14398,988936
e309b06492b6fa57c1ec616faeb948766838f967ffaa5c886d3870f94a819e02,988948,2020-09-29 10:07:27 UTC,2000106119,2000096119,false,10000,0
359c353186e4d4841a0f75b3c3a7e291bc8816bab571be01825c942767f3af78,988948,2020-09-29 10:07:27 UTC,1000062215,1000052215,false,10000,0
eb161ada048b1b057abd40e251b8970cf2264d6978c2300c0ac55d1a8fade6fc,988948,2020-09-29 10:07:27 UTC,181785781,181783688,false,2093,988937
385e52f865d56cbeaa6e0573c3adde97bf166b55f0cbe00e0f88719a4196fa56,988948,2020-09-29 10:07:27 UTC,8487650903,8487646903,false,4000,0
3577d2588b2fd987c2c4760e121742ffe48de34bcfa57083e2dc2861c2275ff0,988947,2020-09-29 10:03:47 UTC,88710000,88690000,false,20000,0
2ab540accea652c3ed49a01168d8023bd1f786013ab5de764f39c5237ed4f8e3,988947,2020-09-29 10:03:47 UTC,1003129986,1002955986,false,174000,0
5ba6979908e09d8a915c211a86e127040e5b1417117511dddb94b2be1a3023be,988947,2020-09-29 10:03:47 UTC,9482544253,9482524253,false,20000,0
94c8a6892213e4f9061158ba0190453cdaac33b6883e177794707503be3e34d9,988947,2020-09-29 10:03:47 UTC,197181837,197178877,false,2960,0
c498d45f6a2668161a09d8764146c0f6bef557eb76b17924a2c8a80c41ee5fab,988947,2020-09-29 10:03:47 UTC,65802947,65794402,false,8545,0
1f8315b7c37c83265e44f46e5070fc0fa65e923f929c082cb08b45f327eaed17,988946,2020-09-29 10:01:52 UTC,129854873,129851618,false,3255,988934
e2a40974f983aa742bc8260d1911b15408d79c4839643a68779549c35f1c76b9,988945,2020-09-29 10:00:55 UTC,794778376084,794778374000,false,2084,988934
83698123a11817029347c004dfd5b1be9ff4acf56cf0e4938ebcae45e6f0ec67,988945,2020-09-29 10:00:55 UTC,4999500000,4999480000,false,20000,0
3a3dbc1c49c0ed95558dd686ac2ac29ca2aceeabaabc44838be371371c0061ad,988945,2020-09-29 10:00:55 UTC,165357232,165354272,false,2960,0
a41f11976e92a589f5c1020344b12ee343f8ee478e1111071326bc8279724907,988945,2020-09-29 10:00:55 UTC,1648440404,1648388383,false,52021,988934
0e2a256c620274c0a7788a3897914a1c99a06241d2b4ed6115f74530f4acba41,988945,2020-09-29 10:00:55 UTC,6529479189,6529472148,false,7041,988934
0b24ae7fb1545ea41a1dc0222760665e17d705bd36fd4c35dfb697ebf90e4f6d,988944,2020-09-29 09:59:46 UTC,20323645924,20323635924,false,10000,0
9ce7d5bf293cb4606a82498182c5a2d3569d0248434884c3823fde725594e976,988942,2020-09-29 09:57:47 UTC,239542541,239532541,false,10000,0
4f05200c3bb25656e8f13f254cf0d96f37e47c8f69212b1ce59ed30e93da8dbe,988942,2020-09-29 09:57:47 UTC,222412070,222408803,false,3267,0
a95fb6bf62a7a5cc196c398b35fe1137550027bfac6725a1b3b8ef19e6eba5da,988942,2020-09-29 09:57:47 UTC,683058309,682958309,false,100000,0
85f04a4b330aeea204cc0baecb203626cd230a88ef28af48365f33999973a79b,988942,2020-09-29 09:57:47 UTC,321212586,321167826,false,44760,988940
d0a8df48ec9f70bad19fb46e62a17546da2993caaa462eea992cb7eba7b04338,988942,2020-09-29 09:57:47 UTC,65833263,65824718,false,8545,0
bf846b25156681154a80bb21d855ea6a77e18a6a57a01994668eff2ab3e0df9c,988942,2020-09-29 09:57:47 UTC,501556809,501286809,false,270000,0
a6337b400c67312a56b52446120d88350e0914809f2fef0ea3dbdd54c3bea3a1,988942,2020-09-29 09:57:47 UTC,10000,,false,10000,0
e892b4e541fe7ff05d878515846d829e39505e91edf63147722c239dcfceba5e,988942,2020-09-29 09:57:47 UTC,500054077,500051984,false,2093,988930
0cd1b18d44518dcb7154c418d70ddf5d51166aa03b875434090ff066a9782e1a,988941,2020-09-29 09:57:07 UTC,21013203153,21013193153,false,10000,0
12a3d20f0176617d7ceb2254d9ebd437423255e78b1062a7b73e0ff9d618fe29,988940,2020-09-29 09:56:11 UTC,65873417,65864872,false,8545,0
23f28e8c59c5d816674a1e07605437a3652f5e8dfa5b7ed697ad2cbba34af181,988937,2020-09-29 09:54:39 UTC,21013213153,21013203153,false,10000,0
be02ac6b3d66e2b46b63a2bf8530601ebecd7ff87ebb549821c16a3c53766715,988937,2020-09-29 09:54:39 UTC,65037,62587,false,2450,0
bf69bfd19c25e5e1e555c6bfa2995dbf2bb8630382d3b81d23865ea72d01fa85,988937,2020-09-29 09:54:39 UTC,83051044,83048784,false,2260,0
3578e92ab3e67b429c83b2885a25da99ef0b8bd5720d4065a21b839dba2aa220,988937,2020-09-29 09:54:39 UTC,197532304,197527813,false,4491,0
88db68436dff159a6ef984540a9db89c1e4b381b59e6dd1247ce23d76b4b07f0,988937,2020-09-29 09:54:39 UTC,149075440442,149075424692,false,15750,0
f3bfcdb1eaa5771729a407e779fac4b4b5613035de8b8956f93c239b464530aa,988936,2020-09-29 09:52:00 UTC,693158309,693058309,false,100000,0
385a845c0adc37bfd145c98c8c80af227bf2268a02111d5829ced465411b8822,988936,2020-09-29 09:52:00 UTC,57180413190,57180413090,false,100,988925
f3b0bf24e161b9e45ef2de48e27c07826ef990c001404bf7335998b0379c9d0d,988936,2020-09-29 09:52:00 UTC,499982260,499972260,false,10000,0
0700440bc085133029313ea52b404b6af320faab1aba79c447f0a0681313386d,988936,2020-09-29 09:52:00 UTC,1649466658,1649417294,false,49364,988924
f71142b6c3a31673ec96a86acd1a194743332111c7a86e8ad13e53b86f6de759,988935,2020-09-29 09:50:04 UTC,201225819,201223726,false,2093,988923
927ff0a8e9a6c5e8118deb1ca6452d6ff9d377e75e93789fc68f0191f6ab69dd,988934,2020-09-29 09:49:20 UTC,29581967,29579707,false,2260,0
b5d896750cc53926cd817927f1e6302f2b86ef9f222aa22c422e95d7c642e546,988934,2020-09-29 09:49:20 UTC,143112851,143032851,false,80000,0
527efa296edf002aca98c79b3dd2e70b7595a7c6b0c6a4f182c5cb88c6b79746,988934,2020-09-29 09:49:20 UTC,229555777,229553517,false,2260,0
3bd200fcfd91a6882075b7894383a47761bf539ad6452c0b03f6a4bf317fa548,988934,2020-09-29 09:49:20 UTC,500064077,500054077,false,10000,0
5c6676b0c1df763a7d5bd9c941687bb3a8eeeeccc76bc63f59ee83bc3b4f6eca,988934,2020-09-29 09:49:20 UTC,499992260,499982260,false,10000,0
09ce674ab00a0dff6a0588b6c7b4f000b631a4c2371e8c82174d02349f629565,988934,2020-09-29 09:49:20 UTC,200928,181248,false,19680,0
c8fe27037967c70d6146b87c0a90ad6f163e1d2b35993a525dd244250ff2fc8d,988932,2020-09-29 09:46:12 UTC,2397097220,2397094960,false,2260,0
35fb224cbadd76cf0255fd1de663c60ee1d704f5eec2660657532c5a768422ff,988932,2020-09-29 09:46:12 UTC,165880139,165874730,false,5409,0
81672e72b66fc22183d328fe7c20d89059c233163e092e200d04d7ff341abc7d,988930,2020-09-29 09:45:28 UTC,11328654559,11327291669,false,1362890,0
66abceb949fc117d5f4bddb08208d36b4fe596afb4f1aac089625c695016ae2e,988930,2020-09-29 09:45:28 UTC,500002260,499992260,false,10000,0
bad8ac1c275ac9ff188768e8637244046686b01c4c6aa979dc9220bf236628dc,988928,2020-09-29 09:44:47 UTC,9199897907,9199894549,false,3358,988915
6d146a2b6a18a6361449afa67acebe364d042f1fffc4ecd162d325f0e1de0571,988927,2020-09-29 09:44:13 UTC,67705483,67699483,false,6000,0
823b05d12a94a1ea422f3462b2dd2416e37213eab0f4141986eab922f8a67669,988924,2020-09-29 09:41:08 UTC,30043060,30042060,false,1000,0
52d6e828bf34af01a4220c55f46b08a7ea0f25a429ede87a18287fe284110365,988924,2020-09-29 09:41:08 UTC,1650523437,1650467921,false,55516,988913
bd00cd826d47b423c22953f0a0306de933b7ed2794c7cb9a7983ff101e4a0fda,988923,2020-09-29 09:39:04 UTC,222770200,222766015,false,4185,0
486bac4336438d2476665e396597ea7040892a14e0c085dda415608f2fd2d973,988922,2020-09-29 09:38:26 UTC,35229671,35222519,false,7152,988910
ef29e5f34f4d8bd051fd2d37ef3c8c8a09898714d30a02690b55586f1cf41df5,988922,2020-09-29 09:38:26 UTC,197801033,197797460,false,3573,0
fa35d611d1536a86a3515194f0addc4bce1a3a8e5757c6c49401a8b640b44dc4,988922,2020-09-29 09:38:26 UTC,2000870285,2000860285,false,10000,0
70c8a382f97363b54883f8b2261580853ac62f7d17cd4297e32ca092426e3f98,988921,2020-09-29 09:37:14 UTC,500074077,500064077,false,10000,0
b71cf9942920c6e2d3899bcef6e3279c5bfdee56bf9ad0f8ff11ebd234ba8ede,988921,2020-09-29 09:37:14 UTC,12324925056,12324725056,false,200000,0
4e283ff106f2d402100d760e5e910f41c194a94f1e2f112548f1cba015ed0508,988921,2020-09-29 09:37:14 UTC,10000,,false,10000,0
137ce271ab8d346a12b319791a07a73f3b07038ceae7b421d74631fc47359031,988921,2020-09-29 09:37:14 UTC,799777878177,799777876084,false,2093,988885
6b419957c135c1e3c2e30b2ee02ce52c10eba1bc1df27902a7fa291eb01cdeed,988921,2020-09-29 09:37:14 UTC,276221466,276219206,false,2260,0
1f663a52782c1f66ec7acd16669346122e8396825272060287b21df9e1acac01,988921,2020-09-29 09:37:14 UTC,6766788910,6766786990,false,1920,0
3d85958a0347b81c355106bff0ad4d0c7d42049aeea7d878a4e41f092ac6e719,988921,2020-09-29 09:37:14 UTC,495994884,495926524,false,68360,0
6e2212a106fc540cca73942a2be7edfb82225925ce558cd818ece698a0aa0422,988921,2020-09-29 09:37:14 UTC,250,,false,250,0
6daed8a27c198f638538b043e6439e555c9091a3896ab6fa550d4a8c87b03263,988921,2020-09-29 09:37:14 UTC,500389700,500379700,false,10000,0
7336a36142abe4dcc40a8202775e0432b8e232983bb85fbc962e1cbe60d05e3f,988921,2020-09-29 09:37:14 UTC,1651427470,1651375431,false,52039,988910
a663a57362143f7e40ff80641181c2f7305141ef587f7476e79234cd531df5b7,988921,2020-09-29 09:37:14 UTC,65918857,65910312,false,8545,0
528fd7b0512ef9b6ee712c43a2b281558831ffa3eed75f77f44f5fe5f581d219,988921,2020-09-29 09:37:14 UTC,6766786990,6766784454,false,2536,0
884664dea41a65fc84c60010cf153278bf833cac7bae751ce5f03c52caa1d1ec,988921,2020-09-29 09:37:14 UTC,198017963,198015003,false,2960,0
dfa5470ba76f49020cab5740ae2eab1ecd666151b65d908bad0c1a402d13004b,988921,2020-09-29 09:37:14 UTC,100000000,99997570,false,2430,0
4fa2fcc95573bfb3025ff031577acfcff80dd75b38a097c16956c4bf7f4f7370,988921,2020-09-29 09:37:14 UTC,223119301,223115116,false,4185,0
d5a0da4c99c58ee55097a58d03cc1b29075ad158bb7e083740d203d702e46406,988921,2020-09-29 09:37:14 UTC,166066457,166063497,false,2960,0
2203387e88bc451df6ce0728e86d0ba3d56a4fbca489839347b9bb7e9c72e426,988921,2020-09-29 09:37:14 UTC,66085074,66076529,false,8545,0
8f26cdfa3e7467553145d784ae648c1afacdf24e9b27ddec5bebdaf60682341a,988920,2020-09-29 09:29:02 UTC,19152137734,19152135474,false,2260,0
d03a85773be53392acb7441d0b9e3114171906318765568cf7c3c33634d682f9,988920,2020-09-29 09:29:02 UTC,66142261,66133716,false,8545,0
a885eae2d5b337ea740b5522a3b91a0b905fc961d505c8b773fa7b233d941da2,988920,2020-09-29 09:29:02 UTC,12959463322,12959461062,false,2260,0
39e984f1be25b7525b894844cf121540925111d1fe9f51b2da3e1c80c5e4a714,988919,2020-09-29 09:28:02 UTC,19152139654,19152137734,false,1920,0
2a36accb760281f711a99638656ce229405e05caa8452ddade00efe424fe4c61,988918,2020-09-29 09:27:22 UTC,15036,5036,false,10000,0
7d9bb78d2963369895fdb052fd783b0aef68f1818c551d7a41faa170439e020a,988917,2020-09-29 09:27:06 UTC,166685975,166679954,false,6021,0
105293cf242f11903d0dddc43e38542918adf4b644538185aaab05ef94c8bef6,988915,2020-09-29 09:25:17 UTC,802945080253,802945078177,false,2076,988894
c3c270a6e8aedee77ddb83dd40c72ccc799e2a16403623c78eca7ad936b1ee58,988914,2020-09-29 09:21:59 UTC,322757359,322755099,false,2260,0
ac3cd30e0676039ac1a5e4e1e2430ae923554c52676a9bbb5eeac6f71f8d249f,988914,2020-09-29 09:21:59 UTC,57281530175,57281530075,false,100,988903
5bbdff3cc43b411636fd3b29d2233dacd5c4ce8e81e342fa405c785412af0ab7,988914,2020-09-29 09:21:59 UTC,6619940,6615318,false,4622,988901
bb5a1b5488425dcb253e574ee3ff281cf06a633b4f097c00e7cc1400e08c7e0b,988914,2020-09-29 09:21:59 UTC,229909581,229907497,false,2084,988903
97ac33383b86f9dd5cfd7ce1be422bc0c1583dbee16de7eb9481852909308091,988914,2020-09-29 09:21:59 UTC,113779258,113760388,false,18870,0
3eb41f16ba29cd6d46db4f0ab848d1bc5ba006fca6c4bb65b8b5cd53b5721e5c,988913,2020-09-29 09:21:19 UTC,500403734,500393734,false,10000,0
4a06c4be9ada83db318404efe8d841b3ea108b26146791312492a3de7a9e2433,988912,2020-09-29 09:20:07 UTC,130362096583,130362081003,false,15580,0
e30a1a4d0bf39d71cc8a33200cdd69cd832816fc621ffc9de4eda023e7a861d5,988912,2020-09-29 09:20:07 UTC,1652206586,1652162674,false,43912,988901
a713a49d7f7c9852a98e8ceb53482473bd4867329aa38883f5516d3969ab209d,988912,2020-09-29 09:20:07 UTC,34550074,34549074,false,1000,0
68d591b199ab0a15763e15ae0a61c17a70db928c9878aa17abc5e4a967a4188b,988912,2020-09-29 09:20:07 UTC,83156465,83146865,false,9600,0
889c32bec480442b4fbf83a920f4cfb0a89f3f9fe2314e9ce8ba3ddc78f361b6,988912,2020-09-29 09:20:07 UTC,73000621,72990000,false,10621,988897
cf02c6f3b328cb69790cdf0c42801b634669ab99ac3dbf2e162e87590a1d7f34,988912,2020-09-29 09:20:07 UTC,223385973,223382094,false,3879,0
f13a019ad57d22d86c85ff899206c4f9d909c46ca539b3be9fde704227078edc,988912,2020-09-29 09:20:07 UTC,250,,false,250,0
18816b0a9edb09e18ac7c8ef2699d113a5557ceb17d271dc3b6cbd0d287704cb,988912,2020-09-29 09:20:07 UTC,3789418376,3789416283,false,2093,988809
1c2a2a7df581365061dfdd969fe3be5a1eb8680a038e79a2793d16932cd8a1b1,988911,2020-09-29 09:18:35 UTC,164657050,164642950,false,14100,0
60f8534eff01fe2497e29dee5228cb3394e54874e72f5e9378b82ed542177352,988911,2020-09-29 09:18:35 UTC,112840396,112836656,false,3740,0
4a460bed4b5d9ee09b953e77f8bead26791dd9cc94f37dbc9cb0b6f1a7558aae,988911,2020-09-29 09:18:35 UTC,101603288,101593288,false,10000,0
32dfec6f86ca9f59d7cd25bdcb388fe610e048953b3b171574f9113af9f17d8f,988911,2020-09-29 09:18:35 UTC,12003545,11991545,false,12000,0
31a0f55b1f590de6c109e99c6395807a1c39561e379c11ee93133fb14b1a7a2d,988911,2020-09-29 09:18:35 UTC,6332748580,6332744080,false,4500,0
bb9b1732d0191efc7de15a39a4a2fbb9c940c9396cef28edc2799ec47c28a911,988911,2020-09-29 09:18:35 UTC,810944582346,810944580253,false,2093,988899
8a07d41304d352d69619548acced992cf16bffb9d0395570a8c08bf57139e501,988911,2020-09-29 09:18:35 UTC,10000,,false,10000,0
108f68387e33d838c19f790331828cd5bda25080e74077df162c526dea8ae0fa,988909,2020-09-29 09:15:53 UTC,503954432,503944432,false,10000,0
5da9c61e8e6fbe8c5818914228bdd029f29f6845f39d1f7ad239c135f16e73b4,988909,2020-09-29 09:15:53 UTC,2531071480,2531069220,false,2260,0
f7a8e4eb18c2f144a07056ef08a0a950885cdb95cfe053813bf5f0642e3a3c08,988909,2020-09-29 09:15:53 UTC,198417547,198413056,false,4491,0
320ed338320065e0dec4eb6d62ccf8e04a5930b1997d501d1f50a6b9982e5877,988909,2020-09-29 09:15:53 UTC,811036134777,811036132684,false,2093,988898
0c8cb59166f9763c3e31c2ebbc531b4c14e0e914337f7b8e4175ad11ad4b0da2,988908,2020-09-29 09:13:48 UTC,831973899,831971449,false,2450,0
9f1e1e2a95e0717b2733aa661157f3b0a9319c791f737a477753ed4839d14d52,988908,2020-09-29 09:13:48 UTC,20021998,20011998,false,10000,0
83060ce81169d336a919c9c8e24bdfd1a3b957f2ba2b20b32fcf8f4d49cf8067,988908,2020-09-29 09:13:48 UTC,369378395,369376135,false,2260,0
6becb709acbffd6b596ece18e2d42568e1805e964befe21b956babbb4f735e4b,988908,2020-09-29 09:13:48 UTC,1153501746,1153433386,false,68360,0
3083be9341c437a58c4f5736783267a0348bd56cab77370748174cbd1a86eb70,988907,2020-09-29 09:12:03 UTC,900770280,900768020,false,2260,0
8e0c9ead2f2e90eb95cf250baa76cbe9e950c9e9cd3d76e798d04b8b750ce2d4,988907,2020-09-29 09:12:03 UTC,415999431,415997171,false,2260,0
07e28c4f2b98da67a18f413b49604ebea53611eeebdc4aeb80f0e5fc804f7474,988907,2020-09-29 09:12:03 UTC,7910,5990,false,1920,0
f35c38810c1854fb8b7c21781424fefc3830698db3d9319ed746ec86704b7107,988906,2020-09-29 09:11:02 UTC,248725633,248723373,false,2260,0
0b8ee2caa217d180f9e513a7dff1b9bb35f494d444c00c5079233104304a415e,988906,2020-09-29 09:11:02 UTC,499281258,499271258,false,10000,0
6d5eb66c2142e3fd007bb07448ab699101ad152a7b041c2a5b268b67547b7c04,988906,2020-09-29 09:11:02 UTC,1653198445,1653148158,false,50287,988894
21314b2f8a4410f966caf68364e647abca3b978077064a1988cde110ade5cd48,988906,2020-09-29 09:11:02 UTC,14858724,14852846,false,5878,988895
4dbc5cf14c89434982419445b41ffedd72cb3644b4cc247ab57f0e24b0a9f2c2,988906,2020-09-29 09:11:02 UTC,1494555,1452555,false,42000,0
0bc3abaed8c0c9e503aac1336789a2bba4749900486d0049c1fbf15fc05824ef,988906,2020-09-29 09:11:02 UTC,1725626,1719626,false,6000,0
ef19a9752bca6eafd03805b907d0b2c5e6529895f872c7b340e94a5aa735cdb4,988904,2020-09-29 09:08:48 UTC,13935080,13925425,false,9655,988838
f89b4abea8188de78e87fde42722ad3e7f7a2980e566970ad339ac798eb8788b,988903,2020-09-29 09:07:44 UTC,48022576,48017376,false,5200,0
442dea5e74dc051e8162e7dfbf420f634f176018905a2d39aa394966ef070b15,988903,2020-09-29 09:07:44 UTC,348729373,348725633,false,3740,0
e02725ac781aeef3455c5fde1eddf2b001d09e2b20e96867ab78dd8f9efa3b14,988903,2020-09-29 09:07:44 UTC,57319356123,57319356023,false,100,988892
1e361c9163e62988dd95acba1fd99af66019dc0171be0fca1808dc8cf8ff5009,988903,2020-09-29 09:07:44 UTC,2000880285,2000870285,false,10000,0
51596b4de37c95068b93b1cfc65658592b535e1c48817d69f5ff83d9e060f3e6,988901,2020-09-29 09:06:13 UTC,1000043648,1000033648,false,10000,0
24dd8102f9f544e3f7ba17527212be978cc411c51ec2c31ff10065eb62e6c5aa,988901,2020-09-29 09:06:13 UTC,462650621,462648361,false,2260,0
e49e1d0e09b30cd263a874b5bb643c1c80c562944d555f5a1c1b12648b639bec,988901,2020-09-29 09:06:13 UTC,166874023,166870756,false,3267,0
5b815096c755627cc0839d9bf68fc6bf5354eb0c847ad3f1f01c47ea3a8197c6,988900,2020-09-29 09:05:28 UTC,811067504970,811067502877,false,2093,988809
5009d0f8d2d8d24e382fd598fb1904057d3363d38c52ff2fb123e750c7489934,988900,2020-09-29 09:05:28 UTC,509109566,509107306,false,2260,0
d8d3d27b5134a10a4ab4cde8bf2b44af227987a645dd6e23dd840a8448817f3b,988900,2020-09-29 09:05:28 UTC,59087028,59083288,false,3740,0
36fc609362da5698777e4b59d16b2e168643a45db03dd98e4c70b13a1b9825bf,988899,2020-09-29 09:04:51 UTC,239351286042,239351276042,false,10000,0
56e5f6a8d9aa45039c11b91bce3c71174773bbc0d492bb0ae60dc7b4e913d865,988899,2020-09-29 09:04:51 UTC,3000310825,3000300825,false,10000,0
02fba6b2cba2b04ed5d16541d7efa3b491697efecb449bdc5c3d321ccd9a5512,988899,2020-09-29 09:04:51 UTC,7292172,7286952,false,5220,0
ff0c149108df0e651727fe373d5e7ace19f769023cdaace3a8a350642ccd8a3a,988899,2020-09-29 09:04:51 UTC,20519066282,20519056282,false,10000,0
c6d8f908a25a10b54a5d5d5bae6e50942b79aa7e6ed2817652c7b57bd60f8c62,988899,2020-09-29 09:04:51 UTC,2000150993,2000140993,false,10000,0
4f134eb2a0da448dc4455dd3445b8a6e80a361cfe203e3187bd877a28a005188,988898,2020-09-29 09:03:35 UTC,20782240356,20782230356,false,10000,0
74983d9d45287b6e3be87922dd8d1ede5341548d214e7d8132a1c737fab2d0a3,988896,2020-09-29 09:02:34 UTC,50283731,50282731,false,1000,0
57c4c5edd824185b7e7844d433a8eb9b68832a70ddb825f4de1ba64604702ad6,988896,2020-09-29 09:02:34 UTC,9095794606,9095777606,false,17000,0
71f74a7f1fd5613832b3d26ec3c19bbeb1bb9c97f2a2eb2653d07992b8169566,988895,2020-09-29 09:01:22 UTC,931403911,931400946,false,2965,988883
dc9c50ceb089e9e23ab0110f9a4ae507d5f28a8672734096642e1e360bcbbff6,988895,2020-09-29 09:01:22 UTC,250,,false,250,0
e6cbfbf4540bc4d1bec63ab3508b3b60f8b967c30e0fb654b78ae0fbe0ace27d,988894,2020-09-29 09:00:50 UTC,157014905,157012521,false,2384,988883
7aa1156a93707cb24968f2c9b1069b55a17f1520568b4ed118c30940ec656c08,988894,2020-09-29 09:00:50 UTC,20127400,20109217,false,18183,988883
bac73aa52971f3dfd0f858cfd5711a888fd8f837ced08b3573d816a419f1fd6b,988894,2020-09-29 09:00:50 UTC,1654256909,1654210365,false,46544,988883
233444158272f97827484370fdcf0e0ca1585b454de62db8b51769a1069c8f80,988894,2020-09-29 09:00:50 UTC,7666,6616,false,1050,0
ffc07afb1e1e979dcf41d790282233cadd7cc3c6247397a75c9fa47883d39856,988894,2020-09-29 09:00:50 UTC,10000,,false,10000,0
cc5f50392c071693e00ae9b04e0aef161c349949ca5245b47b2e38c45030fc5e,988894,2020-09-29 09:00:50 UTC,20782250356,20782240356,false,10000,0
b194982226d2054e164feebf4154901b0bf31d1955fc6e6ec4215174a60ca5b1,988894,2020-09-29 09:00:50 UTC,224037722,224031089,false,6633,0
52b3f389ec645d9706661f2b840f90e949980f31dda76e45a9045a31c213fa2a,988893,2020-09-29 08:59:34 UTC,500023620,500013620,false,10000,0
c13a0a8f4b4580ff55459c405cc91519fe5a850584ff9d3affe321ea37743084,988892,2020-09-29 08:59:17 UTC,499980000,499970000,false,10000,0
5d26205f7d76d5742c737c6ffd0f0b7f3281c50f4d02dce4da5e27818c58aa50,988892,2020-09-29 08:59:17 UTC,250,,false,250,0
1b4122c8c7eefa35211cd4fd7879685f7fd780b4b435ce70b385d1cafcef4376,988892,2020-09-29 08:59:17 UTC,250,,false,250,0
c10707a4391b8bd849646541727ae68ad62cd21b64d890f9db651c1a20f6d6f2,988890,2020-09-29 08:57:20 UTC,250,,false,250,0
65c8a3fb1019ac814fcae2cdb0e4df012938fc2934f1053363c705853d2e2896,988889,2020-09-29 08:56:47 UTC,300000000,299994000,false,6000,0
54b10115cbe7d9c847557c511f0739881be057d67755b31e8ebee6dae95a16e7,988889,2020-09-29 08:56:47 UTC,2665186740,2665184480,false,2260,0
6f437ad4425f5de1917d87944aae940c4d1c50461be047d00587df091948a286,988889,2020-09-29 08:56:47 UTC,198577581,198574621,false,2960,0
4d887210475ab3cbaa2ccf70f3e6a6d86219deddef0cf0b238fb9bb920894229,988889,2020-09-29 08:56:47 UTC,555815349,555813089,false,2260,0
dd29a2f41ee59dfb642b8bd59fea7f3fb9a8b6fc5fb30d113e7fb5e9cc6e1383,988889,2020-09-29 08:56:47 UTC,310680797,310612437,false,68360,0
35fe212714501e4f8263191b239f5b0a44247468a3e1c82baf37444ee6fb593a,988889,2020-09-29 08:56:47 UTC,44798,38798,false,6000,0
d749f266d73a5cd7b3bafb9618311110aeb157c50e4bcbfba71cd37a77509a8d,988888,2020-09-29 08:54:04 UTC,1008563578,1008463578,false,100000,0
e230c6d2709e1372ad54f64ab8383bd73b83f110f4f1b8fa3d2cc58f3beee2f5,988888,2020-09-29 08:54:04 UTC,9689247553,9689237553,false,10000,0
f69807222e691ece1332b245ffbbcb3801cd3640ce07b10c1fad85ff7d993c64,988887,2020-09-29 08:53:28 UTC,499990000,499980000,false,10000,0
6d71a8f982510328850a23526a76d8edc75da25c6ddb3f7de6a93e5d3e95796d,988885,2020-09-29 08:51:15 UTC,500000000,499990000,false,10000,0
8e3ad42e2b6fbf4988a3fd2f07f82cf99ad916b0314cfc4072435e82544227e6,988885,2020-09-29 08:51:15 UTC,250,,false,250,0
32d773a7bd84bc5a5b6bb7ea31cb1fecca296e672d9352ce575cd06573f44d10,988885,2020-09-29 08:51:15 UTC,82789189935,82789187585,false,2350,0
a0e020f7535fd8c69c532bba0bb14ae97a477483cb786efe48bb31cd43a2f974,988885,2020-09-29 08:51:15 UTC,221466288563,221466268103,false,20460,0
c2965576c48088d6e91d3a24c25f69fe4d5d4a8460d274aa324cd14f1d41c475,988885,2020-09-29 08:51:15 UTC,167039294,167036334,false,2960,0
7b62aca6f76e6c5ee80890f61ec999474a14d089682ac33f5bcbeebb60b0948f,988885,2020-09-29 08:51:15 UTC,1655578564,1655527081,false,51483,988802
d62076c28f883328dc267c270e35af94bc9aedc0e1190223f1a0ba6a1109a0f0,988882,2020-09-29 08:47:38 UTC,934622577,934118029,false,504548,0
360bb2540cedb10c9a08fef8993a4d50a90d53b1bb6aef6a0a995992f9d325b8,988882,2020-09-29 08:47:38 UTC,499990000,499980000,false,10000,0
ae582f6b4f0198226f288d1e711efd9e9ca18dd96936cff152456c5bd29a512e,988882,2020-09-29 08:47:38 UTC,250,,false,250,0
0f86b2ab3efd17abb2ab1f3d97e94958ade98e00d2b5a1c21d640c6bdd539671,988882,2020-09-29 08:47:38 UTC,224310420,224306847,false,3573,0
178f8061b0912ee709e57d821e37c2b161f2a986946fe5c102a71953cc7cb9d3,988882,2020-09-29 08:47:38 UTC,63991427,63990281,false,1146,0
6c441e907d5cbcfc9c2200edb3710af067f3ed8bf533f575510917e54b7161c3,988881,2020-09-29 08:46:04 UTC,198912694,198908509,false,4185,0
872443b93ff87f8b9ec9fbe0f929fa8dbf640167fe519e982e29b412dcae5ed7,988880,2020-09-29 08:45:32 UTC,66521560,66513015,false,8545,0
38be5a5191b6efa71ce6338a95572283bc1deb66096b40fc710e134526ded6d8,988880,2020-09-29 08:45:32 UTC,500000000,499990000,false,10000,0
ef2239d5bd99a6a44f40349829ee9b5ae0f44ab032f870738570f50c421573b8,988880,2020-09-29 08:45:32 UTC,1007068,1001207,false,5861,988869
9297838a1df30b07bee5b1da808b89617f7bf138221328b40f08289e35604619,988880,2020-09-29 08:45:32 UTC,1080010000,1080000000,false,10000,0
b4532e5339c1ad6022776935b8e34d03efd5e5dbd8861bca90ddae754fce25e6,988878,2020-09-29 08:43:47 UTC,811108007054,811108004970,false,2084,988867
dc96975ac103d766cd0e98e7fcefdfd90e610960b36bac8f5b85751d3dfe2403,988878,2020-09-29 08:43:47 UTC,167477841,167472738,false,5103,0
6f3ac0bc920defe20cb800a3347463f13ec933dd4408281b39c1026fc452ceaf,988878,2020-09-29 08:43:47 UTC,66561413,66552868,false,8545,0
4918c3346b3df65814d1eff98a947875fa7bc11076cc5d2e022304ce710b5298,988878,2020-09-29 08:43:47 UTC,2876408,2873050,false,3358,988867
5dd2e65ac7b4ecc628b969ca820190958b014589fcb9ec85ad6deff0f511bf29,988877,2020-09-29 08:41:52 UTC,25505812053,25505796473,false,15580,0
8b5b096b73ee8a67e6fd14354444c705900863985c969f865b14bfb1c876769a,988876,2020-09-29 08:41:14 UTC,1656550361,1656501493,false,48868,988865
00c05481e9431eb5771ad8c367f45129be3ee05f6f0a3418fbec2924f979a6ec,988876,2020-09-29 08:41:14 UTC,76392695,76386695,false,6000,0
db3af5e820f7b0e92e1b139e96efcee6a797f8735a4e47fd40c62a9363ed39dc,988876,2020-09-29 08:41:14 UTC,10000,,false,10000,0
d76660b6487077a2b91f24dd5835d2bf9f51a27455389a314bd2e4a47b0045c4,988875,2020-09-29 08:38:15 UTC,375572346,375503986,false,68360,0
bb5891d50e739bd0ed9e649509c80aa0d3844084ddd4d04187399bd94dd8c2aa,988875,2020-09-29 08:38:15 UTC,576031,566031,false,10000,0
bd060f957eca1fcd3b4606fe05bae6b7172c3c9fc04f6ad8c154ae0591e21dd2,988875,2020-09-29 08:38:15 UTC,1093279988,1093269988,false,10000,0
11e787142ba9b9d1eda0b30c335eb18b638b627c4ca2a9644c96180352220662,988875,2020-09-29 08:38:15 UTC,6490390684,6490380684,false,10000,0
8910a85d0d54f0a4c6a626f08bded496f1a4b92fbfd11358bfdac2f8dce4bd2a,988875,2020-09-29 08:38:15 UTC,250,,false,250,0
c8530bbb2f87fb8fdd25f0d8e85140cee308ad066abf411b3d1796c13260f52d,988875,2020-09-29 08:38:15 UTC,224478015,224475055,false,2960,0
0e249d668e24ccd5458463e822a8e93bc53b956e13024a5d6a3bf50dc7c322e6,988875,2020-09-29 08:38:15 UTC,66818613,66810068,false,8545,0
ce6bc4f79bdc3d46beccaf2cc249aa582247bdf0901460d1439e8603c42c2c89,988875,2020-09-29 08:38:15 UTC,20184243811,20184233811,false,10000,0
84732615d4d68adce6af74780b23db2e7435009cf2f52d2389f0cab9e09e1026,988874,2020-09-29 08:35:47 UTC,500000000,499990000,false,10000,0
ba0d527b7302bbd122948f3d554a5200bb56a9d69afc3f7c2dd86a2e735a77c8,988874,2020-09-29 08:35:47 UTC,500065140,500055140,false,10000,0
0683e8d2761938daf36e2de09b5ccef4e9477d1d069901d9e18da6f51cc881da,988874,2020-09-29 08:35:47 UTC,2799100000,2799097740,false,2260,0
c743a4d0ccba36bbd3956dd5a69005a77808c3ac3d549c6f5ac8122ab7a365a6,988874,2020-09-29 08:35:47 UTC,199079339,199076379,false,2960,0
161a398e81abab0ae7991e69f80b11655b821bb04f069f33109891d7e96b5847,988873,2020-09-29 08:34:10 UTC,137842,133922,false,3920,0
39d0380c73d89b08f9fc0fcd809d900ee39ad80ae7b36a78349a5895315c0b1b,988873,2020-09-29 08:34:10 UTC,171615285,171613025,false,2260,0
1b3a850d613d48095d35233df96615ac7c150622bad772cd982c8240ba6311dc,988873,2020-09-29 08:34:10 UTC,40202090,40200170,false,1920,0
801aa7d8011498279bfe403edfcb7bb473272d9acfd3c29ad45381c2f5e87d3b,988873,2020-09-29 08:34:10 UTC,103089739,103083739,false,6000,0
c2392dc7c0ee718e49fe3e76efa4b25ff70ed81d3be4e25e2940e954b646d41e,988873,2020-09-29 08:34:10 UTC,167686875,167683915,false,2960,0
16c866f619bda02443440f854338d12187b6bb81af2906c48f5ac3344e32b368,988872,2020-09-29 08:31:11 UTC,13045856,13036218,false,9638,988861
2ce4247b4a9ae82378d8f8145ff8f08b45a39908c23007300e26c3336de7165c,988872,2020-09-29 08:31:11 UTC,141318569,141302652,false,15917,0
84a2d043f5c9800258c422b57f8431196ecfaf3d46ca070a3c992d948a0beaaa,988872,2020-09-29 08:31:11 UTC,1657508228,1657460573,false,47655,988861
697c900f9c333478e8cb3e68e74c3d4fc5a6a5ecad3f84f85e728ed0827fa335,988871,2020-09-29 08:29:18 UTC,56817,52143,false,4674,0
e5066f027d715cf039aa72b79eb397b588b6f70e3ceefe020517682802396c81,988871,2020-09-29 08:29:18 UTC,66848995,66840450,false,8545,0
8d01be42e459d17690e28402ec389c8fa96e0f0eb14ba94e1a94953ee38d76f4,988871,2020-09-29 08:29:18 UTC,250,,false,250,0
e62d41edd624c7ca0591190b21f3c8208019f8c54096697f9a146b09949073d1,988871,2020-09-29 08:29:18 UTC,199641003,199635288,false,5715,0
2546de936c07c28a543837b8ad87357571b88e948cf11d098e9861535c7a581f,988871,2020-09-29 08:29:18 UTC,224819642,224815457,false,4185,0
f0b583bdbb2170618b320d739abdbd0f8c762f28a11b7ef9eaff699a443ed7b8,988871,2020-09-29 08:29:18 UTC,46755258444,46755248444,false,10000,0
7d66c1313741f2a1f6f8e30f39a0e79301b62b98016a5813fe8697e360cbff3e,988869,2020-09-29 08:22:43 UTC,66967047,66958502,false,8545,0
5212479c57dd9e0cd5088ec8449d7b495603866cc94032773d83451acff6ffa1,988868,2020-09-29 08:21:52 UTC,602493766,602491506,false,2260,0
7a6d2bd85eca3c82d7f5ca7764fee88b763ac4d5da774777f12a14514085e6a6,988868,2020-09-29 08:21:52 UTC,57357256223,57357256123,false,100,988857
b5719c2aa95cf8b7b6a4827979643560ffe4d0a69743c6abfdb6ea0f1d70c424,988868,2020-09-29 08:21:52 UTC,499990267,499980267,false,10000,0
eb7fc92f0dfb0ccc648c120912edc9c3826a5cf6c7afb84f9dcf52e4dee482a8,988868,2020-09-29 08:21:52 UTC,4441084,4432539,false,8545,0
ac6f1cc4fb7c05878104ca180202b7082d73caa6646cbb9d9126585cb2b3df37,988868,2020-09-29 08:21:52 UTC,11259758781,11259753561,false,5220,0
73280e8af5603ee97ca4666d11ad6705af387eecade087b670dbc9cbe80e45fe,988868,2020-09-29 08:21:52 UTC,811507109147,811507107054,false,2093,988857
79de9f160a2de7d1d7f1b89b5a155e6b6ee5f7d7b5fd60c1cad5b0704ca21a34,988868,2020-09-29 08:21:52 UTC,1658836455,1658780084,false,56371,988857
65728d856dfaefe3e499892fbc7e8cbdd901fe0bb82cbc95e32c81a7ca544409,988867,2020-09-29 08:19:10 UTC,358086162,357986162,false,100000,0
2caa1e36fd2c2ae28353231c9f37f6d19e67c786d8911fd85d6bb70f76194d3f,988867,2020-09-29 08:19:10 UTC,123722583189,123722580839,false,2350,0
3d6397a2ee462ac5c3305f6632efde9cf9fe2300918eb1187cea1440701fb054,988867,2020-09-29 08:19:10 UTC,1004838,998058,false,6780,0
057b9352656ee207d8b24dc0b860a908a713fe73c36f03e0f778fb3bcf3b6f74,988867,2020-09-29 08:19:10 UTC,1344843682,1344841598,false,2084,988855
cae3c08723812271f69ce3adf509429ade40cc5de8d6e420b58282ed2e8748d3,988867,2020-09-29 08:19:10 UTC,500075140,500065140,false,10000,0
bd718d94f33a40d7905042b55eca550eb86123cfb7d5972292b0a963e3ea99d0,988867,2020-09-29 08:19:10 UTC,34518569467,34518539467,false,30000,0
4fedd58786e8aee00f2979402d98f63431ea19f39211370d9e18793afdf9ef8d,988867,2020-09-29 08:19:10 UTC,181008580,181006150,false,2430,0
be53a54bac9a865f3a0d03d7bf541a7d573f044ca3a3599a67a8033b6d0c3177,988867,2020-09-29 08:19:10 UTC,4545028,4451272,false,93756,0
58e99f6cce4477bb3acfdc7f5163d72018ee25189d829827a79238eb46109217,988867,2020-09-29 08:19:10 UTC,168421705,168415990,false,5715,0
699ff7ab07b2cca6bb2c355b255385368ff5a6021d0c8ed24861601e1fc36df3,988867,2020-09-29 08:19:10 UTC,170467814,170387814,false,80000,0
e1d1c9f4432dd72962136a90cb5b2b4e593d524b2ca1a221fb26ee7b059e2e2f,988867,2020-09-29 08:19:10 UTC,500010000,500000000,false,10000,0
079488c97cc999a2cfa69b36f1cba99b33a59477b7d00c4f65d09dd796f71abc,988867,2020-09-29 08:19:10 UTC,67029933,67021388,false,8545,0
aa1e013927929e01b06c40e3545f0dea59e8bf8e0134450248a364feee7d2b4b,988864,2020-09-29 08:14:35 UTC,10000,,false,10000,0
c005ed427bf8cca14896e3cc2091e01bc122bd1109ee6dc81dd5db4ad556cd58,988864,2020-09-29 08:14:35 UTC,814034762224,814034760140,false,2084,988852
87492922712e90be442a657d387399d90a57f3daa1b8eaca8b67e106a4d9e6c2,988864,2020-09-29 08:14:35 UTC,14000644455,14000642394,false,2061,0
f1cff17da797d3c56283965f022f0e79ad0ee02583350062f0b6a9ba6f3e4b21,988864,2020-09-29 08:14:35 UTC,500085140,500075140,false,10000,0
67bad155f41c72de026d023357840e52e9d348f1c8dbea8234fef8aa4c42dc2f,988863,2020-09-29 08:11:47 UTC,20880610004,20880603316,false,6688,0
34ab1cde364854e583f5a0c0b5be59fd9d90370c053bb781c62301c62680b675,988862,2020-09-29 08:11:27 UTC,225240873,225237300,false,3573,0
f773c4c3b4724a664ddc1683d49ed4d3a89db53faa72d530d24afb0797aa01a4,988861,2020-09-29 08:10:47 UTC,1659759759,1659710310,false,49449,988850
fb5d4691fbfabd234b32879f0decfa43a9c3edd7439a644d02fdd0ccbaa86b80,988861,2020-09-29 08:10:47 UTC,396787500,396785918,false,1582,0
13a8b55f3e6457266d7317836020b43e0e0943778d8e0e310ebc9d3a7386dbdd,988861,2020-09-29 08:10:47 UTC,250,,false,250,0
b8a1e72266e7da602e2785397193a3c232c910039c2a4acf9096d3a91ade080a,988858,2020-09-29 08:07:36 UTC,2782696,2781316,false,1380,0
29ce6030cb1a303ef7faaf198143f458d1373ef34f599cfc691563077eaf70b4,988858,2020-09-29 08:07:36 UTC,673490,673070,false,420,0
fd3e35be6eb8a8aec6d697d474e25de172c0e92e9e50235523f1f730628ca777,988858,2020-09-29 08:07:36 UTC,1000035415,1000025415,false,10000,0
a7940216ac2362e765a5fc3ee41658498fae2b775344692e8fc448d0b18edc82,988857,2020-09-29 08:07:11 UTC,169255262,169249853,false,5409,0
4b82fe8f84ca1d7810d8fa2aa112cc29ba29fab80977b3e044d545a626565a60,988857,2020-09-29 08:07:11 UTC,500002093,499992093,false,10000,0
073edb9f8104a6b4ce515fc167ab603856ef5e714a69cd758475ddf54bf907d5,988857,2020-09-29 08:07:11 UTC,2234794,2233294,false,1500,0
8c055a9590c10cd2c2b08a30a934c9c52edfb251dc8ae9856b669dfc252a5699,988857,2020-09-29 08:07:11 UTC,88730000,88710000,false,20000,0
1ca92d2c9441b5b77d4da64bd91a9d800a5adacd6f494a234a281279115c02ee,988857,2020-09-29 08:07:11 UTC,82922747883,82922745533,false,2350,0
4a178f956b6547cf20e30630ebc0d2ed41ed898fdb5354eed93380553356cb99,988857,2020-09-29 08:07:11 UTC,2500212155,2500202155,false,10000,0
fe7db69f94cdea447b3752b138ff8384d012b3c1a348bb1af7a07eba77e7747f,988857,2020-09-29 08:07:11 UTC,500000000,499990000,false,10000,0
f54bbbe1a49099447aac0f69e5b8cfeb019f11baa6ef175d681e37b4415fa5de,988857,2020-09-29 08:07:11 UTC,3391201,3387461,false,3740,0
a7685df772b407e62b1c35b920a1cc54202d7016f8fd66b563f1c15775da853b,988857,2020-09-29 08:07:11 UTC,199826344,199823384,false,2960,0
41124b9c55f7b8f497f28842e598cbbc034af2aa24ee03814a38dc178d59907a,988857,2020-09-29 08:07:11 UTC,10977252226,10977204849,false,47377,0
dbb6f74723315e1318459b90a73c80a06587c7d21bc792a8835b4756249e13be,988857,2020-09-29 08:07:11 UTC,67260982,67252437,false,8545,0
7cba90a7b38b368e23adbda08e32f135e7fe09504ea2a6589cea5e7e47ddae8d,988857,2020-09-29 08:07:11 UTC,2000160993,2000150993,false,10000,0
f47a4dffe9a8fa7f28772290949ebb4da578ad9394dcb0a2520897c3aafb3b06,988857,2020-09-29 08:07:11 UTC,260753211,260751118,false,2093,988845
d3fe0de94e09b0d1ea491a4eca5bf2296b5f6fa9498f9e3b065c8278fa7fd1ab,988857,2020-09-29 08:07:11 UTC,247957268227,247957258227,false,10000,0
78220c19d5676678003c83bf7722179e1d2fff26fc310bb1f7031a0ed94adc0f,988857,2020-09-29 08:07:11 UTC,67326947,67318402,false,8545,0
ff99438af336a3ef52ed53e2fd312f8f481b3c6c3a43b98cbf9f2591dbc591f9,988857,2020-09-29 08:07:11 UTC,41099593675,41099493675,false,100000,988846
4b4da0381fbc3ea4694c95afd8f7446f24366a04ea92f53679c8acac8b00ec22,988857,2020-09-29 08:07:11 UTC,818694353081,818694350697,false,2384,988846
7ff74aeb8bf7bc1ffd0f637c835168314eebb8bf3c782172ca8b4b8cee8d0f31,988855,2020-09-29 08:01:15 UTC,67360366,67351821,false,8545,0
10778c0d9ec8ca92680cc8510bf6224e4fc3f3adfc2f72092c7fd261d3cbb861,988855,2020-09-29 08:01:15 UTC,693461,691201,false,2260,0
289c69f4b31247a2fc8ccb493557fc1d60f22bae988230de5f007ce840926779,988855,2020-09-29 08:01:15 UTC,13561083796,13560880796,false,203000,0
2f98fa79e6bcb2db1dd069f6458fd8348b55450bf2dc7c34bd7206fb29a387da,988855,2020-09-29 08:01:15 UTC,989677647,989674682,false,2965,988844
aed78f247e7fad5ce8e36f434cfbf0a675ff81d4f9e66d09040aceb5c01627e3,988855,2020-09-29 08:01:15 UTC,188409447,188364687,false,44760,988854
68bfeb9753699efd1c9d5f74d58ea049fec677c4dc587620af465f395d5e2844,988855,2020-09-29 08:01:15 UTC,19907927675,19907917675,false,10000,0
09f9cf7abf5cacda7b8ceafd222653e8fabf7ded9859f588e8bcfb73fddca7d8,988855,2020-09-29 08:01:15 UTC,276531873,276529489,false,2384,988844
8deb85f1d456d6de03f17e18fc6c0c35b4029362b805755fd13d72f57544eb7e,988855,2020-09-29 08:01:15 UTC,1661073535,1661019523,false,54012,988844
d3e68d26690dd79100526055b1bc7a80bb048b40c94b4d0a8b58d8a1ea2cebe2,988855,2020-09-29 08:01:15 UTC,746713281,746703621,false,9660,0
b81f7c549fe9926a12eb50d7e4fe083c2056e5acc22f77441c62f98f1b8da223,988855,2020-09-29 08:01:15 UTC,143207934,143139574,false,68360,0
ec9ec42f5e6d14dd90f43106bd0ed4c054015a3b3a53d84931860a3983c541d4,988854,2020-09-29 07:58:40 UTC,19910417511,19910407511,false,10000,0
cc3e71cd53b2c7bedb2f27214e7a906df8bb377a687ae2feca8d65e719f278e2,988854,2020-09-29 07:58:40 UTC,1020043351,1019943351,false,100000,0
cac3aef69ff200dc34947e605d11bc82c95ebd87c2206645728fa7a18b6262f6,988854,2020-09-29 07:58:40 UTC,682041796,682028953,false,12843,988842
d468beef669987eab838670e847001fa880dec6db6f871df93e6872ac11d1ae4,988854,2020-09-29 07:58:40 UTC,225504638,225501678,false,2960,0
50a094e0894d812ef680fd5be8cedd7481b55d7d481bdfdf672de0df1d6628f9,988853,2020-09-29 07:56:58 UTC,32417560,32411560,false,6000,0
1448b0ad02297adcd5a65cc045f0b1564252b6a748d10e0550dab9f08fbe9148,988853,2020-09-29 07:56:58 UTC,94465662041,94465659351,false,2690,0
a06c42d09ac8c45d04a9a8d8d38e908400e5cac2cd7289dd4cde8d70a4c47f1b,988852,2020-09-29 07:55:15 UTC,57376148154,57376148054,false,100,988840
95400280a570f6b872650bf7de0e2334f8d65f4f36fc9c629b458f81dbf0598f,988851,2020-09-29 07:54:45 UTC,200124245,200121285,false,2960,0
7106f7dd38d927515e3b5c52ce5947383416eca86e2e3c5f8f59775eb54956ad,988851,2020-09-29 07:54:45 UTC,46699593675,46699493675,false,100000,988840
1e9b6a5e45af8eadbc1aca6eb468a78e0a0f1d567b6e01dbae2ba220eb1a6dc0,988850,2020-09-29 07:53:06 UTC,2104226,2103326,false,900,0
9a80186222119e8ee60cf18529f680631e83ae754aeca5bea3558e81671ee2d7,988850,2020-09-29 07:53:06 UTC,10000,,false,10000,0
826de6cb42c4b7daf69689051b004a07866e24f89509b07d3c98f76c251f568f,988848,2020-09-29 07:51:38 UTC,250,,false,250,0
dccf9db62611a81e60f33d3658c6eef36b5240f8588155291668a5cf0eb42eaf,988847,2020-09-29 07:51:20 UTC,250,,false,250,0
3103a3f59c300344c83bf482ef42fbf2cb81bc652afd468d487ea8da352ae887,988846,2020-09-29 07:51:12 UTC,20856249,20850371,false,5878,988834
99c7a4b3828fa076ef1ed8c57670b7a4890350b24afcd1cea11d1fa988cb0355,988846,2020-09-29 07:51:12 UTC,1662752352,1662700331,false,52021,988834
87a3c567ee5b7553b8d07eb57ee5dee7545667809cde86d9946d843f65300085,988846,2020-09-29 07:51:12 UTC,134782589,134755638,false,26951,0
8fd30ddccdd623bb1c91a816cb0a023d36931ad6423e0fd4f2440f1ab89eba37,988845,2020-09-29 07:49:46 UTC,19910427511,19910417511,false,10000,0
316d137ecb8448c80d8aa8e3642eae732a0111ecc0617afa625dee031cff6b32,988845,2020-09-29 07:49:46 UTC,58478064154,58478064054,false,100,988834
7c16d9244b5376a6c33c90e4de1876cfa9a40b046d548d5e28ec621bcf1ed0ea,988845,2020-09-29 07:49:46 UTC,4300832,4299212,false,1620,0
0b54b5d12020603d9210d4b8060101193c62dbab7789fef202879421765d92ec,988845,2020-09-29 07:49:46 UTC,292951266,292949173,false,2093,988834
9b0ec1d1bab8fd8601b2a2e28c0e5e3e2a51213b89216adfa8ddeaf4741ee6d5,988845,2020-09-29 07:49:46 UTC,250,,false,250,0
9cb67f06744510d09ec075591c18dd4a7f20dbd5bb560f31ced32d09fe8d20ac,988844,2020-09-29 07:47:36 UTC,250,,false,250,0
1d041a277898a5e95f4e25501b7a8a3cad77bf636b9c54a0ab0dc15debd94788,988844,2020-09-29 07:47:36 UTC,770000000,769990000,false,10000,0
22108edbcc1024bc41344307b34599686fb969ce003e1aa4e529b211eb5d5a58,988843,2020-09-29 07:47:17 UTC,492500000,492497740,false,2260,0
28614a9d53a5f4ac4960823d880d23e99c74ec908a7521f923249de8f149666b,988843,2020-09-29 07:47:17 UTC,61080,51080,false,10000,0
10c92beac226e72bd6e3cf1873194a14ff8fa28a380fa2382a417883810ff4c0,988843,2020-09-29 07:47:17 UTC,20288775150,20288765150,false,10000,0
287f0d228b37ad1a4f0506e0398d1b077b8a0148ec777c9ff5dc4b75d6cedd25,988843,2020-09-29 07:47:17 UTC,73769021,73766993,false,2028,0
251b00696d852c5bc2c287b69abb7b586e0d1ee316efe2dfbfca329f58e6064e,988843,2020-09-29 07:47:17 UTC,7501347102,7501336199,false,10903,988831
cb8fdf0024428b81a22ed9c5c45d83e724c5e0a28b5f1340b3769c2f08503dab,988843,2020-09-29 07:47:17 UTC,5815258,5812978,false,2280,0
77c4a2690a342074e3b0e776e5b39661cfcbfb04ef33a68d7eb3629f83dc2afe,988842,2020-09-29 07:45:58 UTC,169402969,169400009,false,2960,0
12692bc86b4970d3ae777bbd96c31533a82f4a925e49f411f12302b2b656186f,988842,2020-09-29 07:45:58 UTC,7501099919,7501093066,false,6853,988831
5414c5022411a0af12b67843b777a800258c2ae94cfae2fd21303f93c69c6049,988842,2020-09-29 07:45:58 UTC,20288785150,20288775150,false,10000,0
09bcc55bcee422077ed47ede123747624f85d8d0c295eb685ab43ec9beac8820,988842,2020-09-29 07:45:58 UTC,3601139658,3599863755,false,1275903,0
4c2dc8bac69ade2262e1654dc86e7599d6b0248906415cd552b62703aa6d7679,988842,2020-09-29 07:45:58 UTC,58619361168,58619361068,false,100,988831
01f78270896e45f8ae26bf32990cc1981d91e4fcce79b87544da421d1bf4bfb0,988842,2020-09-29 07:45:58 UTC,58504561068,58504560968,false,100,988831
c3adbabf6aaf2f572052892908bc46eeae56702c43193578b629dfb09c874d6f,988842,2020-09-29 07:45:58 UTC,1241512,1240912,false,600,0
3c5c97e40bede3c3591f56acf828210e401bfca6761264859a8906aac1b9111a,988842,2020-09-29 07:45:58 UTC,77000000,76999000,false,1000,0
f25e969b8c46844302223af0e6f4c0a9702138b765768d4feecfccf427f63f95,988842,2020-09-29 07:45:58 UTC,90237973,90227973,false,10000,0
f2c671eb9a1b50be97a8f7a81650ad1a1493ba5c477a81724df507e7ed82c635,988841,2020-09-29 07:43:14 UTC,250,,false,250,0
82a1bbefcf821b541ab9b67df5ffc4d512fc3c1f91ee01257276dc524db9980d,988840,2020-09-29 07:42:37 UTC,23538624,23535574,false,3050,988813
5964ca20b339f8619ce2db501ad00cea68f20217121e0bf8a37f853981fa9ecd,988840,2020-09-29 07:42:37 UTC,143223192,143154832,false,68360,0
ca44b836c2d4a7cf8fb692e32e43e87c919fb0c21548034624c281b833e6408d,988840,2020-09-29 07:42:37 UTC,499990000,499980000,false,10000,0
761adaf0112636b67c4a9ced6207112b534758fc705d4eca82804e93e5c60449,988840,2020-09-29 07:42:37 UTC,2114003861,2113993861,false,10000,988824
a582856ad200ed7566d3927ed4a4eb6ec3966a480027b385d377d9188079d6af,988840,2020-09-29 07:42:37 UTC,20290901961,20290891961,false,10000,0
ee7a0cc5137910adcbaec782ae9bb2534b0a7b99db04d4c213ed507c2e6932a7,988840,2020-09-29 07:42:37 UTC,250,,false,250,0
e0a055d93ca4b03bf0f73f3c000cf6bd3cdade9d6ff743e4f7b08d6b9cc2e148,988839,2020-09-29 07:40:30 UTC,1664281159,1664220396,false,60763,988827
cf6c58ae3881784f136efc53fab64dc26eb06211ab002f0be95b05708199e11f,988838,2020-09-29 07:40:01 UTC,174529354295,174529338715,false,15580,0
257867a7791089773e6c98f3c95164fd8a56da5fe7ba262f502f7ecb7f36532e,988838,2020-09-29 07:40:01 UTC,250,,false,250,0
174382fcaf4a4a6dd758968e6a9905e30c5cdfb18661eb6c23d02b5a1486a06b,988837,2020-09-29 07:39:31 UTC,770010000,770000000,false,10000,0
d9ebf71ff255ef72c4e6a1c2126eb69f69cb5aedfbf416ec28b65e1186290fa9,988836,2020-09-29 07:39:14 UTC,20000,19750,false,250,0
ce9121283c0293b224901d0535811ba166a5aa6649b067f50cf81cdee4530174,988836,2020-09-29 07:39:14 UTC,818744355174,818744353081,false,2093,988824
40866e69a939f816e8d815e63bbf28697389609ab15973130223ecf70c5d010a,988836,2020-09-29 07:39:14 UTC,694510,692060,false,2450,0
cd222a69a8e4afedf67b48d50673cced80b1665717dae0fe28f07f491ff760e4,988835,2020-09-29 07:38:37 UTC,500000000,499990000,false,10000,0
03288cf8c2acc93314927d241a0982918556b225dd3d4fb063c76567e2e30ef6,988835,2020-09-29 07:38:37 UTC,4500501783,4500491783,false,10000,0
948c7ea8a99eb4fa29efd03c0ab3cade104857e97992529fde2313ccb285c186,988835,2020-09-29 07:38:37 UTC,67430187,67421642,false,8545,0
24af10781fd262dd081a55a0eb977e39d98f8302a7927cc75a6e0d2ecbd338b2,988835,2020-09-29 07:38:37 UTC,408867493,408857493,false,10000,0
13b3c0873f07238c5254d78a9556ea8e23971e158681bf2d476b4bfaafb32da5,988834,2020-09-29 07:37:06 UTC,225658996,225656036,false,2960,0
170e97cea64364a771e84af9e04225f4ade28c3cbd18f7063fa7c319b85d63cf,988832,2020-09-29 07:36:24 UTC,3590536592,3590534332,false,2260,0
b6bc6364de87e12b43fc1ad3477a4c68c5e20cd02620cbabca41b186af7c0cd9,988831,2020-09-29 07:36:07 UTC,3600868438,3600866178,false,2260,0
f4f3dd9a6cb968f6143126d9de72c2c86158b9f5bc6807b55a29475b0a3e8c73,988830,2020-09-29 07:35:30 UTC,4678392,4669847,false,8545,0
418cf1d1b9c766b07b7ada6219ead1348e7556884e4777b9646c7a507f9152b3,988830,2020-09-29 07:35:30 UTC,4559738,4551193,false,8545,0
909679bed4aa3e0408cac3e1c99308cc33b2559662e9464f75a2ab73f44cccee,988828,2020-09-29 07:35:08 UTC,3697125935,3697123675,false,2260,0
36d2699fa8f357bd52cb04fcc568c5a30650a1378ab422796445f317f294a41c,988827,2020-09-29 07:34:59 UTC,309299397,309287397,false,12000,0
e723440708c7b0c9714bcc7702335b516c506b9d90439bac9522cfa0273263d4,988827,2020-09-29 07:34:59 UTC,818937826267,818937824174,false,2093,988815
8bb3c42fdd3f5547edfc2f747a411ca65a48936404560a9d4e5392396baf2ad3,988827,2020-09-29 07:34:59 UTC,3709053898,3709051638,false,2260,0
32d35adf22513a3d1cfc9f8138a1c0fe3c5cffa29961af144d106c048683695b,988827,2020-09-29 07:34:59 UTC,499990000,499980000,false,10000,0
93243b8761966bc600ee1c83c8cb39feea8a1eec2bbe87f522b2299f00045451,988827,2020-09-29 07:34:59 UTC,10000,,false,10000,0
da960cfc2c173ef89c58129dfef7f2f40957d0131cb0a901c70d1861aee9a702,988826,2020-09-29 07:34:07 UTC,67496647,67488102,false,8545,0
cf83ef5576adcf3e8041300a802b4fcfb9722f72973ca02f6c1d8ee2af857ce9,988826,2020-09-29 07:34:07 UTC,3719056158,3719053898,false,2260,0
e3a214f42f6e70498ceaa0b06a4e0c766e822306f63cfb349859e2826ab5834f,988826,2020-09-29 07:34:07 UTC,11007161,10998631,false,8530,0
81e72a30d5842d0522a6bbf9bcd35474fe11ac51283c645b4849a3e1c9827e1f,988826,2020-09-29 07:34:07 UTC,500000000,499990000,false,10000,0
c56562b50a4390226c0d0190899d2bd57a0017d4c8cad518c3e6026123fe5e53,988826,2020-09-29 07:34:07 UTC,196954656,196944656,false,10000,0
84b87612d58abf0c360a5b54fa40bbc24d20fae5312ec59b7bbd012a6eeb16e2,988825,2020-09-29 07:32:18 UTC,818987828360,818987826267,false,2093,988813
e31835356a5f4ab1d0b563ccff53213dc171fdcc0f2968abf1b53526080d52cb,988825,2020-09-29 07:32:18 UTC,200399198,200395319,false,3879,0
cd4c7175adfce81fc5d2c0bee619b3ea5821f382084eb595cfb7ad1654fa27e4,988820,2020-09-29 07:31:00 UTC,58854961268,58854961168,false,100,988738
09a6983bc248aaa5e26fea9427731780536ef2b7f9ad316af526a17b84f017f4,988819,2020-09-29 07:30:22 UTC,819064830444,819064828360,false,2084,988808
00ac3966a13274c0762ab1b4915bc0112dc3333bca5a56fb5658e0b5f7b61ade,988819,2020-09-29 07:30:22 UTC,1665932461,1665872330,false,60131,988808
e5478c44fe37a77d7f4868b8a666e71e44d283a5a314bf64da7d8a9a0ddf4117,988818,2020-09-29 07:28:35 UTC,67530397,67521852,false,8545,0
ad3b4b2b4866171017bb0611f353b791e3f146114e040f4c0e76fcc60408f6c2,988818,2020-09-29 07:28:35 UTC,10004075552,10004069699,false,5853,988806
990d793366d03d2f0f70489e896fe6398b641b11fb61b264c6579bdd1877bd5c,988817,2020-09-29 07:28:18 UTC,11716441,11693461,false,22980,0
fb6a584428674d889b5c5c46b81dc31de1a119bc987b7e626bff6e0057921eb1,988817,2020-09-29 07:28:18 UTC,82966167138,82966164788,false,2350,0
78d6665ab068702a8c90b8f0db11715ba07b135c823ca01a408433dcb0f564bb,988816,2020-09-29 07:24:25 UTC,169606541,169603274,false,3267,0
ad1ac6c8c910ec67ff068d07895645fb3fa0b6706a95519c05072435deb1230a,988816,2020-09-29 07:24:25 UTC,1004360,1001910,false,2450,0
9661481f2f5a0e95ed51f55cf86a2942351eb73896d69593e080560b7eb48c84,988816,2020-09-29 07:24:25 UTC,1076819820,1076751460,false,68360,0
0caaa7cdfb93fe235629a318366d958cb25f897fe2edd48ec1f6677b54141ad3,988814,2020-09-29 07:22:41 UTC,67581828,67573283,false,8545,0
2ffc0c92770e0ba1a036a617e2b367d79b7a006331a853ec9426473f5aa839cf,988814,2020-09-29 07:22:41 UTC,772258309,772158309,false,100000,0
718d09dbe55bb9331a1745f0ba70d8df3537f00abc931190f94bbb9063ea8eaf,988814,2020-09-29 07:22:41 UTC,67613016,67604471,false,8545,0
167cbf9fb7b631a2ec491061df063273655184816495875420da5e30da68ecc6,988814,2020-09-29 07:22:41 UTC,106826538,106822798,false,3740,0
c38459b490af9aa072c4b835e97821c5250bf31418245cef07ad6753f9a2fcab,988811,2020-09-29 07:20:27 UTC,58866217942,58866217842,false,100,988799
cd23423ab8045f99a4f038f8fbfd36a65c5616ba90783fae2f9882b32aa5f301,988807,2020-09-29 07:20:05 UTC,819367132537,819367130444,false,2093,988796
468a663926a1376c2de358d27af1afd8173663b1354ffe30f32612fc1dc97e3c,988807,2020-09-29 07:20:05 UTC,225859834,225856874,false,2960,0
b80ec2f7c0af4ea0bb119333d42ed2e7fa264d0aea265522c585eec1484d1815,988807,2020-09-29 07:20:05 UTC,67650780,67642235,false,8545,0
2e8e995b51417ff8e4d63db70ff56cb09eba4241d5056225a4535352ccbd65c3,988807,2020-09-29 07:20:05 UTC,1667135297,1667087334,false,47963,988796
0eb9455343ba602da7173a10a1d1ca2ab6623ed017a12839d47d9212de4fdcb9,988806,2020-09-29 07:17:13 UTC,25569642,25565902,false,3740,0
82a5f2f46ca502433c0e3d5e2b1e9d6d130ccac6539bb75f3976976cb7855af1,988806,2020-09-29 07:17:13 UTC,838188995930,838188993837,false,2093,988795
5341ce44be039154a266aaf9102b04d1206eea6a1d61e53361a66f23e4c3d19c,988806,2020-09-29 07:17:13 UTC,331245836,331243743,false,2093,988795
318a1144b6110bd776a1f908a704d09df86f4e90c7f3434627098acdc709da54,988805,2020-09-29 07:15:05 UTC,8154760,8147617,false,7143,988793
1df41cda79b2941cee4fbc2c96834823387c7eef02d33501ca16083c8a6c7cd9,988805,2020-09-29 07:15:05 UTC,1660690842,1660685962,false,4880,0
68c6688b26b5cd68d70f02f174bfb831d4186d3139412eb80cff161fc933e331,988805,2020-09-29 07:15:05 UTC,12568664076,12568651701,false,12375,0
406bbfb7431c4b2058579670f47f5267b16e540b4a7125ae5116c4cd8d39c28f,988805,2020-09-29 07:15:05 UTC,19790931961,19790921961,false,10000,0
4a1e4584a96e1039c8ab4a7625c7ae46ef67ef165e9de67d936b0514ac75aa4d,988804,2020-09-29 07:12:05 UTC,838216661822,838216659738,false,2084,988792
554bc11b54320cb9a46af94084258da133692f0bf1187cd37cb4b7d5b83255df,988804,2020-09-29 07:12:05 UTC,968866,966626,false,2240,0
eab0edf55f92c6f72ae788c033537dcb7ebeb9f6132462b1848dea4fe3af775d,988804,2020-09-29 07:12:05 UTC,200593826,200590559,false,3267,0
9c17826fe3026b04fe7325af9ed25174d2c8396e6e72061221347cf8974ac5e4,988803,2020-09-29 07:11:07 UTC,169195235,169192975,false,2260,0
39cc0415554b00d95ed74db1f6ba7fde3452ed70f136159c622240b4b0eba59f,988803,2020-09-29 07:11:07 UTC,1668247198,1668196595,false,50603,988792
32c6d8db4eccda9cd864514bc5d142c21757b8eb6ceb076070e57fd257b810c8,988803,2020-09-29 07:11:07 UTC,20363426728,20363416728,false,10000,0
7b2e28dd1da19f61eb532acb5637a5becb7c879e42fea9628038c3eeb668fece,988803,2020-09-29 07:11:07 UTC,161422,151422,false,10000,0
da7ee058ad061a14d7c36904d69c8497287cecf1d6ff125fa74bb9d92b5f711b,988802,2020-09-29 07:09:21 UTC,11000000,10990000,false,10000,0
41b3e710e8cd9a625fd7f5ac1b34ded7053d45a1f7ac56b1fb75716d002c5ad3,988802,2020-09-29 07:09:21 UTC,10000,,false,10000,0
5b7ea0b9de7961e70eaa675bef21efcdecb6d2a682cf854610c4c64f885f30fa,988801,2020-09-29 07:07:55 UTC,150000000,149999755,false,245,988790
2eea08edad40c0fba5a8dc00f93bbd595281de9601b36ca0dcd494e38df154cb,988801,2020-09-29 07:07:55 UTC,10000,,false,10000,0
b78ae7cbb6586aae8acc08ac9771c39b62b25143dea428803e301aff9b494bb7,988799,2020-09-29 07:06:33 UTC,500001920,499991920,false,10000,0
80143d99e69c70ffa3262ded34236c69824ccd7cdd149ffda957beae64a57e9b,988799,2020-09-29 07:06:33 UTC,169816077,169813117,false,2960,0
5a3916063d7093609166d9752d6e889dac70baa213a1ac552e4509eeb5b7f212,988799,2020-09-29 07:06:33 UTC,20363436728,20363426728,false,10000,0
e505ae2c756335f46b718a27ae56a59394bb591e1bf7c1ecf2a9d694141dc1eb,988799,2020-09-29 07:06:33 UTC,384932623,384929949,false,2674,988788
6d06f6459e4f3c1f704cd90c9aa3722034db16582989271c95f6489395d7486e,988799,2020-09-29 07:06:33 UTC,500537959,500469599,false,68360,0
444f697c2515876bfee2a44cf753d44c711ef9d8a7e9a5bb40db5ea333d1e538,988798,2020-09-29 07:05:56 UTC,499980000,499970000,false,10000,0
fa0157614dbd87900e86f17726578042299b3241d753b0425f4878c56583a96f,988798,2020-09-29 07:05:56 UTC,4502212118,4502202118,false,10000,0
b62139baca657bc2c746fbfe108d06f34e1c65d7800584495fccba13e211619a,988798,2020-09-29 07:05:56 UTC,18557833674,18557821299,false,12375,0
77ad6474db0dcf87f2a8dbb4de3d6b60e0be54b8d230baa95dfde6fbcc21e855,988798,2020-09-29 07:05:56 UTC,2500222155,2500212155,false,10000,0
4567ed70c8c648c7a55e70b9365fa898c952d4cdf65d3aa5a0b1b2a0a4fe7a43,988796,2020-09-29 07:04:47 UTC,244404797098,244404787098,false,10000,0
157f8a7da804bc334ffbc060b0a3cb740ec0a2613ac647eb206ffb2a56592b06,988796,2020-09-29 07:04:47 UTC,41587731,41577731,false,10000,0
68ac80ca3772efa9bec4c7cfe6139f1b82b8243854c9fe1480c95fba4f5003e5,988795,2020-09-29 07:04:34 UTC,500016700,500006700,false,10000,0
4ab97793eb809129e098b00b30123c06195ec0a35ed5bd61677d8c8b2e212c69,988795,2020-09-29 07:04:34 UTC,8210330911,8210300911,false,30000,0
6c63656bcf610bc35183634bd0560da3b8934b8160ec7efb592454d93bf05818,988795,2020-09-29 07:04:34 UTC,499990000,499980000,false,10000,0
6d0610caf4542fc252fdd92eade5ab1a6ff6bcbbb1f53266e58c76efb5cbb0b4,988795,2020-09-29 07:04:34 UTC,14215888,14210018,false,5870,988782
0a3349349a27657528100d394397bede66839fd3810a02916200206f9be5f158,988795,2020-09-29 07:04:34 UTC,324084415,324081741,false,2674,988720
5ad67c82c6e20ccf9e9155ed556261613097f5c46964ca86de0a016bb8943d15,988795,2020-09-29 07:04:34 UTC,20056826063,20056816063,false,10000,0
608e21fb6496ceabf6784a03b270478cc166af85f883a83b830f2a5b32df909a,988795,2020-09-29 07:04:34 UTC,50399593675,50399493675,false,100000,988784
beb785657be157aa59be3dc53294ac8043bd64c0aeccfd5415e91e94fcdbf965,988795,2020-09-29 07:04:34 UTC,10000,,false,10000,0
d4c1886b95293a94d56658c1719b94dff3009eee17f44fb9c46b61f2949a7e6a,988794,2020-09-29 07:00:40 UTC,403383274,403380890,false,2384,988782
d25dfea848dd4e18c4fe64e1c3af84629925705092436ad76a04d2bf5a1e03aa,988794,2020-09-29 07:00:40 UTC,15654280,15644280,false,10000,0
104c51e5922273072d7e7bd7b3775be911e44e54d2d4f6aca51bb82df5c143c2,988793,2020-09-29 07:00:10 UTC,500000000,499990000,false,10000,0
6197ab2d56cfe29c5fca44f77400819e417f0cfa2f6df60b26681777da724121,988793,2020-09-29 07:00:10 UTC,10691200,10000000,false,691200,988782
dbf44636b9faab3467fa53dcff631d98f86b42f6d6beb409c3e9f114336633ce,988793,2020-09-29 07:00:10 UTC,1669147712,1669096596,false,51116,988782
882457d9e9f2a9afdf40a77fc60dd32eec92efb7fd7178d48d01f689ec255794,988793,2020-09-29 07:00:10 UTC,163993455,163991427,false,2028,0
f504101f188510f6ebe290e2dcdaac36fe71083d7e9fa456981a01da05bde550,988793,2020-09-29 07:00:10 UTC,20408034449,20408024449,false,10000,0
2982b817dcf2965f1faad5609346d14200a3e0ce51d4b99acf02f532f5350a1e,988793,2020-09-29 07:00:10 UTC,226106006,226102433,false,3573,0
e658d0873c528d15a7214d5b202e70ebaf89507bcf730a4c96a777bea5d908d9,988791,2020-09-29 06:58:01 UTC,2051625,2048276,false,3349,988780
5c70c4c3a8a05d6fa99faaf0e9118b1ac058db29024af573d45be00dad9ca150,988791,2020-09-29 06:58:01 UTC,67820974,67812429,false,8545,0
464706da77219087895ddad421d47cae72a198af81adefdd8f87b8d47228bcd5,988791,2020-09-29 06:58:01 UTC,58909817985,58909817885,false,100,988780
a4793bc3d685a2843011c86a82a146fb87973092d49df9377fa3dc68806cd65d,988791,2020-09-29 06:58:01 UTC,67711901,67703356,false,8545,0
6f8da36393e03d04b8da0f9ff25bf387de3b69045216fda070652fe809d6aab4,988790,2020-09-29 06:56:32 UTC,20408044449,20408034449,false,10000,0
1400d24581eaa7a58cc7ad14582ba5b8681c24d2e3c7fabee6417d71c23b9462,988789,2020-09-29 06:54:53 UTC,12879595,12871221,false,8374,988776
4a909fbe3629dc50c2571dd9ef8e28406815a9173f95c4b1ffa849f6a36691f3,988789,2020-09-29 06:54:53 UTC,500006078,499996078,false,10000,0
f8e8526e02a97caba0b610af0c5989e88da6d29f0a7f4f0ddaa67b3ec3a0a8e2,988788,2020-09-29 06:54:17 UTC,8904178375,8904176282,false,2093,988748
d6d7b8d736f5322127d39d35de761a97f70068bec7033866e1fd081131eb8932,988788,2020-09-29 06:54:17 UTC,22568615,22551696,false,16919,988776
23dc0e205203befa1c3953d86d0d656053c9dc50117de35a40ce20fbe3d24adc,988788,2020-09-29 06:54:17 UTC,624971464,624969380,false,2084,988776
eb5adcb4dfc96b7e6cb011df15d2f427b86b0d0da940a149aa15ed88bb1b3c7f,988788,2020-09-29 06:54:17 UTC,8482210955,8482208862,false,2093,988776
389093e5508ee035fc16b414b622dae437cc832dc1e4bff8b1308d2cee034e82,988788,2020-09-29 06:54:17 UTC,67938513,67929968,false,8545,0
3275186b4fb973cc55e791280dadf573ceb01712b4baf884c6992bf3dc95a993,988786,2020-09-29 06:53:48 UTC,20130411674,20130401674,false,10000,0
1193fda313472e3d124c5eca120ac700eea1abcb2e0ac0b9e5f014a5733ace3d,988786,2020-09-29 06:53:48 UTC,200999107,200995228,false,3879,0
afd40dcd10734ded04fa110daabdbe45d1eed7141509048e310b9fed72d735c4,988786,2020-09-29 06:53:48 UTC,500016078,500006078,false,10000,0
42c9c367385bc783db471f163ce84fbd9e0c86d01cf5fe7a3e60945c3b97aad5,988786,2020-09-29 06:53:48 UTC,42350787,42349059,false,1728,0
b342add919b10548e8ee6ca9f43d04b06e8f70ec288dd7c4bdd1ad79cf78f226,988785,2020-09-29 06:50:23 UTC,156164228,156145358,false,18870,0
4d77999557578194d04156509701db00cb81e20b6f51af93d6cde842360dbad1,988785,2020-09-29 06:50:23 UTC,20130421674,20130411674,false,10000,0
aa9b568267e861f366e0af6f34a6fe21fc07b5c25c370b3ca6588c7a692497fb,988785,2020-09-29 06:50:23 UTC,10000,,false,10000,0
49a958e6df22f62946506b62ebcd3b072fdb5f59d46b1100cf113fe26a105f13,988785,2020-09-29 06:50:23 UTC,1670458189,1670399203,false,58986,988774
2b2f23fe6aa829b77ae23531c639e59e6605774a40f7ff0e0eef1038a96065ab,988782,2020-09-29 06:48:32 UTC,500673890,500663890,false,10000,0
3d8fa9ec3ca9c9520d261857f615b128eff95d2a035b3073f65b7590e6b9b8f5,988782,2020-09-29 06:48:32 UTC,431578958,431510598,false,68360,0
707ac8e97c429a8d34286d4ea2246cb3045ad767a826e18d2dbaf484d1e7c852,988781,2020-09-29 06:47:11 UTC,500683890,500673890,false,10000,0
acb2d4c77db8439fe194c6d70d7db6b1777476f854d7001c2604104e8c7bc210,988781,2020-09-29 06:47:11 UTC,107502237,107486284,false,15953,988770
e6cff9e31a7d3594f04e7e7fbf261edd61790533234e04725828c2cd29505d89,988781,2020-09-29 06:47:11 UTC,59032164305,59032164205,false,100,988770
2c78ebed98abbdc96437d75ca7bfe354461cf0781c490399cd0af2f9c1a6ab2d,988781,2020-09-29 06:47:11 UTC,500026969,500016969,false,10000,0
b0ccaac38cc0d2787c5ec04a430a332c0e0bb09f093582c51eb28090a8bea3d1,988781,2020-09-29 06:47:11 UTC,774669999,774659999,false,10000,0
815bfe02f24a70f3bb852e92d227fb9afda0a5b014c3ab1c940f918c202ec7c7,988781,2020-09-29 06:47:11 UTC,30472,28444,false,2028,0
091394077eb83b893b4ba149d99ec7b5108cc74d9ad758d88c9b62272a218d40,988781,2020-09-29 06:47:11 UTC,19670034727,19670024727,false,10000,0
cc795d05eda22e5ec023323c2578c0fba25a429895d76b4abd2d8cbf2d91c64c,988781,2020-09-29 06:47:11 UTC,838283809915,838283807822,false,2093,988770
4e9afb6efb03583390b25ee8cf7cc52b6bf55a6c62b62cb4d59856cae45c11b6,988780,2020-09-29 06:43:19 UTC,19987490684,19987480684,false,10000,0
0b1e758a64213037c898cd5981d3a572c25529beebfc4536e4c4151478e6c2d9,988780,2020-09-29 06:43:19 UTC,500693890,500683890,false,10000,0
a5702f77707d561f7efcd92247c9c3fa2af876998ef8f1996e7e5a20c999807f,988780,2020-09-29 06:43:19 UTC,4047730,4044082,false,3648,988720
5242a1bb9c9ba19f2aae245d8b9e098a85f7d4e4498646610c24faa19e1da4b1,988779,2020-09-29 06:42:07 UTC,19987500684,19987490684,false,10000,0
43d3db407e6cb92c6fab66adbd9e009f270fd28462edb240a7e598f24d2e2af9,988779,2020-09-29 06:42:07 UTC,971464267,971456214,false,8053,0
0e0ac881b2272530805be6f3a7e2d9e2add8d162b95db442e7f4aeaa5f9789d0,988779,2020-09-29 06:42:07 UTC,169975034,169972074,false,2960,0
0075c504a1988a7ed2313df5a53db1908b52a21870131de04bb80167c8c3ea27,988779,2020-09-29 06:42:07 UTC,6704575,6699953,false,4622,988768
c430ebf5ab276cd6865826c7bd44365d046cfce589769e93a3c2deb9e518c437,988779,2020-09-29 06:42:07 UTC,15491834,15487220,false,4614,988767
7faa24c93ddd80a0b82450f7e26cbad38dbc81c95d04d6a16145ea9e525291ec,988779,2020-09-29 06:42:07 UTC,1671416578,1671361660,false,54918,988767
44864774a2a88d47ed591515cc9104152cd2f9ef6943e9e8c6a0f00f986480c5,988777,2020-09-29 06:39:52 UTC,1000190784,1000055164,false,135620,0
1b400beb339fe30503fa88fbdfabd8059c32b0b08079205370182a2f1f90cfa5,988777,2020-09-29 06:39:52 UTC,19766935714,19766925714,false,10000,0
bf2b8fa0c12aeb66f061819d7bea74e40e6533421f8bf160db52f48987107715,988777,2020-09-29 06:39:52 UTC,130561370,130551370,false,10000,0
a827e55e96068a6a38177c9cd6f7fad8a7430889b8e0aaaeaa6a2a622366821f,988777,2020-09-29 06:39:52 UTC,417710819,417708735,false,2084,988765
061417347341a820fc44aacc6e159ee3fb1a0bf0bca0a9cf5a6d7aeb0263b944,988777,2020-09-29 06:39:52 UTC,226270671,226267711,false,2960,0
be2976a77da1499dd4b8f709bbd2076dd6eaf85ac0ad2a7300f447f15c13926a,988777,2020-09-29 06:39:52 UTC,285698,275698,false,10000,0
65c266ec96b782781db2cefb3154f0fa0c5ccfca940f2eb533832cdce32375d4,988777,2020-09-29 06:39:52 UTC,13000000,12991379,false,8621,0
5ad82140e251558a8587eaf9464aaa0345be252f07a9edd994fd85a8bda8146b,988777,2020-09-29 06:39:52 UTC,476569259,476563259,false,6000,0
e10c11f6061718668c6afb2aba61bb004dc018940d11f175c1835cd37cbcd2d6,988777,2020-09-29 06:39:52 UTC,13313158,13303158,false,10000,0
0dd0edebd8e024818740e7206d4ef83dcc9efb78e2b7e6fa954ec3e1cc6badc4,988777,2020-09-29 06:39:52 UTC,201211261,201207994,false,3267,0
a0fefa1191c159fbeed98721408b812c436613b51f118f71a857a46dd4fe635d,988777,2020-09-29 06:39:52 UTC,101622490,101532490,false,90000,0
e73621f103045ede5003c9a984f4d157864209589141f8fc3ee4149c09f9f5c3,988777,2020-09-29 06:39:52 UTC,1000013740,1000003740,false,10000,0
2bf725e243da2f78242b9ad7ffb5acdb0ffd82f288583508be0931e82d1ff2b2,988776,2020-09-29 06:38:01 UTC,30167771,30162215,false,5556,0
e044005a8b108c65c52460f9335228572bd58ae3964e08136439899d7a68708b,988776,2020-09-29 06:38:01 UTC,2993639782,2993274262,false,365520,988775
13980ba6c008a02352f8cb518342dad8b09b6891bb530747c96d105e37d3e896,988776,2020-09-29 06:38:01 UTC,10481795,10475015,false,6780,0
dc4c6b73e7e58d9f9d61f82fce5194be048781161d66d8f408324d39fa5b6e8d,988776,2020-09-29 06:38:01 UTC,500159818,500149818,false,10000,0
3d709382ea0c288e6666de13513c3d954e510ee3d96417ba181cbae86f9187cf,988776,2020-09-29 06:38:01 UTC,135142173,135132173,false,10000,0
074f3432fcf48efca975ee75e226c0218e06da4728de94e740e6701405251624,988776,2020-09-29 06:38:01 UTC,8258921,8253043,false,5878,988765
505f72dc9521e1380365051494f57798b2e3d5b3863bb16cea995b688efe2e75,988775,2020-09-29 06:33:34 UTC,500169818,500159818,false,10000,0
52abbc42c6e895d73a9951ad208e8302dcff66e92625876cd65c0ac1a4124677,988774,2020-09-29 06:32:58 UTC,19766945714,19766935714,false,10000,0
aad31f9df8115f0a6f1a9a726540bb8a510d0260f0e052625003baa369d10e82,988774,2020-09-29 06:32:58 UTC,68139538,68130993,false,8545,0
44ec7b0bc4d53baff0f3429433fde820cf130df35a03616a486b26a2f184fdfc,988772,2020-09-29 06:31:57 UTC,1064872434,1064870341,false,2093,988760
7aa3ff508efe34db01d34a175b79ac2d948df7603306f6fa26d3543f7c2541da,988771,2020-09-29 06:31:46 UTC,628817,618817,false,10000,0
b2934496186c99e20bba9cea2bea5f1c67b530df8c574b2898116e10620f021b,988771,2020-09-29 06:31:46 UTC,500126935,500116935,false,10000,0
b150d462256920a87c091357a6a945269048aa126de47c3ff6f36a1c76c6caf0,988770,2020-09-29 06:30:56 UTC,1001802,1000000,false,1802,988757
37a35bb1c7e7397e3a3fe5627d62219ea394827ebc66eec63fb3f406dbafa5f4,988770,2020-09-29 06:30:56 UTC,62599572,62199572,false,400000,0
66ce5c4fcf64745a7588b3e04489157fdc803fe0b538c299f94f756c0880d479,988770,2020-09-29 06:30:56 UTC,50412093675,50411993675,false,100000,988759
73d6e3b2abc385cbedf9141a1257ed6bfb2ad4388756aad6adc304039c157242,988770,2020-09-29 06:30:56 UTC,593828132,593826039,false,2093,988759
699cebdecea220c47ac2be30e35130807a863cd15e5fd25d31ccc688ff85aec9,988770,2020-09-29 06:30:56 UTC,500136935,500126935,false,10000,0
1ff56c3cb8386512a072b0327d3f09b66a23d78077ae95329a9df8f8515b5655,988770,2020-09-29 06:30:56 UTC,143282058,143213698,false,68360,0
3329823efebad2b52c6d0e3e729ce532bd02b85d36212d92846412535e0da119,988770,2020-09-29 06:30:56 UTC,19529773447,19529763447,false,10000,0
675504dccecb39bc63f11c8f986ba4edd5b08933750536832bf0c53a30a8839a,988770,2020-09-29 06:30:56 UTC,1672518638,1672459943,false,58695,988759
e8c978465afa7fb8b606b6ad698eb1635b6ea919252909a19536763080ce7326,988770,2020-09-29 06:30:56 UTC,46545471,46539033,false,6438,0
dc5d53e895c0194605b9faae9a3a71ba6686c65aea1f8527a6c3bc17567b9ba4,988770,2020-09-29 06:30:56 UTC,170223850,170220583,false,3267,0
860ca933e16b6a956f58aaab076ac99c51a13b32f70258f9273299bc2c4ea432,988769,2020-09-29 06:29:02 UTC,499980000,499970000,false,10000,0
0d57efa9b8d668302bd7e4cceb6f7ffade037f0a2d9d86bd6597a2a317de5665,988768,2020-09-29 06:28:16 UTC,3032799499,3032796681,false,2818,0
fa08a5a65bb75fe038d7b48272c730370941ee56b600fd91f7a96a2e166b2852,988768,2020-09-29 06:28:16 UTC,500146935,500136935,false,10000,0
dfc2ca30994d24ba25b785638a6cfcbe5add5d534ee3a859feae6d457bfcf2f4,988768,2020-09-29 06:28:16 UTC,13390000,13380000,false,10000,0
b548aefdaf575b7ba69b72879346315c7e04a844c750d5a47a66cded8fd0de28,988767,2020-09-29 06:27:38 UTC,1729906030,1729904110,false,1920,0
ac6867c64c03acec2fd7ba779b238d324422e474c1ee0078468bb3506661c2f5,988767,2020-09-29 06:27:38 UTC,68189859,68181314,false,8545,0
8bf35d0b1da4192c50fa765100ab82fc4305af2830733d84545ead890a9e929e,988766,2020-09-29 06:26:49 UTC,59120964405,59120964305,false,100,988755
40a4bbeaaf5562c8d48a374357b2a38234392a74b3d3146012adf7764b885812,988766,2020-09-29 06:26:49 UTC,68242958,68234413,false,8545,0
3086a21a178dee21fb223fa50d73c274e85dfb3ed0e827391e410cc74b7f0f6d,988766,2020-09-29 06:26:49 UTC,10637162,10633813,false,3349,988754
844d19c165e5292ff7987b9b6fb43d2eccd7f9c5cf9a6862eaa78b384a67c652,988766,2020-09-29 06:26:49 UTC,59235477212,59235477112,false,100,988754
27afd97ebf5bdda88c56bf929ec93cd37ad0167a2cd7702c62f8af3e8258e961,988765,2020-09-29 06:23:42 UTC,489690828,489688453,false,2375,988754
00d4413fac7a0a7fbb3a0c013c513824ff05e3724d42be427b1e6365d14ed1ff,988765,2020-09-29 06:23:42 UTC,23359487873,23359484130,false,3743,0
899040c016cdee602fcf213e5901957d299606f1ab72380f80d51e641f4efa2e,988765,2020-09-29 06:23:42 UTC,1673690909,1673637119,false,53790,988754
40d5783fe27a1d66649189504907595b75cc3a5f96317317531d49802c638796,988765,2020-09-29 06:23:42 UTC,499990000,499980000,false,10000,0
e33f499aea60b30395c557b900289c6d5e45302bc590bd2dd4ed04c0b4457823,988764,2020-09-29 06:19:23 UTC,500000000,499990000,false,10000,0
26eb27d9f856e75d4b51102e4448d829a2c471c7152cdaf7024a96062a387e39,988764,2020-09-29 06:19:23 UTC,68343306,68334761,false,8545,0
ca6fe310351caab83c06d52ec6fe9a6755653fb04c668cad004f0d930cebf370,988763,2020-09-29 06:18:42 UTC,201384257,201381297,false,2960,0
9fee8733943bd325f26eb4452ee0e90599454ac9c04b8034daf1423a91a40ca1,988763,2020-09-29 06:18:42 UTC,500000000,499990000,false,10000,0
e2e521e37e2c4fae4706bd65d0196da157bd84bf783e9ab3dd2e6fb91719daca,988763,2020-09-29 06:18:42 UTC,68420183,68411638,false,8545,0
a10798968f124d9249ddf25fd463f777b14d3f2662db863f3f7c73d23507e412,988763,2020-09-29 06:18:42 UTC,885044048,885041933,false,2115,0
f0274037ae90075395f4a9bd90e15722f0011c7e966ead5497086d0f51357cc6,988762,2020-09-29 06:15:28 UTC,499990000,499980000,false,10000,0
76095fe43dcaad86b5ae4a76f75b917d9e65818ce325f1fa9275d3cc719f9556,988762,2020-09-29 06:15:28 UTC,1005272,998492,false,6780,0
1ce2c521e2266d496db951b6326d18007a50a65e0fffcaed06f447b18566e2a5,988762,2020-09-29 06:15:28 UTC,283678192,283609832,false,68360,0
cd94ff90f993ec079c8411f56e3bf6807b564c85074a7408ff64b67b4dbe65e2,988761,2020-09-29 06:12:13 UTC,226469456,226466496,false,2960,0
94a0a6d0b54e9e7f64e62deb3d9ac721b61161649d628a1da8966c36a9a0740b,988759,2020-09-29 06:11:28 UTC,500000000,499990000,false,10000,0
0d6a15b43f3e3aef48a3c6fa67e479f0e1e4ae631f1591da9af60ee15862fca8,988759,2020-09-29 06:11:28 UTC,345047874,345030092,false,17782,0
eaa703a545e2f7cd8a0e6f3322cd79b3772fded614cbc97b984515b35f9f57ef,988759,2020-09-29 06:11:28 UTC,500002960,499992960,false,10000,0
76a62fd8ab02b5ae91ee372fa013da502bd25231c4f9975afc6e00f6b6dd159d,988759,2020-09-29 06:11:28 UTC,1674961871,1674906081,false,55790,988748
30a658b6baff706c935f74ab405c86bee573819db02ddb397e675c824c66580b,988758,2020-09-29 06:08:57 UTC,18319838473,18319828473,false,10000,0
8360237a805f7b020fe302597a9929dcb9eface09b07a27afa51d5bb5a390e80,988757,2020-09-29 06:07:54 UTC,989687647,989677647,false,10000,0
b988b6c8332e9fb29b96ef82025b2888a3c4e924390b92d4c9bebeb2b76c9bd8,988757,2020-09-29 06:07:54 UTC,68456168,68447623,false,8545,0
b27b8346ebf1ae7592a3ea7c892c0fa84cef8e2ddbfd19705c8c299ca2d5ac5a,988756,2020-09-29 06:06:49 UTC,243697148216,243697138216,false,10000,0
d881879525f4aa89c8441623ad08956f2e5658a949181fe6d83a118b48663e65,988756,2020-09-29 06:06:49 UTC,2500267050,2500257050,false,10000,0
6757c68ffbf5a229eb9211c894a35b4b77601d4c6de55d058a9026528bdee26e,988756,2020-09-29 06:06:49 UTC,4502222118,4502212118,false,10000,0
eb3d66554bc35f840f897e20e3f5cd5b4a49262ca99d3d0d2a7f70d1d91b42bf,988756,2020-09-29 06:06:49 UTC,510170168,510168084,false,2084,988745
538aa56d31ea34477388686089fc99086a75a762436ba9ba7203cdb713414be8,988756,2020-09-29 06:06:49 UTC,500012960,500002960,false,10000,0
a78aa60030dd9c6e07bec154de9462630dcadc6c1050c5ba15387c3f7e098fde,988756,2020-09-29 06:06:49 UTC,170371394,170368434,false,2960,0
66a42fb0a992eda606eb59adae6eee3964ac112974cee706099b488352b9b3e5,988756,2020-09-29 06:06:49 UTC,40099891,40093891,false,6000,0
8fea875207e9c312f58e943a97629ba3c38d4ee7d5e8684458c10a8a9c23c596,988756,2020-09-29 06:06:49 UTC,499980000,499970000,false,10000,0
a9bf394aa8445b8da412360ceb12c1c86ccb21cb7be12faf30ee0c221b0651ed,988756,2020-09-29 06:06:49 UTC,68487902,68479357,false,8545,0
11e832596f186dd78a7d4e9c00247ffab4f9e0dafe97faf31ce4a7a6953ae7d7,988756,2020-09-29 06:06:49 UTC,59362129828,59362129728,false,100,988745
2321f80e934e6b0c51fba52e5f45fcf234d88677003e7c0b8dd64cdde853297f,988755,2020-09-29 06:03:39 UTC,822516537,822416537,false,100000,0
06c6541d646bc89e9064405cbac3e5d8ca41ee3e78443246e6aa9774a1b9c3d6,988754,2020-09-29 06:03:16 UTC,99347115,99344665,false,2450,0
9ab35660780d581315078ba9c35b373d7ce0fd961972775a301247f40f3733e2,988754,2020-09-29 06:03:16 UTC,229743473,229733473,false,10000,0
52e459013b6d1ef83ef8eeb0f0be0a24414b1b5bae3d6645a06e81232582bd1c,988754,2020-09-29 06:03:16 UTC,457068562,457065597,false,2965,988743
188ddfd47ba201c8694e1989d06cdc8cb5459ef493a169d5dec47901e4f39651,988753,2020-09-29 06:00:42 UTC,1676452573,1676392169,false,60404,988741
e1acfcaaf7c32ecd9443192804efcb78d259b91c4dcf5e885000025ded60175d,988753,2020-09-29 06:00:42 UTC,1016123,1014039,false,2084,988741
f54a57bcf5860bfd6bed4b5f9ce150bb4345eef8f02f4165a23ac026836d213e,988753,2020-09-29 06:00:42 UTC,492092447,492089773,false,2674,988741
e0c8082ec6518de24c1b59ca9073f4e316febd9d19a95a9aa1b4ce01dea1f588,988752,2020-09-29 06:00:10 UTC,306282,296282,false,10000,0
9eb88f9377b2ed881beb90ec04fff70d1d5a0bdb832b58e75e637796b657cdc1,988752,2020-09-29 06:00:10 UTC,30135645,30120813,false,14832,0
1b2aa9c8ebc350f0b9171ccbec0b51917b626c6d42bd3221176e01d504946bc2,988752,2020-09-29 06:00:10 UTC,8910360911,8910330911,false,30000,0
b4b00d86513b10c3636addb6c3204eafa52b4a5372a6538e77e166621da3d88d,988752,2020-09-29 06:00:10 UTC,83006795038,83006792688,false,2350,0
c849798a507b56f05de872e61acc3bac4754fe20c24b692fc0ae0dc9c374f1dc,988751,2020-09-29 05:56:32 UTC,143313823,143245463,false,68360,0
9c24b9a9d05ed8f1c8dc93e7fd827786111c37767e8163c16ee263891adbd954,988750,2020-09-29 05:56:00 UTC,201581227,201578267,false,2960,0
be8aecfeb0d035b9ce743961905fe9f9b53300984fce9237c32fda65a4d9ddd0,988750,2020-09-29 05:56:00 UTC,45008402,45000037,false,8365,988738
b8ea2c505f0c0c257d35360a736797905cbed5ccb220307f51d10d41b9a8b38f,988750,2020-09-29 05:56:00 UTC,11858530,11857384,false,1146,0
3b20d50a31a687a0349ed060fe0f192a356402fc4e172f926a3b52ca9a58b0cd,988750,2020-09-29 05:56:00 UTC,68654305,68645760,false,8545,0
2a0f74862ff35952e616a7c5b4eab15b957538297666a76cf3418b671ac92ebf,988749,2020-09-29 05:54:42 UTC,1677650842,1677581098,false,69744,988738
b80a75f6d0eb70367a60287d0b216606c4be743342bd5a905d13293e208651b7,988749,2020-09-29 05:54:42 UTC,2475000,2468220,false,6780,0
d7b08c090a0b892d32fee8e7f154e21ea6c3a5dedd33a0502deaef94eb45edcd,988749,2020-09-29 05:54:42 UTC,68714843,68706298,false,8545,0
d48060a51fc09d712d8eb4c4d185d73d774bc2d02a406fe42f3d28675796f993,988749,2020-09-29 05:54:42 UTC,167081974,167063974,false,18000,0
540faee956f63ac0535fbc24734b33780d4a2ab256f2a199ddc37cbad8f8c65f,988747,2020-09-29 05:48:33 UTC,99994000,99984000,false,10000,0
73bf6468f94fabb5d6f7319b606d1f07f9b36ae80c7feb3c9008972d576d7cd8,988747,2020-09-29 05:48:33 UTC,100468179,100367141,false,101038,0
408d23e991f565c2c61809bc35b5f8d5767d91426023b75b142981f7a5682003,988746,2020-09-29 05:47:06 UTC,10398842,10392842,false,6000,0
303c17b7a0ad6339d3c159d3da2bdb2d1f7bb6ac1d883ec4ca6773d47119adf3,988746,2020-09-29 05:47:06 UTC,499990000,499980000,false,10000,0
51dc5b636b6745456a57da3eea7cbbe788f0dc715126a96f35a99723c78b504f,988746,2020-09-29 05:47:06 UTC,499990138,499980138,false,10000,0
88d899fabea823cb0ed2d8ccba0ebbca2af1b6339741062e1d2d7e006f33241c,988746,2020-09-29 05:47:06 UTC,100000000,99997550,false,2450,0
df7a3ca3be7c341edbbcebd4e89dba4a47baae9afa8c210115d8cb805310f85b,988746,2020-09-29 05:47:06 UTC,226745315,226742048,false,3267,0
6d61d77b180900dc8a5ba652990cc04a9e3ae4bd0ca2a5b82b208d86b2f65783,988746,2020-09-29 05:47:06 UTC,100000000,99997550,false,2450,0
2bc9a66e0ee9ee86a354f1e165fc51ae6ed0641458670d28c42ef7eb6f7d4cd2,988746,2020-09-29 05:47:06 UTC,68800086,68791541,false,8545,0
05984430cee012ab6195adcbc701b3b29c2db739e50c97033e999bf7932a5700,988745,2020-09-29 05:44:31 UTC,500000000,499990000,false,10000,0
968d38cd07ee54f89e0a118be4dd3b5815bbb25ab65189a8ad87a5b7fe546c10,988745,2020-09-29 05:44:31 UTC,50195113,50185113,false,10000,0
cd5ae54c8c82be583698128d9344feae83ba155a6a830a3e8eabfc866ed98435,988744,2020-09-29 05:43:32 UTC,10000,,false,10000,0
e804bc50380b51d7024085eba464c346b5a72fa063d40ad1f73c7ca7bf07c011,988744,2020-09-29 05:43:32 UTC,189594872,189575691,false,19181,0
c0f5659f65a5c183526c6945faf39a1c16678f712c31c6defadf36fed89cd64a,988744,2020-09-29 05:43:32 UTC,1679136373,1679062006,false,74367,988733
cfc9fd3fcb47805ba2e3bb2a33c264e03160fe4fb3e401ccf9618f6752ef99de,988744,2020-09-29 05:43:32 UTC,14407975,14402097,false,5878,988733
1e97ffaf9b2edde5593f1c05e84ff7e32e39c94f10bf771e243d209a32a7507a,988744,2020-09-29 05:43:32 UTC,1052775128,1052706768,false,68360,0
6fc155732e918809b77d6ddacb3fc1031952626340d4315486c5881b82d4fa0d,988744,2020-09-29 05:43:32 UTC,10008435,10000044,false,8391,988733
61261338e9f217ee1c4d04493afb526a0e3448cd1fc345cb15a70537918bad49,988743,2020-09-29 05:39:09 UTC,500040820,500030820,false,10000,0
bcbc48cd083b254f2fcf014e8633dccc33c2b9d456798f31d92490231a9aaec2,988743,2020-09-29 05:39:09 UTC,129137865,129127865,false,10000,0
f682a64ca03d3bd03293ac63454cef69330404a1b7a3b2a5ee7f56de74998e25,988742,2020-09-29 05:37:04 UTC,544935631,544933247,false,2384,988731
08a67b6ba4bb2d83d1d89d37d08dbdaf74355c882d25be616cee63eaa3dae7c1,988742,2020-09-29 05:37:04 UTC,2085680000,2085168080,false,511920,988741
fa69c9dabe4a12e0594a61e10ea814b519b0b07de30509a808f3b4a905e24800,988741,2020-09-29 05:35:57 UTC,18168622028,18168612028,false,10000,0
ce3bb7fb59acbdaa6b949998acb205b26cec0b0fafcca2eaf2b4180096dccef1,988740,2020-09-29 05:35:54 UTC,170661827,170658560,false,3267,0
3491fafb98f62f407f35db12337bff123b695f04cbdc497d4f6173e896b26241,988740,2020-09-29 05:35:54 UTC,6794,3394,false,3400,0
3e3c9e50952f120c91fd0401f3a52d19067b4842eb55fa1797f9523a7474c3b4,988739,2020-09-29 05:35:03 UTC,500010000,500000000,false,10000,0
b07d5b48e27b47d9f2ba8d146b394a91f1c266aa71a578c54e48c978c298ae98,988739,2020-09-29 05:35:03 UTC,2304471400,2304461400,false,10000,0
fb73e9d5858775e06cf42e41365a27ed2d3309b3ccfc71ae8977180b8f0f5883,988739,2020-09-29 05:35:03 UTC,478815000,478805000,false,10000,0
288c19824b7b533b0acfe56da296b34988143f9a650b40c96bcee84d6f68c61a,988738,2020-09-29 05:33:16 UTC,7176738190,7176718625,false,19565,0
dd9a5e134a70d59b6bad48e0acfa0a268399ccb4aa18bf668e899755886ac0d9,988738,2020-09-29 05:33:16 UTC,747300000,747287720,false,12280,0
7d321d13e19f12994a63df70f941917cf174facea247a5c8bf9d2387cb24bb3e,988737,2020-09-29 05:31:36 UTC,839814696790,839814694697,false,2093,988725
8563af43ecdd5bf525f791077c528793ddfa750d26c4851e1204bfaa2a3d31ef,988736,2020-09-29 05:31:14 UTC,201778864,201775597,false,3267,0
67067a210eb9206185b7172a1bec29be64f70890a9ad71c2c7994f8ab993f4ee,988736,2020-09-29 05:31:14 UTC,4210,2290,false,1920,0
9c2d72f149eeedf743d91700e14b7ea3d07b9ad009603301330260bf5ffb45aa,988736,2020-09-29 05:31:14 UTC,181024469404,181024465584,false,3820,0
dfd89334300381d2f9416cc58c6f36abc206fd48929e0d5f565391af1b895ee4,988736,2020-09-29 05:31:14 UTC,1680663730,1680589312,false,74418,988725
5e58f83b505063d4ce24c43c9e9dee0e530444bf236118a8d70e2e75454504ef,988736,2020-09-29 05:31:14 UTC,500000000,499990000,false,10000,0
caddb11eb2740822a09f599b9aebeb16ed27827dc86e657eab0a5078bac4368c,988736,2020-09-29 05:31:14 UTC,209356880,209354430,false,2450,0
bc58c1e0800f5bd2c1bdb3ca07dfdf965e0f4c23d342049e4c00dc5ec3f7fbec,988736,2020-09-29 05:31:14 UTC,500020000,500010000,false,10000,0
bbea0691d73ff3f48e2629bac537369a6ab85c10e56d5a1095635233e6abb135,988736,2020-09-29 05:31:14 UTC,400904132,400898132,false,6000,0
8b0b296eb4cec851e08f16ddea9c5e3ece99cbeac8bacee364f45c2d23dd5f48,988736,2020-09-29 05:31:14 UTC,8198,4504,false,3694,0
f9ac81b88b819482e64a6af2bd4c0e8df8e6440a11f574df435f7b2642cf1211,988734,2020-09-29 05:26:46 UTC,17934629001,17934619001,false,10000,0
e48c27ad8d94491e634954274075ebc56c759aa67d78d934b448137bc43a9254,988733,2020-09-29 05:26:40 UTC,15000000000,14999900000,false,100000,0
004773a9d0782df8b4cfe38070af93276340e6686d3022ee6be2a35affc021d6,988730,2020-09-29 05:26:09 UTC,500030000,500020000,false,10000,0
767a3b9b8b2e3172115de9a3c96ac03137bca777a1e218a0f8b6e7759b90680c,988730,2020-09-29 05:26:09 UTC,226998726,226994847,false,3879,0
2ab7e4fe651f00d1aec9dcb11aa5d5907e53716c4c07718fcc236e212c1a4cd4,988730,2020-09-29 05:26:09 UTC,840408278883,840408276790,false,2093,988718
9773e79b15febc25bdf7181c25f27dd1a28ecdf0c37898050a4ce63b7eb227c5,988730,2020-09-29 05:26:09 UTC,499987000,499977000,false,10000,0
0c2a6d770a79b967bf36a0727cbdf2f4ab2998bec3cffaa1dadf9d31c1ee34df,988730,2020-09-29 05:26:09 UTC,17532213755,17532201751,false,12004,0
fe4fc24c9c80359fa62b9d28c14bfb2e5d028fe91fd9038b8606166bdcd9fa5f,988727,2020-09-29 05:22:23 UTC,50423093675,50422993675,false,100000,988715
2b48f446c1094f42df0a30b1b511c82ed1e3fcf05d1c7fe1ac8e7c2151a2550f,988726,2020-09-29 05:21:53 UTC,68854545,68846000,false,8545,0
cce51b32b49759f5a5aef1151d5956eaeedb84e88941156a0579daebb8ae84aa,988725,2020-09-29 05:20:46 UTC,143342383,143274023,false,68360,0
2905bacc76f6d4bccab01cbdd0785b1999aa4cf38e7fd1791ec4063231523da5,988723,2020-09-29 05:20:20 UTC,1682246952,1682172543,false,74409,988711
24342614264622dedd1d8ffd4edf0fdba83433114109edea03b4d770b315d8d6,988723,2020-09-29 05:20:20 UTC,1261703866,1261701606,false,2260,0
0d767e0b6da4f4a638ec4841ed78c836c566c6d22272ebb84140f128294f6bf4,988721,2020-09-29 05:19:42 UTC,7211523296,7209430406,false,2092890,0
76e65274032f8cc08e63b309021528ca5f07b1fa47f970373cc796257cd6744d,988721,2020-09-29 05:19:42 UTC,498554746,498544746,false,10000,0
5538b8ee74e17ca65a7589bd11ed842acce796500f86ed9949351841013d970a,988721,2020-09-29 05:19:42 UTC,2420827478,2420825394,false,2084,988709
53bb76ff016116c1979ca6932677d758801cf56c7e1ea166161dca802e76d5c4,988720,2020-09-29 05:19:19 UTC,2822485236,2822453376,false,31860,0
ba8f0638305d6d557adb437015b4b9c2667ae41e7358262cde40d32d0a988057,988720,2020-09-29 05:19:19 UTC,40644,34644,false,6000,0
324c23f671388426b598772c50f8446ab884770bd2ff6f075a45a3ab762df094,988720,2020-09-29 05:19:19 UTC,7610,4210,false,3400,0
65855ba52a918ffb4e07976fd9f51a6976dc44dcc8524d5c9f1081223d4f438e,988720,2020-09-29 05:19:19 UTC,103910462,103906712,false,3750,0
2292832d76888f3cf4d9693cedf6b4d5f71184e954570eb75100c5f7bedbf58d,988720,2020-09-29 05:19:19 UTC,43908,19908,false,24000,0
90421a16ace51b4b9457d302d9fe544ce5efb0d2695aef2ebe36ee7ff1dddf13,988720,2020-09-29 05:19:19 UTC,577254280,577252187,false,2093,988709
1be80dbd4f8bf87c942ed4e2cf372298ba99cccd8bb8973d3e98a361b75508ae,988720,2020-09-29 05:19:19 UTC,261406763,261306763,false,100000,0
13f5d4665fa69f3bad93fe34a1daba6079ad48ae34e2f8a0f72fc0bc6c4730e8,988720,2020-09-29 05:19:19 UTC,13559,7559,false,6000,0
502b2fc4e7022050e299f2787b48bdcd380d1a7c248688fcce6a35bd6a847ee6,988720,2020-09-29 05:19:19 UTC,202299948,202295763,false,4185,0
5a38e7bcb47af1a7e58e4aa79296aab2d932b96b906b8136567816284b1baf91,988720,2020-09-29 05:19:19 UTC,13177,7177,false,6000,0
53b9a22edb65299b04e46ddb2c32066cd7ce1bdc16ed85ee036e16f67f482130,988720,2020-09-29 05:19:19 UTC,16544,10544,false,6000,0
8e27d2c61a1bdc1121984d3060dc1bb96dda289c1dd9f32ab67ae610620c9393,988720,2020-09-29 05:19:19 UTC,23225830,23218687,false,7143,988709
152b662053b73cc43e8bbc935675f08da2f9c726e51150fdce8edf3cb5334306,988720,2020-09-29 05:19:19 UTC,170811898,170808938,false,2960,0
e3ea3967699bbf8e91494d52665dd7835b37ed81357e4c9d8c45a9b905b989ef,988720,2020-09-29 05:19:19 UTC,895334277,895322383,false,11894,988696
3d64cbfb73ec4eb0ee9b13e99b186f04e5fd0cdbfa48e55c7eb0efc684dc5683,988720,2020-09-29 05:19:19 UTC,17499470000,17499459800,false,10200,0
dbfeeed91b1cd19c1db8580faea73260bc9e0f82cb8f1306849696bb955b7a0a,988720,2020-09-29 05:19:19 UTC,499997000,499987000,false,10000,0
cb9f015a24058b29b4205d529a97967698d9d7451f65e270cd38fe95ccf3cc45,988720,2020-09-29 05:19:19 UTC,31353029,31349289,false,3740,0
8d3051bda56f7f542c0af08f5b0055875db7fe37ff6b1ff7d5f5ce079817a2c8,988720,2020-09-29 05:19:19 UTC,31144,13144,false,18000,0
91a05fce84b440b2d4eec83a0f83a28486a64c00864b6460ef39e76326b40eaf,988719,2020-09-29 05:14:53 UTC,500007000,499997000,false,10000,0
0973c914607f3fa39fb2f01a27965cd940433a8e5486f393740f92751a863a8d,988718,2020-09-29 05:14:46 UTC,132667,6667,false,126000,0
ce798ce417b8f1fdd6b98a34b3ac1e6526e492512ad4e637a947a3071b77e8ee,988715,2020-09-29 05:13:47 UTC,68896513,68887968,false,8545,0
64219081c2433628792c78e10b5db4e4607dd6e812619ef0491cdeec5acf9f6f,988714,2020-09-29 05:12:38 UTC,227400436,227396863,false,3573,0
7709065f09e995bbf7a284c41db0e43557be4338d30d2cb55224b95f1f2f69d9,988714,2020-09-29 05:12:38 UTC,68946452,68937907,false,8545,0
7c4adf35efc4588d20217969fe8beea283edf1e0f17871d237066df95315baba,988713,2020-09-29 05:11:57 UTC,86378997,86368997,false,10000,0
dedf455ab96a6a5f5d0d42e101892cccd525425d601f413b0e562c2384b7f528,988712,2020-09-29 05:11:26 UTC,123020268,123000466,false,19802,0
085beb8555fa86fc274622cc2d627a171bdebf057e9d8059db19663c474a0ea6,988712,2020-09-29 05:11:26 UTC,1683773440,1683699056,false,74384,988701
3b24e19fb78214415585811f8a53892af249d575c0981912c1b3589b0100ae71,988712,2020-09-29 05:11:26 UTC,1038472,1036379,false,2093,988701
57a7baac55be91b1e5046bab6589b7b6988ce77ced81b894b8fbf70d9b88572c,988712,2020-09-29 05:11:26 UTC,83543223797,83543221447,false,2350,0
43172c3dbdacccc33ba4c5e5a553c8a4399ae04b9caaedaf12e93433b7cf03bf,988711,2020-09-29 05:09:59 UTC,500000000,499990000,false,10000,0
b9823548ecb9d8981a8a232c5c65d31bbbf121a724e806305f513ead3a9c0e4c,988708,2020-09-29 05:08:07 UTC,199459820,199453376,false,6444,0
8c4fbe4b3042b16f214ad5c517244347fa9227c6c1170ef1193b9323ded00c18,988708,2020-09-29 05:08:07 UTC,11631968887,11631966794,false,2093,988696
546c7ff1171e7e6f057db1db43d08bb98bafceacc0bc3d38bf2c5f01bae6dc12,988708,2020-09-29 05:08:07 UTC,500000000,499990000,false,10000,0
4bab99a060d882465b9aef5cce35f23866a5d48e585caa0adb97693d551ce1cd,988707,2020-09-29 05:05:59 UTC,242552469505,242552459505,false,10000,0
34a37a913ac426b36e7851258fb34c5d9a619c439b82e071b00e4aae0ce5e1c6,988707,2020-09-29 05:05:59 UTC,500002960,499992960,false,10000,0
8f52744ade067595a57f881815b0ef891b06faad494066f058f8bb792c6f8f7c,988707,2020-09-29 05:05:59 UTC,2500277050,2500267050,false,10000,0
f0b1d91f0a6a0893f7bc80af5136abe6329d342dc7bdb526633ea3ca340b69d6,988707,2020-09-29 05:05:59 UTC,67465841,67454947,false,10894,988695
38fb526b5cd44d7d2f72fbcfbbc49811701babc438429d055e9ea09ae7bb0dfd,988707,2020-09-29 05:05:59 UTC,411501383,411498933,false,2450,0
da1eaac888412634c007548bf0d7d3d0df2b183569a6c710aba3e22dc3e9706e,988707,2020-09-29 05:05:59 UTC,5262315,5259865,false,2450,0
c9e26883525263ff5f939ffb0ef255e011a451564cecd2ac13cdb725e9c376f1,988707,2020-09-29 05:05:59 UTC,202457205,202454245,false,2960,0
43bd78662e6eb492effea8882f1e82ef5d165a1589bfb7c8650d8966c649bea5,988707,2020-09-29 05:05:59 UTC,490960256,490948256,false,12000,0
79d43baf6ff7f7b996f0ed0e697245922a89a8ce141ca68f1c8a30d48eec0371,988707,2020-09-29 05:05:59 UTC,1500531012,1500521012,false,10000,0
189e9273cb7390c5f7bb98fe21c02700af81ebfa1b548a0af7b09143e303c5fd,988707,2020-09-29 05:05:59 UTC,12089220,12082085,false,7135,988696
59b28d000c2d99a2a5be1c93e1012297ff64d6e625e9f48d693dd37b6f3a67f9,988706,2020-09-29 05:02:38 UTC,572220546,572152186,false,68360,0
ad0e02f949a2d71f4403ca7479a26ef9f5d424ac4a687679aea9858d85cf1884,988705,2020-09-29 05:01:20 UTC,43322398,43318468,false,3930,988693
098489e0d19c22912d34155b8f2fed85590ab46de7b395f89b4fa7aa0390925a,988705,2020-09-29 05:01:20 UTC,7500468900,7500465935,false,2965,988693
fb051d3740092ec66d1842393a1398635ea7d83178c2f8888e199402c3bd7570,988704,2020-09-29 05:01:09 UTC,283771135,283671135,false,100000,0
e80dfb380e8d7c91501d51aa6b1b130a0ecaafd7581ebfb94be8871841e44b06,988704,2020-09-29 05:01:09 UTC,10000,,false,10000,0
5160922efe87a374833029312116fa2744d0d8b57c2533635fc2c919d1282eb5,988704,2020-09-29 05:01:09 UTC,597235542,597233449,false,2093,988693
c520583bea5f7bfb951473d4a8623acd88103d464efbb1880877cbb126a6e92b,988704,2020-09-29 05:01:09 UTC,106464,96464,false,10000,0
86dff05045168e4b509c8784614eb60ca42b904b41d33d9caef6850179c0d4e9,988703,2020-09-29 05:00:06 UTC,357573,347573,false,10000,0
e3b30bb71a417a0bdd4f17249851bc439ea94b289785e581c72aa2284159e6e1,988703,2020-09-29 05:00:06 UTC,227615038,227611771,false,3267,0
c0e89362dc5dd0e859e5a1d15a0e9002f2dbbac09830138607b056ff0ab95c5f,988703,2020-09-29 05:00:06 UTC,3005863703,3005363703,false,500000,0
d8cac2d3b11c1cb39921e45cba5bd59e50082ede5cb5dbe456686e9bdc2679c5,988703,2020-09-29 05:00:06 UTC,1685826378,1685752011,false,74367,988659
8de9da1aa2c10abfead7ed5c17ffa29d7471d789437fa56bda6805c0a6841d9c,988703,2020-09-29 05:00:06 UTC,15001200821,15001197472,false,3349,988692
59f8eecea5594bae1ba54aefd2216029b8e2c3d216f9c45f4f6e5729b1f15140,988702,2020-09-29 04:56:57 UTC,199659711,199656138,false,3573,0
fa5218892a29193baef59313f1f3df84204bbbbadbd4a3c225edaf5be3d9ff57,988702,2020-09-29 04:56:57 UTC,69084522,69075977,false,8545,0
d4a859821f423221a557f22b44dfa4919288fd1b987178bd31109547b9db745c,988702,2020-09-29 04:56:57 UTC,69147290,69138745,false,8545,0
0b2516c5216e4d78f672a78c913eaed96f312e22489c3f4c28325bdae87ffb0a,988702,2020-09-29 04:56:57 UTC,167447239633,167447235813,false,3820,0
3bf0e6540f8c51c5223f4b15e028d5fef79923608e60b0331bd40bc02f6d1fd8,988701,2020-09-29 04:54:46 UTC,69186356,69177811,false,8545,0
3b614185f7479d7564433316006bad126f5e2e2f93dc8c620705df79213f0f85,988700,2020-09-29 04:54:17 UTC,121640,109360,false,12280,0
cf215ddaff0e5bd9b42388f0d8318cbcef91cb601d857d017a0b2b693c5db6f4,988700,2020-09-29 04:54:17 UTC,102434,99984,false,2450,0
a073f87c70d5e2da7e21f61eca1c0d31c1e4ef9f8eedbe3f85dcb752da44039b,988698,2020-09-29 04:52:51 UTC,1687296001,1687221643,false,74358,988685
87be231e6d7ca6da61dda919a3ad43237b85208b8fcae230b367b01290b4990a,988697,2020-09-29 04:52:47 UTC,2199900000,2199896642,false,3358,988685
92035d7fe18db9a83e77c4c45c9251509879b6f3c2a3d761860e7a8cc6eb72a9,988697,2020-09-29 04:52:47 UTC,1455675,1445675,false,10000,0
574d9113461551b56a96b5ea3e64bd39efdb6adb622da1ad374c8c7cea3d3a1c,988697,2020-09-29 04:52:47 UTC,98789324929,98789322579,false,2350,0
1e70fa4c2782843cbca93736cb84434939629150cb699372cd5a093fbdeb1125,988697,2020-09-29 04:52:47 UTC,116408567,116369944,false,38623,988685
7e728b522666ea96fa4f64a065a9b48d5971c08177cdc0b767e1bd9d7e14644b,988697,2020-09-29 04:52:47 UTC,202804918,202800427,false,4491,0
c6a90568f8148354282128c63509f62e8da9613fd8a39d1c6be17227e4b16970,988697,2020-09-29 04:52:47 UTC,8609490,8589490,false,20000,0
2f9a8facc40f35e7b0e537f5fb2092d3476b5980a3d8028762ed50c044e4e785,988697,2020-09-29 04:52:47 UTC,120434,102434,false,18000,0
1dd36d13c3610dc6776e44fe6d2f9406d2427c99df0f61c754d489d1b5fb33d5,988697,2020-09-29 04:52:47 UTC,2000000000,1999995677,false,4323,988686
72be9ebfc3b938104e79dd17e461ec85e5b6576ba4d244142003c46d82a2d8a6,988695,2020-09-29 04:48:31 UTC,321528003,321515383,false,12620,0
2ad8662958f3885325ed8735f8ecbd9ec1b7db43f2a99d099e15a71ddfedac1c,988695,2020-09-29 04:48:31 UTC,227778333,227775373,false,2960,0
2fb1581a68030aa1390c7b79930daf2ed8896b94ecc470b1e0981d80c9e9b61c,988695,2020-09-29 04:48:31 UTC,840429035526,840429033433,false,2093,988684
8d703c0653dd2085ab63a660d36059b927534f99a0b5efeb520283e210fd9860,988695,2020-09-29 04:48:31 UTC,100010000,100000000,false,10000,0
d9a73b6b49ea1272276489a303ea76dd3210032891a24c1eb989451a98e71e7f,988695,2020-09-29 04:48:31 UTC,55240964,55230964,false,10000,0
8884e1e832b0175cbcdb3e9b7399c91d9972f49aa0b1ad141e2f01e9ec4d7c0f,988695,2020-09-29 04:48:31 UTC,700000000,699998080,false,1920,0
adcc5deb69cb03d1c24b8b3b0fa2091f815f3687e89f3836e8af554c108e244e,988695,2020-09-29 04:48:31 UTC,69391383,69382838,false,8545,0
360717d23d14cd01445df92fdd0f321085ba1cde16325e453dd1fac28a9fbdf4,988694,2020-09-29 04:45:54 UTC,230000000,229998080,false,1920,0
b8a777cca9078e0ab0db219dbd52aef0a6cf25504e667204949d52d88ffefda1,988693,2020-09-29 04:45:46 UTC,17864267020,17864257020,false,10000,0
3823443a23e05c92a83c0659bc322c27227ead759626b47274bb83403d38f186,988693,2020-09-29 04:45:46 UTC,283839495,283771135,false,68360,0
1e540c2a655c3878483540e455d6dd38539e4dfa4cb226d2a94d6126fb781879,988693,2020-09-29 04:45:46 UTC,7252861,7242861,false,10000,0
3e0cca8ae69cf2ba1bcfc83b7d39facba59b9e2b87fb6ec39900655de09a9b04,988693,2020-09-29 04:45:46 UTC,500000000,499990000,false,10000,0
5edc86b10b3e2ac48bca11f0c13680186c18237f8067d41777d283f2a446211b,988692,2020-09-29 04:44:54 UTC,200130272,200125169,false,5103,0
e9ccaa48208a209e9a26345fb1f7a0d99ec3b1b5e531d737bb7ba7bf05a6ef56,988692,2020-09-29 04:44:54 UTC,759970845,759855317,false,115528,988681
0b1644c0622045299eb603527cd339504f15503dbee2ecd82a42a1e4dd4c4b66,988692,2020-09-29 04:44:54 UTC,101827424,101816518,false,10906,0
52ca6c8c2855070f85dbd0c906e44cb6fae0b3c2ebcbb10b210752bfcafea9c3,988692,2020-09-29 04:44:54 UTC,18547810684,18547800684,false,10000,0
4af63cd70f0cd8df1cdc450825d3b6ab76f0b443a8727801421583d93611fcc8,988690,2020-09-29 04:42:22 UTC,2558555747,2558543372,false,12375,0
75d2cbb39a7c00cb4dc83e38918a8c9d0792105ce31144751c6ea82f18c78f7d,988689,2020-09-29 04:41:57 UTC,69482410,69473865,false,8545,0
0aaed49512086c70cde70d0650cef7a602026507faea72fff3286a012773d7a4,988689,2020-09-29 04:41:57 UTC,319815108,319795108,false,20000,0
7879630408ba8b666c4ed5b8b87c3aa69f8e049f670e01d4e92dcc19abfe54d3,988689,2020-09-29 04:41:57 UTC,1688924657,1688850222,false,74435,988678
072542515a1bd63a42e2a63bf4a859decece141cd09b2c51f25d2a27275d3447,988689,2020-09-29 04:41:57 UTC,5994475983,5994463608,false,12375,0
c8c40ab0630697df439ec1fbd94fff5308e0fad464b9a6bb728c16de45a8f8d2,988689,2020-09-29 04:41:57 UTC,5150795,5136725,false,14070,0
f707a5060f73dfc53553824c8470c883846426993ad3f9c0678c543fd955e755,988689,2020-09-29 04:41:57 UTC,3221541580,3221531580,false,10000,0
e6394f4015ad8ebd0ba3a2b457aa0a498eae3e9b1cb4dee8d7497e4322ec7717,988689,2020-09-29 04:41:57 UTC,196848,172848,false,24000,0
a52e5f6e1a21b982ec6673149d9f18406d21c83dfb9cd98c5ff9606006077d88,988689,2020-09-29 04:41:57 UTC,5130000,5125000,false,5000,0
0667553d5dc8097a4c289af2f689c03bed1d8c307b2f71e1581eca8dbaef7495,988689,2020-09-29 04:41:57 UTC,69444907,69436362,false,8545,0
809b2460a0f3255ef97fa534971060162bdc956075f7922423b49d3bcacbb56d,988688,2020-09-29 04:39:33 UTC,341835108,341815108,false,20000,0
4e50ca4399e48bef4438645e3875cd5d1d5ce08765bcf2fe06bab7e88ef1f0be,988688,2020-09-29 04:39:33 UTC,1977995993722,1977995991629,false,2093,988676
43bdaebad8548f13ad52146c9cdbc3abbee6c7a21b15b6d69d59b5abccd57d2b,988687,2020-09-29 04:39:15 UTC,203030661,203027701,false,2960,0
7861313e614c220bfacbb20de76b1935df70c1c9974e90278a340e94317d47ae,988687,2020-09-29 04:39:15 UTC,16015954,16000001,false,15953,988676
781940921155336c6448454260648212b74fc0ef2582b6cc361a8431c2d72a1b,988687,2020-09-29 04:39:15 UTC,5037384,5028839,false,8545,0
1a7a42c144b4215a65d3951df446929ad6efe55659b07be218f311f657f1983b,988687,2020-09-29 04:39:15 UTC,228013501,228010234,false,3267,0
d7b7209fd926a02c0c0e3a4654ded41ccf13840ee7e19bec2d46645bbc257771,988687,2020-09-29 04:39:15 UTC,846423513602,846423511509,false,2093,988676
699a95c3c43fcee4f6c07d095c41d412b4ddef56f0a42fdf77c26e9fec5e7308,988687,2020-09-29 04:39:15 UTC,69736978,69728433,false,8545,0
d61e46fd6c6b2057d72f477d46fa5fdf5005715a420b1ee7cc09cf8cc5d907b7,988687,2020-09-29 04:39:15 UTC,85136,73136,false,12000,0
c964d69e8eea607d3fe5d6b3bd8e3bd4964001ec1a022341f2c3cc5d1a82ede0,988687,2020-09-29 04:39:15 UTC,8000511567,8000501567,false,10000,0
60c1e2b4fb9be634f684d55d590405b9963a3132e40d282bca19fb727a0b620d,988687,2020-09-29 04:39:15 UTC,10249900,10247872,false,2028,0
9f1564cf536f956515c76d50295cb21e0ee6a999a77adb7e6fc4c6694dfc260e,988686,2020-09-29 04:34:17 UTC,200312881,200309921,false,2960,0
d94a704fca908c57b0f085471da4b9739480d69518e2fd48f2528b085c32233d,988686,2020-09-29 04:34:17 UTC,23252150222,23252137847,false,12375,0
433bab3c5a48e5f4983159e8070f0f765e3345b296fc6f322b54226ea2d9dd8a,988686,2020-09-29 04:34:17 UTC,4512,3366,false,1146,0
e9c71e36e9beaf0504bf32538cd580e588393dab9a8f6a4ef3ff535b3e5af4ad,988686,2020-09-29 04:34:17 UTC,14577083,14567083,false,10000,0
ab9a9c1c7d41e42341a7cbb152132fd508b207595a0e274bfd8341c32cf7d501,988685,2020-09-29 04:30:15 UTC,1690369479,1690295061,false,74418,988673
7bc7728259c6aa8ce59a8b68fe0e4f217e454bf743e09213bef8cdb62f12faa7,988685,2020-09-29 04:30:15 UTC,104153278,104136584,false,16694,0
81d7e329f31cd910dc6da79002f07ab57f5ae605223ba299e55249b530f40927,988684,2020-09-29 04:29:58 UTC,69765785,69757240,false,8545,0
8488ab51e332e1e24058347207844a29c4e0f1829545254d4eef209f26a6fcd2,988683,2020-09-29 04:29:31 UTC,100000000,99997570,false,2430,0
df1467be7c6d6841eafdc9e2891ade6ee7471e8185e3885f996b9613748f4a24,988683,2020-09-29 04:29:31 UTC,228507874,228502771,false,5103,0
17e70f938fa5bea28a471df8bd15fa706c076cb13bbe57b980df636f9b405734,988683,2020-09-29 04:29:31 UTC,69863725,69855180,false,8545,0
9261567a2a6414d46b160d6785521016c69e9e8d7dc3b75d77c441085e200e73,988681,2020-09-29 04:28:27 UTC,500003804,499993804,false,10000,0
3a298f312d995238deeadb5e7dcbb1a42d722222d55b70e24dbb67e088a54835,988681,2020-09-29 04:28:27 UTC,500001421,499991421,false,10000,0
a0b737bcf53b4caa355f355fedcd031b7467558085aeef362ac4e5e040875be4,988681,2020-09-29 04:28:27 UTC,25033092,25030662,false,2430,0
bf97ea4642753eaf963c1a1ac16e3450a6800587de619e25d1e6d6fcf1d12cbf,988681,2020-09-29 04:28:27 UTC,431798300,431729940,false,68360,0
e42304503014917331648ebd664e0557e19262133c5cdfda629db74b23606b0b,988681,2020-09-29 04:28:27 UTC,97318064,97315804,false,2260,0
394a34ae9d0336ceb6f1a9dded4f95de6e77a4708025dc9d8ae8ab9ae05be647,988681,2020-09-29 04:28:27 UTC,70182277,70173732,false,8545,0
623cc33e2d422cf45f819b2fb4501d5da0bb49b4d900fdaae0cacf6d1c2710fb,988680,2020-09-29 04:27:13 UTC,203181490,203178530,false,2960,0
60b3dddd7a4b3cce6d65bbef83db4faba7d29e775731b92e1bb403df4bd3e260,988679,2020-09-29 04:25:36 UTC,16319354,16304978,false,14376,0
d1e06a4e73342e04ebd06e3ceedc26cdd607b07b36b0805a5f9e15371e0f005d,988679,2020-09-29 04:25:36 UTC,616140196,616138103,false,2093,988667
0218c1820c240ea3d6d8d173a3b0424aa762d59bf0f30fd8946bb1afd9de5762,988679,2020-09-29 04:25:36 UTC,70228320,70219775,false,8545,0
891564a202ae62e1d016524e70fda580732fae465254f75037015e78cbedd7b5,988679,2020-09-29 04:25:36 UTC,8000570475,8000000037,false,570438,988668
934388940360706edec87d57c67f8a895401ab19fdb3172b85633596b0ed5360,988679,2020-09-29 04:25:36 UTC,33784302,33783302,false,1000,0
d72596bef2c342b35e5016095daf7e62b32bc0c0dae0b4c6108ffc8ce431db2c,988679,2020-09-29 04:25:36 UTC,1692103932,1692029582,false,74350,988590
010ce2356ae985be3cd7caa97cc5f8efe2520d54b9c496ba6830851a52c7f093,988679,2020-09-29 04:25:36 UTC,222865650,222863200,false,2450,0
758806fb5a9d63820683baffb2e06ef53f1a9b48fb6918f406fc6fb1f578d0e7,988679,2020-09-29 04:25:36 UTC,846633015695,846633013602,false,2093,988614
b7e1184719d8f924fec6c3260e376748c36488778e718893b823b0e758dc1e29,988679,2020-09-29 04:25:36 UTC,500011421,500001421,false,10000,0
e3aab69ff1162e3a2c149015524fd6152c2d1a9dfb95e383bc667f935f6176d4,988679,2020-09-29 04:25:36 UTC,70280033,70271488,false,8545,0
2da5e326ae6515d846cc40ccf1282f2e9945ff237f76447cc1851ef7883b74ea,988678,2020-09-29 04:22:19 UTC,70512639,70504094,false,8545,0
136e96548c5d17c31c3d001f2550fcbe6486a08cf489e8680d25ef951ef30a7d,988678,2020-09-29 04:22:19 UTC,70476100,70467555,false,8545,0
83c3b28a9e67fbf67a7647b08340bdecbc91e16ebb9195ddcdceb9cb629d8fe9,988678,2020-09-29 04:22:19 UTC,921478614,921472614,false,6000,0
34920c2333898c72ce85757d5bad6d8ec19f1f0522ac78d54be0a42e5ab5a05f,988678,2020-09-29 04:22:19 UTC,200602621,200598742,false,3879,0
aafe490745c654f339dbb18f83a9677b86f8c3481c20c5d13754826d5d31b086,988676,2020-09-29 04:17:43 UTC,70555505,70546959,false,8546,0
c450e0322c6ae3b8a7a238f79d2a4b2d769b7421e88567b8008212ed2c66aba0,988676,2020-09-29 04:17:43 UTC,228616018,228613669,false,2349,0
24b1dbdbd4560154e0cf4dd69590b90222eb63a3c730c5be47f74b6e56b1ace2,988674,2020-09-29 04:13:44 UTC,500008545,499998545,false,10000,0
3317386fe98ceb7729565ff6b9755a7eb5a98035a153a87901de69b8244af68f,988674,2020-09-29 04:13:44 UTC,122576000,122566000,false,10000,0
b3b402d2dce25f82447ad2201bd7afa63518ba67db50fcfb4b4127e3ba5cce23,988673,2020-09-29 04:12:17 UTC,1744468275,1744458275,false,10000,0
f61d941dc3e917785a2d9ab47560f6d21cc8e9a2c1558fef5fe4a9fe7dbfd5de,988672,2020-09-29 04:11:36 UTC,70639025,70630479,false,8546,0
1c2c5a81fff94b3d7cd67df34fcbeea1e4ecea38f934154ec2c20616fa230521,988672,2020-09-29 04:11:36 UTC,447780000,447770000,false,10000,0
1f1fc9d7f75fdc24e2909e792362699a51d1b6b23eafe016871ccae231a09f9b,988672,2020-09-29 04:11:36 UTC,143400986,143332618,false,68368,0
0568e2ea4cd89c6e4951198bef1a5171fb4523fa998cde60e9f0317ed8d65179,988672,2020-09-29 04:11:36 UTC,1694179407,1694105049,false,74358,988661
77fafd608c8ac07e462970763e3bcd713f7b8f075cae52f827da1285728d16ca,988672,2020-09-29 04:11:36 UTC,70691182,70682636,false,8546,0
cd2b148aa4fd422743962c1cca6669cfe2c9480c2dc0279f5ac70b4baba74fa1,988671,2020-09-29 04:08:20 UTC,768753449350,768753447000,false,2350,0
83057507911f4c6f63eb269241c55c49e303dac95e60f72f51f445b5b74afa2b,988671,2020-09-29 04:08:20 UTC,500024927,500014927,false,10000,0
1e930d167576b4cdaa99d0bac5c7a08f2a9148d4fa9194812955eb4bec6a2d00,988671,2020-09-29 04:08:20 UTC,47897966057,47897950477,false,15580,0
2925975543a6d220ea6e31cba6897d8bdf646ab1e981c08108abacd39024c20d,988670,2020-09-29 04:07:19 UTC,130257062,130247062,false,10000,0
b420f9d74c85a5b3d94bf9601b768bb46f36d8c9d1b5b8399f8b3d5f1c0b79f7,988670,2020-09-29 04:07:19 UTC,1500000000,1499990000,false,10000,0
79962b3db5a56a04c9d3f2f3c1769cc18305501f6a6b0372f387f071e174cd27,988669,2020-09-29 04:06:28 UTC,203387253,203383986,false,3267,0
e0a4f4d42009a6722aef040e69faa2390f63c3e49b453c760f3813f2e627b57e,988669,2020-09-29 04:06:28 UTC,146010336,146007886,false,2450,0
206590913b02b464299eeabeb4e1ab86ea1d211d3772217e4e3bd020b751152c,988668,2020-09-29 04:05:49 UTC,1500541012,1500531012,false,10000,0
4e8673781ec474d293b28997e4f53bb5d0b7218c22885cef862e9743b9c195a4,988668,2020-09-29 04:05:49 UTC,1222130000,1222120000,false,10000,0
808c165555d0e1093742dfc8d781f4018f633b72ed737e0cd3f516871b0d6425,988668,2020-09-29 04:05:49 UTC,2000055540,2000045540,false,10000,0
f4213d8e91e83c9868bdd75bd8ac230ed2aab7ac9b6207e2015222c12180f828,988668,2020-09-29 04:05:49 UTC,88369746,88367486,false,2260,0
114e20f7677d01b037bca6e88ce8d733c4f7f733fc75ef620faed5658e277a42,988668,2020-09-29 04:05:49 UTC,642189010,642186917,false,2093,988657
d37d3435bdceae193972e86dc8152e862d8ee6a8702f787d80ae2f3acbdbd70e,988668,2020-09-29 04:05:49 UTC,59782273,59776273,false,6000,0
35ad716fcdb844d714cdc12cbd92f685bd052e38e0de2198fb77886e8d08e6fe,988668,2020-09-29 04:05:49 UTC,3000479538,3000469538,false,10000,0
2bc49ef475c1d021dee8bf396f9a43c3b194c33786c163b43decb3cad8009ad5,988667,2020-09-29 04:04:30 UTC,240974982323,240974972323,false,10000,0
4a92cd51cea896daf579758ce4c1366edd4c52fa0b1c0000954936a5349baa0a,988667,2020-09-29 04:04:30 UTC,11807153194,11806863286,false,289908,0
a23d5a0b0f67e3a077badc8384ec0aacfe957549e4da86861911adef57b973ed,988667,2020-09-29 04:04:30 UTC,1166623256,1164529428,false,2093828,0
31c1d124b2110c9e2cdf90fc8fa104343cf8ee89307db0f0d2b05dddad781e99,988666,2020-09-29 04:01:52 UTC,98880000,98860000,false,20000,0
886589606362714fdf9fa951efd01279ba82e9c818457a25f1311049219612e8,988666,2020-09-29 04:01:52 UTC,1500039604,1500037511,false,2093,988655
92b9950b32ce55acc7103ecb6593f934f8ae4d3e121e60b6804b1d5fe062f177,988666,2020-09-29 04:01:52 UTC,1696133440,1696059030,false,74410,988655
4560a5b3dbd7197082887d47d705badbac79259746ae13cabd723003084bc867,988666,2020-09-29 04:01:52 UTC,70733309,70724763,false,8546,0
31e3b40881e6de7222facaec80769e6c508b12e463bdc6fe7c993f6d967147d5,988666,2020-09-29 04:01:52 UTC,220085159,220063026,false,22133,0
20cb3c2630ad274c14ad1044d7de8267e13cee09dd9499fcc5f2e5c0eef602ac,988666,2020-09-29 04:01:52 UTC,1222140000,1222130000,false,10000,0
4809628be5081191a08037f9da5bd5c9fec47f4eeed73f68097123599cb2cf32,988666,2020-09-29 04:01:52 UTC,95869041,95867121,false,1920,0
9b6d07d0338ff70f60dcc14221ea36de28deb80d4ee9fd2681fed4eabe71ca5a,988666,2020-09-29 04:01:52 UTC,26667434084,26667429507,false,4577,0
9f5ce054323bb90ac612d3279da403cbe1d6b02c34a6845d21a431bff273f345,988666,2020-09-29 04:01:52 UTC,89419699,89416443,false,3256,988655
1cd6d35030cae75f3fec6775acc83d509956670e4ad26ae8e58c74b041f331af,988665,2020-09-29 03:58:49 UTC,93285345,93283260,false,2085,0
e762c0722428bbb88c2d5220af545bb777940a40c415687e4dc78f8c6657cc95,988665,2020-09-29 03:58:49 UTC,191741301,191739041,false,2260,0
64abc5e7add84b4314cf72ae590e47cdd900f39d29fa074cb8c8e2ea9b4a6b88,988664,2020-09-29 03:58:24 UTC,200881024,200877451,false,3573,0
44e90ee61a14ecb64b3798d7804b18ca57a2de569d974b8a394ad3576bf5d459,988664,2020-09-29 03:58:24 UTC,5734169869,5733862296,false,307573,0
16ad670392ca0e71b0c090d6a6ce02000370a43f7cc4493f6e3a07c7e00e8893,988663,2020-09-29 03:55:05 UTC,1744478275,1744468275,false,10000,0
cde19ae77121938fa73b539fabcef1fa4af819e26505d37597b9235be71e2b9c,988663,2020-09-29 03:55:05 UTC,90895913,90893463,false,2450,0
caa4979c69ca13328ce5bb382e2d9937ab212a6a0c9d32ebf3b596a4ccc9cf19,988663,2020-09-29 03:55:05 UTC,4000130000,4000120000,false,10000,0
be230b3c1ad2ef1ff67c46b715bbe780c88b173b20fa8fe0d3af6c7c317bf1b3,988663,2020-09-29 03:55:05 UTC,10217985,10215892,false,2093,988627
35df17bac7b62000f5168aefc7839d6ff2491a5b2cfa3fc1425cd385efff74ba,988663,2020-09-29 03:55:05 UTC,283925380,283857012,false,68368,0
8eb3542276807174dc45a9d1c6299e9b4d109f2f926c4e45be2816d0bd6671a6,988663,2020-09-29 03:55:05 UTC,1871279571,1871274863,false,4708,0
0aa7494359aa9dc1aeffc920dac7872c11d955857728e0bf6290b00129664f8e,988663,2020-09-29 03:55:05 UTC,70761841,70753295,false,8546,0
c3d84bd7ceb8ae3e4c31a13ff53aac12e69e96038f18f774403ac3f45915fcf8,988661,2020-09-29 03:53:09 UTC,735918976,735832276,false,86700,0
770c35e6f672fc17b0b2a2e01ea2db5ad7be77b8c251aeabf0c272c998c0ed35,988661,2020-09-29 03:53:09 UTC,9414620,9412029,false,2591,0
1b539bf6fb2c36c42dfde0936ed821b0cddbf6c976fe7258fdf24248d6d539c0,988661,2020-09-29 03:53:09 UTC,1697638810,1697564452,false,74358,988649
f3910d0e4c727eced1a931cf7d14e2218efde3238f34600b27d8c29b9cd2ccd4,988661,2020-09-29 03:53:09 UTC,15530694,15526071,false,4623,988650
172fa7adbac3f1cf422b7cf0cafac392de3b8f1facd2f9f6ff81c83ff1c29bc0,988661,2020-09-29 03:53:09 UTC,723599989,723597605,false,2384,988650
aa4ce3d4b39c72f14cb9b10a9e2d3f755eec6ca6a3e0d8dbc7a6cad9a3ffbc18,988661,2020-09-29 03:53:09 UTC,51248069,51242069,false,6000,0
ac740375ee935f5595d9f37ce011f187ec47c65d15122f71d72bb7903ad839d6,988661,2020-09-29 03:53:09 UTC,18047829263,18047819263,false,10000,0
014530eec4fe1aaf770dbd645e67ed0f251f019f3e69e1e8c73683c6838de624,988661,2020-09-29 03:53:09 UTC,846651217788,846651215695,false,2093,988650
f1c08e8b600ffbad55fcdb5a47f260df0937a5a79a940441fd0c35faca47b4fd,988661,2020-09-29 03:53:09 UTC,228867445,228864485,false,2960,0
b954483307f4c693663ff22d89e83574da6395aa36bffd7cddbba9c14aa5a486,988660,2020-09-29 03:49:57 UTC,499980000,499970000,false,10000,0
afec52d9c2ce1e9ccba4aeec7685f44cdc6dd60b37eddfb6f84659ee28af1df6,988659,2020-09-29 03:48:31 UTC,70822629,70814083,false,8546,0
7a77ffa5c738a71e4b3dbad862a22b156eea5d22e99b43fa62f8543f18cc72c4,988659,2020-09-29 03:48:31 UTC,46456192,46454107,false,2085,988648
9d64570255f5c78f5dcc320b557ce69c6840d5c83e51aaef9521982174546367,988659,2020-09-29 03:48:31 UTC,203585242,203582282,false,2960,0
d2ce35659a0e30f73ec257b1e0ea50b90aba6af8128bc8d0c6b92bdd7d849c54,988657,2020-09-29 03:47:05 UTC,73106266,73034266,false,72000,0
a49c94b0d59a3e8cfcdecc447e3a9e9412c2789e3a3a87b8c7a7f7ed67930c5e,988657,2020-09-29 03:47:05 UTC,434533376,434527376,false,6000,0
dee09d994bac9687f044d91c43ccaa60bddbd0bcfeaef5cf08e084c5abc96c4d,988657,2020-09-29 03:47:05 UTC,156528,146528,false,10000,0
0c417fbc86b6585b976fa6c31b026b281a03f4737639eecf636a053a8720f74a,988657,2020-09-29 03:47:05 UTC,53570918,53560005,false,10913,988646
ad46f5f40c5af22c0ec85de017a74dea9b837d07287dad43cf4bcc3064bc943b,988656,2020-09-29 03:43:57 UTC,70960283,70951737,false,8546,0
e0773be71cb03b6a8ae7eca64d4a2a216dcbb5d5aa97eb12284d9135a345264b,988656,2020-09-29 03:43:57 UTC,103107386,103101386,false,6000,0
dae6b399c98c10f7f83f2e623f8079624807034305e8e468c34f0073220b974f,988656,2020-09-29 03:43:57 UTC,70855415,70846869,false,8546,0
5fe7cf3bd3c38d4a791efb7ea9e55907aaa7cf55c15570b3054be378c5e45a61,988656,2020-09-29 03:43:57 UTC,848395698156,848395696063,false,2093,988645
3b21f6d6407184f6d92834401a1c854ddab4b8d3b8828623a744241ee58e40d6,988655,2020-09-29 03:41:15 UTC,122857000,122847000,false,10000,0
cfa6b9a1b183f4265dc5afb03d8dd4d809aa811013b6ea5d4300f4710e4329a1,988655,2020-09-29 03:41:15 UTC,201058556,201055596,false,2960,0
84fa4527b6193d380137c1756c62b75d09c05ca75e6904d76467c120304531ee,988653,2020-09-29 03:40:36 UTC,499990000,499980000,false,10000,0
d52b352c238a3b5cbeb1c523d61de30a0ca6f808544045bd2330f293f752cc23,988653,2020-09-29 03:40:36 UTC,699997550,699995100,false,2450,0
a8574d935df159b0f66f6b3f3ff0b73fa8c1a6667fefbcaed6b28f8b2eb86580,988653,2020-09-29 03:40:36 UTC,90738985,90736892,false,2093,988642
f3d7643eba819010d3159eb3422c6345ca9e5b175e132c035638d3ca412e503e,988653,2020-09-29 03:40:36 UTC,639081,617537,false,21544,988554
23b512635b2a602b07eb3d7d0d66d5f4d14ceeecccb75395e0120844b45d8896,988653,2020-09-29 03:40:36 UTC,1699647806,1699573388,false,74418,988642
1ec465030cb7f3dbdac2cbc2de4e6fc7e3a090eb0dea7cd5fa857a8a5f04436e,988652,2020-09-29 03:38:38 UTC,2558565747,2558555747,false,10000,0
9fb8acd52dbec8e48233cb7cd055135b4a7f693e62dfc23fa5d50107ba5372ec,988651,2020-09-29 03:38:07 UTC,34527517,34517517,false,10000,0
c37e3bf804004dd87e79cf300db5031ac7bfd1f2c186b31e3f42b983f66fb2fc,988651,2020-09-29 03:38:07 UTC,1000012000,1000002000,false,10000,0
79716b8b2b46ef888a28bf29c89495966d6d8938ea6f418f8cf5f7a9f175914c,988651,2020-09-29 03:38:07 UTC,500000000,499990000,false,10000,0
78d1402ff2b3ee194be3b163510fd5af7b59b503bc94d5526f51e0da68b10851,988651,2020-09-29 03:38:07 UTC,1111988450,1111920082,false,68368,0
48cbb06b03bacedbe6036b6199eb674ef26ca77b43684018924a02e7e0574083,988650,2020-09-29 03:37:03 UTC,83806596118,83806593768,false,2350,0
eb83a808809660559042d15b1ea39d22b42dfe89899e37fbd08bdc3d29ecbefc,988650,2020-09-29 03:37:03 UTC,17891645037,17891635037,false,10000,0
79890cbbc13c2a7f68e007735f91e0ac442ab1be4568a58a085fc57081a1a80c,988649,2020-09-29 03:36:30 UTC,5011079,5008649,false,2430,0
580bbc091fa0c7112c5820e9df777a8f51f749f7d59c1189c94b17aa68332f35,988649,2020-09-29 03:36:30 UTC,525910132,525904132,false,6000,0
e30de0cf79a367f0d48b306a2d9efb68ce23f9eb37a20c30cdc56b4584b01e05,988648,2020-09-29 03:36:19 UTC,100000000,99997570,false,2430,0
8960f82cb04a19005d3994d2fce6f4c565d5261d00678f96bf9318c235ad6204,988648,2020-09-29 03:36:19 UTC,60485088,60478908,false,6180,0
6f0b50c27f00fb33c9e96dd65d4cf4215ca19b960915055e1f8db1460f58af69,988648,2020-09-29 03:36:19 UTC,858385204848,858385202755,false,2093,988636
431627822927dd2bfd9cda3b86227aafd2443aa21585bd7e39900df16f46a1aa,988647,2020-09-29 03:35:36 UTC,18129503643,18129493643,false,10000,0
258a7fa7e750aa810242380e01250ec44c6a717bb6aab808ff56fa9dca32f1f8,988647,2020-09-29 03:35:36 UTC,163006787,162977807,false,28980,0
a34aaca7f9b4519f75d771278ec88b63a2e3ad0e60cfbb027595c2d42bc3dbbc,988645,2020-09-29 03:32:30 UTC,266516673,266512933,false,3740,0
ca7200b391d5ffdf5f9191394932749b8bdb7e7c0e7a6bfe5b6697b796e9d239,988645,2020-09-29 03:32:30 UTC,66100656,66090656,false,10000,0
82677695208b65c992a2da8d59083439c1c77b66aeb6e84c8ed64b17ff7637c9,988640,2020-09-29 03:31:00 UTC,11096144,11091692,false,4452,0
f6c78aa38ce4bfc4a5b2d3eda4f5efe1b17994bdceb4034da5dc4c8cb78f2355,988640,2020-09-29 03:31:00 UTC,1136961,1118904,false,18057,988629
5b9f28061c01b7479da016c5c0aad1c3dd007004239e53b00871f4b9bcfe8c04,988640,2020-09-29 03:31:00 UTC,5603643920,5603640392,false,3528,0
8aa859e59100802ac0d27fc1a74d13806527026592646c6422c9f7d1d24037ad,988640,2020-09-29 03:31:00 UTC,37349240,37338609,false,10631,988629
8047fcea3e70ce9ba04433693a3243148a4bac8a95b934c8b844fc143cd543ad,988640,2020-09-29 03:31:00 UTC,286111613,286094452,false,17161,0
6dd0959ce7cf20989fcda4b16b794935827bbd22ef827480ec340bddb35aaf15,988640,2020-09-29 03:31:00 UTC,4915000000,4914993000,false,7000,0
b47e128c9e0a7dcc694f5eb55a3675d10889d4def385ea10191b78219e28cc92,988640,2020-09-29 03:31:00 UTC,500000000,499990000,false,10000,0
72f46701c35e63e49777e43a2757d2fb08cef83780a5b739876066c45f6d9b70,988640,2020-09-29 03:31:00 UTC,1701299491,1701225099,false,74392,988629
cb27cccad3330f4d22469bf2d41404e796c5c764ecad678036a25ce4d9e3b64f,988640,2020-09-29 03:31:00 UTC,229092924,229089657,false,3267,0
ddf845e280b91fc7cfaf99a4b31bb2c0d2bafde4fa380b1760737655316eed84,988640,2020-09-29 03:31:00 UTC,2384291258,2384052965,false,238293,0
0715bd6d6bb7fafed0d9bf514e57324a9cf5bd2120b9b1031aba7af258161c30,988639,2020-09-29 03:28:06 UTC,203798972,203795705,false,3267,0
a2b14442d4f90940cf172536029cf9c1eef5281d06f7a0d50f626e58f2e4fb71,988638,2020-09-29 03:27:12 UTC,4915010000,4915000000,false,10000,0
5d68a71adf80471aa381f723622eae131c682f3ffe32095662d5bd18647aad34,988638,2020-09-29 03:27:12 UTC,59392100028,59392099928,false,100,988626
5cf842fb33da861ed4387a926f74e392d848799a8f877929cd624edfd5192cc0,988638,2020-09-29 03:27:12 UTC,521371495,521363512,false,7983,0
f68fd25fe0d514bd3c8920eb23dcd4161b304999b6c57fd2058336bdb0a568a2,988638,2020-09-29 03:27:12 UTC,59379419928,59379419828,false,100,988626
72c7ed50d63f0b7c5b7549adc2e0ec3c5b9a9f0d62fa30119c72f6a5d898d6ef,988638,2020-09-29 03:27:12 UTC,71154372,71145826,false,8546,0
45b238be4f74d7936ba13b2aefc760eec83e0ad5f66c9cc1ce7ed13797385d47,988638,2020-09-29 03:27:12 UTC,18129513643,18129503643,false,10000,0
28d866949478019f55995fdb458960eef1950df77ad930c95a3063e04d488e62,988637,2020-09-29 03:25:19 UTC,19486086073,19486076073,false,10000,0
9fbb0d91e43112b1bccb7263f07e5e21b71b9e58c99d8a8e413c586e861c15fb,988636,2020-09-29 03:24:17 UTC,474042846,473998086,false,44760,988635
f7d2dab6370a70e427b2b75d1ed713c6f84d8be67b7549521c289739609cd190,988636,2020-09-29 03:24:17 UTC,499990000,499980000,false,10000,0
1d82a2a20687c6422113f3c98872071fb848807dd8adf9bf55e0b5d18d5dc1ac,988636,2020-09-29 03:24:17 UTC,59568787879,59568787779,false,100,988625
ab1121473e37d6dec35e45c90ea408176ec52e6e6c3f6ed28fc6f9e365d62413,988636,2020-09-29 03:24:17 UTC,201576119,201571322,false,4797,0
a6b29e63cf80977d444f675deb40cae0dbb85d99618512b4001ceb25feeda7a0,988635,2020-09-29 03:21:51 UTC,31710456,31708363,false,2093,988624
375a12d82e97ae72a4b5d5b45454137b8a35b1d5a5b116f4075cc89ba905db9f,988634,2020-09-29 03:21:30 UTC,1503667,1486379,false,17288,988622
8e050741f2e5c6de60148b3289e419057236ac475ec8fb59832b71c2b1fbb451,988634,2020-09-29 03:21:30 UTC,1702955445,1702881121,false,74324,988622
c1ab93c8ac9d9f1dde6440131aec0ff47619929c41f68ac33ffb159d068f7615,988634,2020-09-29 03:21:30 UTC,2283088313,2283058835,false,29478,0
2fd0ae6221a5b8655727babf9dec28e2431518959177a30262fba5b1007df16e,988634,2020-09-29 03:21:30 UTC,83835062497,83835060147,false,2350,0
95dd3ce0f4d2d50242d22dc25bdee928cdc38832bf53d06e421009196abcee1b,988634,2020-09-29 03:21:30 UTC,71182773,71174227,false,8546,0
eff95ce310f3e0946e86c3fda6e2b817413c2a3186248d4b1531dd43f611b30d,988634,2020-09-29 03:21:30 UTC,500000000,499990000,false,10000,0
c19d562fac0387519f77688fb3aaca2139029d8db1feb1276ceed08038d9e601,988634,2020-09-29 03:21:30 UTC,4587870,4585420,false,2450,0
b6b807a982c5c8ce1e85f0dd07c394bdb034529e67430259fe040310138191b5,988633,2020-09-29 03:20:09 UTC,628748046,628745953,false,2093,988621
2efb7ff326f0f2ffb2a8aafcdace89334638d25598f33ff30e33f93153d4cd00,988633,2020-09-29 03:20:09 UTC,18138012,18128347,false,9665,988619
ee344dd3f6486e9bd912de88f48a1d90d070c0698f5f32443815d4889bebfb21,988633,2020-09-29 03:20:09 UTC,632495523,632493430,false,2093,988621
00c883f15fa16641ef861654aa8978aa97795dcc4ad466145cd813291d248b89,988632,2020-09-29 03:19:37 UTC,851435478,851433385,false,2093,988621
a38a56736467b178f53027d9deba88f03402ff190f3e0faafb522acdd3b6e3c4,988632,2020-09-29 03:19:37 UTC,877741072,877738987,false,2085,988621
db65fe6e9097f322993ca728a9532a3a179a85afe45ae5cf4babd9272dd5b451,988632,2020-09-29 03:19:37 UTC,944142379,944140294,false,2085,988522
d9d581aa64f9b431e3e181fffc306bc714776976d099e7a4606d3a068feb0af6,988632,2020-09-29 03:19:37 UTC,1140108020,1140105935,false,2085,988621
7f77c790b24da8bd302c0298140ccfb8b03e0532dbad73d36a8b1669564afe9e,988632,2020-09-29 03:19:37 UTC,960427281,960425196,false,2085,988621
8f9bdd48a670b1b99fec120f2dc6c9a8066aaa00ea325fd341fee5ee8b1bacba,988632,2020-09-29 03:19:37 UTC,1118843057,1118840964,false,2093,988621
cd4bf8fea03492474984d7c17b479c2ad3203fe695f162d7c9c61f8c2ab1798c,988632,2020-09-29 03:19:37 UTC,1159254811,1159252718,false,2093,988620
ca7c194fb20b0559ecc88277b8f6a8feefe528e434da2ec2dcc39ae44fafd215,988632,2020-09-29 03:19:37 UTC,673376294,673374201,false,2093,988621
e6fa9a93b761a8071321850aef8e0dbff432c5637b9401f434ceb36fcb72958d,988632,2020-09-29 03:19:37 UTC,1103910182,1103908097,false,2085,988621
b80eebc0c947f9100013372fbde0727b9aaf562ee1199c9d7f4f61b74b136519,988632,2020-09-29 03:19:37 UTC,1162978649,1162976564,false,2085,988620
4928c06b1d0bf76331fc383e7113ffae83eeb947396be752abec1cab3e4cf419,988632,2020-09-29 03:19:37 UTC,1177830845,1177828752,false,2093,988620
c7aaa003f84eb816902d1052a4a38e56538d7ede3514444852b4db5ef42974d4,988632,2020-09-29 03:19:37 UTC,1111421373,1111419280,false,2093,988621
90e94afc8856458957a25570f863e59ce79562f93575929c7d83ea582c07634f,988632,2020-09-29 03:19:37 UTC,57450894647,57450892562,false,2085,988620
5e373361a819b8247bc7ff58217ca18cc18a744e48824d374afedf624d574526,988632,2020-09-29 03:19:37 UTC,881536389,881534296,false,2093,988621
b0f767c78738beada8677c957d6a957f000f2102da422cff48c23e4d3ece8f0d,988632,2020-09-29 03:19:37 UTC,669633914,669631829,false,2085,988621
7a581e930eef900a8df70774150ef1a1c7fdf68a150f63fbb916dd6fc98b2b4d,988632,2020-09-29 03:19:37 UTC,1055315012,1055310885,false,4127,988621
0e90d47a18053963b0e841e2b0b12ccd0847505b7aeb1ea5bb00ab2256d1f4d0,988632,2020-09-29 03:19:37 UTC,71243295,71234749,false,8546,0
43cc56f99fc789366060523e6e3f4fc55652cc218099e03c0e9288d3c1ff956f,988632,2020-09-29 03:19:37 UTC,1155491549,1155489464,false,2085,988620
55ddbcacfcb9c1725e404514778c4238ade49d595b9b9283215d4712b368d1bd,988632,2020-09-29 03:19:37 UTC,1166736560,1166734467,false,2093,988620
4158337486c9d6eb8a42df4b883e6137b2aaa704dd28c6eaf5cbb20f0c2b9fac,988632,2020-09-29 03:19:37 UTC,465735416,465725416,false,10000,0
b0a02cae5d5e0629b1d5b083f3d44131e1324283a896d391bd6e3accf75d7ada,988632,2020-09-29 03:19:37 UTC,889107795,889105702,false,2093,988621
4b4336338096c32ea7bb9d5e2e6b164592e528dde4bf918080d466e0b976de74,988632,2020-09-29 03:19:37 UTC,1170430961,1170428876,false,2085,988620
65ad124f2b50853e20ff963fe31a93fe02446069dc37a01ed8d90dfab8add08e,988632,2020-09-29 03:19:37 UTC,885310838,885308745,false,2093,988621
225add2c9d704bdaf1bfcadf116e5625bb69671829e7095a021fb5eb98186a3d,988632,2020-09-29 03:19:37 UTC,8485997337,8485995244,false,2093,988620
5c3ffe2d9e495ebe059a9b33a2a3273794fd0312d75425f31a7330b91deb604a,988632,2020-09-29 03:19:37 UTC,8907970551,8907968458,false,2093,988620
41a3e5b612a9c506f4baded2f395424cfd4dd274d2faba38469ad7b19a1ff347,988632,2020-09-29 03:19:37 UTC,1115127191,1115125098,false,2093,988621
8b34f0012b39bfa13478e54d8ad6c13dc23ad3d08aa9e38830fddb45cfb92c4d,988632,2020-09-29 03:19:37 UTC,862843912,862841819,false,2093,988621
a193f59a697601c71c36906fd8e84109280e32df7ed2b54656521af14f739e2e,988632,2020-09-29 03:19:37 UTC,1181637727,1181635642,false,2085,988620
95dcdf3fa1204207c89e27466c6b005cc691217ddddf8a89dd9b36d9a6d78441,988632,2020-09-29 03:19:37 UTC,855216389,855214304,false,2085,988621
1cac151d8760094c0e92f6f6949331eea72c9cc085bd1989261fc0d4cd9de14f,988632,2020-09-29 03:19:37 UTC,1059130334,1059128241,false,2093,988621
fe2af7b278a10cb789432af01663578a797f66b6a0f311bae63fe06b25cc2eb4,988632,2020-09-29 03:19:37 UTC,1066594267,1066592174,false,2093,988621
7e35743bb295d977f13a1765d98b5d84d73e4cef1cf50339b2bdf522579e2812,988632,2020-09-29 03:19:37 UTC,1000000,990000,false,10000,0
d5ac7faa84b86e538f3b76b0bee8f4c5b67fcfbea1019687b4632b880e6d52f7,988632,2020-09-29 03:19:37 UTC,229309696,229306429,false,3267,0
0e3d6d1bbd5baf5e67c9fe6cdd4f1c2d24d98763b8659aca89d3b5be5056c738,988632,2020-09-29 03:19:37 UTC,1107645006,1107642913,false,2093,988621
16df05ec7df71303fd133006817b56eccfc181fe67db156108c62ca02b771e2f,988632,2020-09-29 03:19:37 UTC,964105374,964103289,false,2085,988621
5a0afeee1b2c69c4dd072b44480a7f75e4337cd449f80b463f688f333760d499,988632,2020-09-29 03:19:37 UTC,859061633,859059540,false,2093,988557
66c26e6959184eb6e20cf74c745359cbda98cfa43ed8f95d096b9b50d5e852d4,988632,2020-09-29 03:19:37 UTC,925785157,925783072,false,2085,988621
f0633d9942d37b85cd40d485372c2ac69372b74311fe4dc8b09de98f0b7e0b01,988632,2020-09-29 03:19:37 UTC,1174139128,1174137035,false,2093,988620
9e745787c13a604232afef5af2063443b4cdbc9be57c67e20bd63a1e384728f1,988632,2020-09-29 03:19:37 UTC,1062834948,1062832855,false,2093,988621
6009640760c2a71575f22c7b2a301b82aaec57e8c7437b4b6cd766f405614bb4,988632,2020-09-29 03:19:37 UTC,143442442,143374074,false,68368,0
6d8cc501dd9b23ca7c94d6547e8ea92e99f9543858187e96e0b70e4f4c8df9be,988632,2020-09-29 03:19:37 UTC,18986116073,18986106073,false,10000,0
63f68c2acd633a76c3da77f40a28632358367dc3fe4f5f1dd3e0f328eaf527ca,988632,2020-09-29 03:19:37 UTC,1136354820,1136352727,false,2093,988621
0b3c7624a6a765243b84f0bef438c42652a67170cbbefee7338954a27b0e8fd5,988631,2020-09-29 03:18:03 UTC,71647056,71638510,false,8546,0
41d645f1738c0328385fd8d5a4c2017a6e0017d0f4e287480ec865092da9f960,988631,2020-09-29 03:18:03 UTC,499985053,499975053,false,10000,0
90bb31e3424ffebcc35436551865cecffe0b52a8234aae8f99c1a66a652a05b6,988631,2020-09-29 03:18:03 UTC,71429286,71420740,false,8546,0
4ea2261719b6bebd01b58bd43a10cf3fe090f5a6c872912e85c48e336f6a6d33,988630,2020-09-29 03:17:06 UTC,1196817850,1196815757,false,2093,988575
b117d35231f4e0fdc7fe3c18a6771862ee906aaf09cc46242077a8d6cf2bf41b,988630,2020-09-29 03:17:06 UTC,1185425480,1185423395,false,2085,988618
8530cd322bef3bc5dbd5994a9a7eba4f685f9041b1383823c60fc7011f49e70b,988630,2020-09-29 03:17:06 UTC,1189123948,1189121855,false,2093,988618
3c36da3cf80f77b01a77339e11ff36bea94188eaf16b85d9ee0296fbf45129e7,988630,2020-09-29 03:17:06 UTC,1192966578,1192964493,false,2085,988618
f5fe8550c11f660bed2912b5c0acc6303e2e573abcb50c07ce97ac27da839cc7,988629,2020-09-29 03:16:20 UTC,1225952240,1225950155,false,2085,988618
495c5a04e64bc7139bdcf765976abc852c50fab34b9eca0ff72151122aa0c492,988629,2020-09-29 03:16:20 UTC,4142857599,4142855506,false,2093,988618
a40cd51047346649148da54526b84e025b4b0aa0effe64a35030777dfce71736,988629,2020-09-29 03:16:20 UTC,18597922931,18597912931,false,10000,0
311a06cc1cce68360dd8ea032e56d6e8910022edf5d80cf02ae06e15aa35de95,988629,2020-09-29 03:16:20 UTC,4335209664,4335207571,false,2093,988569
96800d52ebc17b3e6de1aac2e69243fdd90891c0d1aa18f4da9c7e078daa6b80,988629,2020-09-29 03:16:20 UTC,1270394692,1270392599,false,2093,988618
cc10a16c19d69f63c3acd06fd7862397455424225f42e8b4ff9742b77eb67fcf,988629,2020-09-29 03:16:20 UTC,203947080,203944120,false,2960,0
a0db74c84da6cdd6c9c68f2cc67e4b88c6fdc4c8aaf70211ce2d04e4ca8088fe,988629,2020-09-29 03:16:20 UTC,3998835384,3998804653,false,30731,988618
5cf7706b52a15d95a431b8f6277383c5cc7e17c5a7d414a19d7bcfa3ffad5f52,988629,2020-09-29 03:16:20 UTC,4068515631,4068513538,false,2093,988618
4d6b80cebcced62baee378d595bad32584048b3743e6f99f479a404973d71186,988629,2020-09-29 03:16:20 UTC,4002441428,4002439335,false,2093,988618
0c43e986c3c6a0a418df9d0c8ad5148e44ed94c4263297f06a85df8482c0609c,988629,2020-09-29 03:16:20 UTC,1310474664,1310472579,false,2085,988618
60eccd2c8a4ef4d67719ddddc69a5c2199d8fc657ca242e9864ba8f4810c1dc2,988629,2020-09-29 03:16:20 UTC,264908483,264888483,false,20000,0
ff14df23c17c24a068caa763fb1384cb347760be06a8174acb73f07f324477f9,988629,2020-09-29 03:16:20 UTC,4146613666,4146611573,false,2093,988618
5cf01f6f874570df0db9dfdec5ef333ed16e2f57a7d892e5b738beb1176f39a7,988629,2020-09-29 03:16:20 UTC,1204332548,1204330455,false,2093,988618
ed95d7f275df955ecf48d62ee638eca7880f381c074aef35e2f191a4de7db32f,988629,2020-09-29 03:16:20 UTC,4327709422,4327707329,false,2093,988618
f2f0cbbb79489eabd31a35a5d54f83408fc825307f7392a3a3746fa07dfc6489,988629,2020-09-29 03:16:20 UTC,4323847555,4323845462,false,2093,988618
f62bb2908645c45dd51c5dbdc10cce83cd6e0c93f85f0c3527b630a30c84990d,988629,2020-09-29 03:16:20 UTC,4049446121,4049444028,false,2093,988618
563648fc6c235747edb77e72ba04648828803acb2b91803c276900035e43eab8,988629,2020-09-29 03:16:20 UTC,1229641922,1229639837,false,2085,988618
324f7886cc37daa3f19c43e2d828a279f89554c13e9376114a2944575f7cf084,988629,2020-09-29 03:16:20 UTC,4006304309,4006302216,false,2093,988618
3852c9bf7e7aa7898ae0f9a116b4f69fb37210373ecbeda70a1008f9d07d7883,988629,2020-09-29 03:16:20 UTC,4150393645,4150391552,false,2093,988618
44136b516faad35763b7d5d63d74a7828c41cc98731a50874c718a1cbfc0b3af,988629,2020-09-29 03:16:20 UTC,9263387059,9263377702,false,9357,988618
fa198f9ac3103f640dde55e664502db188848a8b47576987dd1276293d27c105,988629,2020-09-29 03:16:20 UTC,57454619077,57454616984,false,2093,988618
ea735375f243ae38cf7aa26bd35f4f7f81a489a34067d54f7deed771a40c7a92,988629,2020-09-29 03:16:20 UTC,4072278733,4072276640,false,2093,988519
158793646ab6aac18f11c9cd715fdca34cf6ebafc07e0fc3c3ec8f8a4225b448,988629,2020-09-29 03:16:20 UTC,4339002433,4339000340,false,2093,988618
b3d14599e98f5e93eb95bc1b954272a64cd0915cf0cbe7909b908a19acd1e895,988629,2020-09-29 03:16:20 UTC,1208095650,1208093565,false,2085,988618
1569f9491e3e0a5968d2dbc1a4459607e5c3b1c077abe257ee6dc38ebb9759b7,988629,2020-09-29 03:16:20 UTC,8489722313,8489720220,false,2093,988618
5573c557294154a91016fa4deaa23fa9af869cdd6d704eb39fa58e59729b11e4,988629,2020-09-29 03:16:20 UTC,4045658890,4045656797,false,2093,988618
76769cbed6b6a014a018b52afe84c1ea02e1b2cde4e267fba4068d444bac8875,988629,2020-09-29 03:16:20 UTC,4108255263,4108253170,false,2093,988618
e5e254d91f8e8fb34269ff74a7f5e51cc9bdbad9f6698084e4a0462743660926,988629,2020-09-29 03:16:20 UTC,499995053,499985053,false,10000,0
9979802d184f38fa313b2e4a1cba423719c230e08b21d2a4ad159eefa5c1bf4b,988629,2020-09-29 03:16:20 UTC,1306791009,1306788916,false,2093,988618
7d84609924c8e6a82ab483d1a276c98a1ad69515762da2713fdfe7a8db173e92,988629,2020-09-29 03:16:20 UTC,969780787,969777794,false,2993,0
d8f1e917910a5f279f79002307a7517981e6aaec749ba6e9fa41b43b3cff8c76,988629,2020-09-29 03:16:20 UTC,1200574373,1200572280,false,2093,988618
3b3cb8e5e86de3df94e40cb52679d362b199e77777bc5bcccd40c79b0b8405d4,988629,2020-09-29 03:16:20 UTC,4331452418,4331450325,false,2093,988618
30c22fb31686ac1f0b8c5ccb7255b7772cb28b009099896d2fed54bb62c323a0,988629,2020-09-29 03:16:20 UTC,4010005347,4010003262,false,2085,988618
7a869d0f61353c081299bfda9bca835c54be4a86720ca0a0142e2ce786d72ac8,988629,2020-09-29 03:16:20 UTC,1266602569,1266600484,false,2085,988618
5280649485dff19dd751f1936e1f50dbd26f93234d0f594faec9881b852b5ede,988627,2020-09-29 03:13:31 UTC,500005053,499995053,false,10000,0
f6412390d0d2738afa26f9b3ff22738fae61d76f9bb918487744d5c8e4bf6917,988627,2020-09-29 03:13:31 UTC,19456560000,19456540000,false,20000,0
1d8b06facab43485d92ad70c0ce02f2632ed74381a5a5fc3fe8675e8b1c7047a,988626,2020-09-29 03:13:08 UTC,201730306,201727346,false,2960,0
20c3cc07151b6e994d2dbfcd68040cdf80fc270bc6ee485b48a3bf494b5b393d,988626,2020-09-29 03:13:08 UTC,178224473,178186613,false,37860,0
c52dea5148f282666a778cebeda24258cca40251461ccbbddea433c11bc60107,988625,2020-09-29 03:12:29 UTC,4416644151,4416642058,false,2093,988613
9966273ef88880a89fdc4b5ea272c0f04547a99bd9075eb8f0b0991374d962d0,988625,2020-09-29 03:12:29 UTC,4342858432,4342856339,false,2093,988613
6dbde984e1a4ac97d470f3e3f70335ff82ba53533bf3eaf9268fcf742c53c4bd,988625,2020-09-29 03:12:29 UTC,9267161642,9267159557,false,2085,988613
6a07d3df271904d0866841bc21e150b37918474fe1c0bc416c246ea915438c71,988625,2020-09-29 03:12:29 UTC,8507827016,8507824923,false,2093,988613
47b314d7c9aa6d9157ce24db1abd451833f78ba1e6f9a2264a634f7b2f81ecb1,988625,2020-09-29 03:12:29 UTC,18607956533,18607946533,false,10000,0
f3855378cbb9151285544051799fc93a937065db01d46eefd1c99eb3a5eb9c70,988625,2020-09-29 03:12:29 UTC,4379723294,4379721201,false,2093,988613
eb16f4650c335bdf89d9b6e4de87a5addb5470afdc32b5ada4573695576503fa,988625,2020-09-29 03:12:29 UTC,57458317833,57458315740,false,2093,988613
da170a684a6f6ca9d884c08a516aea3e555243c00e4f1c7788ffe4b590423539,988624,2020-09-29 03:12:06 UTC,500524372,500514372,false,10000,0
a9b9b3db079b84deeb56836f729ba42358a6cd50540664bafe415c573cce6dfb,988624,2020-09-29 03:12:06 UTC,4826045775,4826043682,false,2093,988612
a892a23d259d651f704afbed4f6ba5edf7e1245eb76c0207202cf353a4cef77d,988624,2020-09-29 03:12:06 UTC,4715602979,4715600886,false,2093,988513
7e644a4600c2741578e8fbcd022c9b9c2c03217fa5a1e019c31e045a1145ba06,988624,2020-09-29 03:12:06 UTC,4698469326,4698467241,false,2085,988612
c826641f63995a38faeb007c7eb389a66d054518ec8f2a57c96e0ff69ecf8c4a,988624,2020-09-29 03:12:06 UTC,4694707613,4694704648,false,2965,988550
74ed63a40df1a7452f54c830d064498e9406256facd1a6f3241a918f03515d7b,988624,2020-09-29 03:12:06 UTC,4829791661,4829789568,false,2093,988612
404b06595cb911cc048f0d7fc72867d8fdbb18df8aad926d28abde29fc161b20,988624,2020-09-29 03:12:06 UTC,4751703444,4751701351,false,2093,988612
b91ca376d6ca61eeda7e9895be81f033e59e4f08afbc643ef108c5f9a75fa30b,988624,2020-09-29 03:12:06 UTC,4788445732,4788443639,false,2093,988612
4fcaee45d77edf2dcfd0463c740891f6dc8ac59ab571ffba707d023de585d2ea,988624,2020-09-29 03:12:06 UTC,4833461270,4833459177,false,2093,988612
da50bbe67972ba07af002c35f8594c8c17f412463e8bd8a93a7134ab593ecc5e,988624,2020-09-29 03:12:06 UTC,4639368580,4639366495,false,2085,988612
803c9b04bad800a112ec66123d484692a6a1312035ade0c8d0963b0d2e97c4b8,988624,2020-09-29 03:12:06 UTC,4676702774,4676700681,false,2093,988612
881b010c5ebd6cca156a42c1531eeb19481a7f2b7f5817fe7b61cde902884d23,988624,2020-09-29 03:12:06 UTC,4454938671,4454936578,false,2093,988612
6e050aa617ba13bb49bca01fe5db7894a4d3175fb19c0128258ba5a931113341,988623,2020-09-29 03:11:38 UTC,4900452321,4900450228,false,2093,988612
8636f6ffa3ee52d10b27bbce518ce7d516b7fd65cfc3f398ffe8fbc2ad9dda05,988623,2020-09-29 03:11:38 UTC,8511679389,8511677304,false,2085,988612
aa56f8aebda734c55783d923fdba346128d994267469376399607f614b52b6fe,988623,2020-09-29 03:11:38 UTC,6469595972,6469593879,false,2093,988611
d132eac59ff35fe19284b39c2dd6d5dacccdc484beeb49c3798fb7a2cb73b55b,988623,2020-09-29 03:11:38 UTC,4865473571,4865471478,false,2093,988612
9b84c73ed27028249899abcee873b06703f8bfe754736a7d8038ef4f9ef9e205,988623,2020-09-29 03:11:38 UTC,6412748329,6412746236,false,2093,988611
d8d93d952dc6fe95e6784c4532f8a6a5008d08bb69c97c14d314b32ca1fbcb14,988623,2020-09-29 03:11:38 UTC,6378047949,6378045864,false,2085,988611
8c6c39b67892113e1bfb17d2f063687546f8a3be05a13e61b99f25a86bc92af3,988623,2020-09-29 03:11:38 UTC,118349571,118300331,false,49240,0
08f1bb4d7a90db3d2ae67089c67cae31a19b2da68961a505635e6fa9b57461ed,988623,2020-09-29 03:11:38 UTC,4893070174,4893068081,false,2093,988612
6204f50ce64d867c598402ff72f6e6cdc83a42eb9def7c176037b323061deba1,988623,2020-09-29 03:11:38 UTC,6274873346,6274871261,false,2085,988612
1c273dffec4779554902e727d018806c8ef3050e7ad05d4ff3e416745054dabe,988623,2020-09-29 03:11:38 UTC,6454932478,6454930385,false,2093,988611
69093cd92f7db7c978851151154145dc555a79e26a6717820cf37057602a537d,988623,2020-09-29 03:11:38 UTC,6162141974,6162139881,false,2093,988612
4b6549d558d81773278ee8b3c4d99c4791cca35844fb071d024cd7297adea605,988623,2020-09-29 03:11:38 UTC,6394783586,6394781501,false,2085,988611
e34dd1e6af4043ef0982ac033af40b0fb2abd3b252fd102fdde3d6a7120e03af,988623,2020-09-29 03:11:38 UTC,4953843356,4953841271,false,2085,988612
480781e2df339b932886d5b7b38efb8c7667e1137c0096c4003921b12b6fa59d,988623,2020-09-29 03:11:38 UTC,5024462346,5024460253,false,2093,988612
0d05353a0938a0e58665451a0a35225487e0adeb51b05e12bbc535e6a6c783b9,988623,2020-09-29 03:11:38 UTC,1047777,1045692,false,2085,988612
ea824ed9cfeaa8d1213e7f6632b0095ab938e0b1a8b59e6ea1e03497d328153c,988623,2020-09-29 03:11:38 UTC,6213932510,6213930417,false,2093,988612
560727fc013d0cbd6f97f44529e1c1f43bb81607bfecfacd3fced5cc94dc7c13,988623,2020-09-29 03:11:38 UTC,6132219620,6132217535,false,2085,988612
5a9b55fc1644cd125656f90aba3060b83a77b60a2a0b5a65c21274afcadae68f,988623,2020-09-29 03:11:38 UTC,4881821305,4881819212,false,2093,988612
127fb450043d3991aec97401eca2c52a66c76718aca3e919af43dd44c082a9a8,988623,2020-09-29 03:11:38 UTC,6374323275,6374321182,false,2093,988611
e6add96b4f995f4129d610ac6265cf3e7948d6c47998448ee1a4d2a805299f34,988623,2020-09-29 03:11:38 UTC,4896744233,4896742140,false,2093,988612
ac8e8781805ba3d89cee6c8826e21d79b73abea711cd81a742590729428461a0,988623,2020-09-29 03:11:38 UTC,6189103531,6189101446,false,2085,988612
4bd364e5399d4a7e3b50c4d27d7019a04b6a9ad46390ecd0bdfbcfa2f493643d,988623,2020-09-29 03:11:38 UTC,6147226655,6147224562,false,2093,988612
e04587d18b5e364eec7190a3a4146a6778ed7f4574c6a754d406b3e00d41da5e,988623,2020-09-29 03:11:38 UTC,6282466779,6282464686,false,2093,988612
e2c546a517b0e0633d4f98cdd64aa1a4e4ed503d1dc05d2105919c51e23ec4ea,988623,2020-09-29 03:11:38 UTC,6154761725,6154759632,false,2093,988612
2f254a0b4ef91bbc9361daf27a97d3ece51cc2c999bfcbfdee36b9da23703758,988623,2020-09-29 03:11:38 UTC,6139705833,6139703740,false,2093,988612
ecf51097281589b6dd4bf2bc494fb5ffa25795a07a474d09d2ab23c7a750e7ba,988623,2020-09-29 03:11:38 UTC,6143519769,6143517676,false,2093,988601
a96da19a4bc2842222290bfb43f2e4dc31a656ca260302b00da86e244d9340ba,988623,2020-09-29 03:11:38 UTC,6295568452,6295566359,false,2093,988612
dd1cdb876f84d34f9e9b83c131597eb3a9538542d6a2d85ab9852307ac123fad,988623,2020-09-29 03:11:38 UTC,1704476213,1704401838,false,74375,988612
8ddd1217eac8b27fab770d10fecd20ed4402015e24ccb936795e55edf745b6a4,988623,2020-09-29 03:11:38 UTC,18607966533,18607956533,false,10000,0
ed8604ae0c336791b431c2be87650f94905eca7d348104fc44ea8c61d6c57010,988623,2020-09-29 03:11:38 UTC,6206268304,6206266211,false,2093,988612
45f26846a3814445dd68a6bc70f0bc5df380b59e7713777224842bc3ff446801,988623,2020-09-29 03:11:38 UTC,4980182245,4980180152,false,2093,988612
dcee42fa18f277a60aafad21c3fed8e411dd469998dbb75076568ea738ed3944,988623,2020-09-29 03:11:38 UTC,4885538918,4885536825,false,2093,988590
4c0a9c86aeeb864af0a1849f95900dedff3ce0e2a63a3a8880815a4d5449dcb5,988623,2020-09-29 03:11:38 UTC,4957562718,4957560625,false,2093,988612
383a2caad44f7499d18ea937af06173e11469d4e899a6fde87926ba5cffd7031,988623,2020-09-29 03:11:38 UTC,15490133,15485527,false,4606,988612
f1508c2c3c0bb22d7a9fc2d55dd8b07cfe901b4383cbf63100a7ebe3b2a9a558,988623,2020-09-29 03:11:38 UTC,1995217473,1995184151,false,33322,0
24cf7118821d6e9e5cc79a878d3ddb8901fecb89b23e79b4146d3a44c37f4788,988623,2020-09-29 03:11:38 UTC,6230386625,6230384532,false,2093,988528
ce04609ba340d292f8f7e5202a2ba8569199240714b7a3abed51adb684f5f989,988623,2020-09-29 03:11:38 UTC,2500764482,2500000000,false,764482,988601
663cab149a09d878e5196f9af8166e26ab88ffa023cc3e7e7fb7f7a1dc17faf6,988623,2020-09-29 03:11:38 UTC,4976313439,4976311346,false,2093,988612
6aae55575205f4ca9d062961014db8474e5d8029f1504915a36417722c07fd3b,988623,2020-09-29 03:11:38 UTC,6210078280,6210076187,false,2093,988612
e340f58b60d454bd808b23710ccfd43924fe9714256a7345ff246dc3d385740d,988623,2020-09-29 03:11:38 UTC,6370477238,6370474564,false,2674,988611
809e8edc1a9d3575ffbad260916c5aeb396dcdbb95be3c195484ff32293231bb,988623,2020-09-29 03:11:38 UTC,6271226752,6271224659,false,2093,988612
8b57dd68867b188af056e864433f8f992aec3aa11adf4782145e9255583236a9,988623,2020-09-29 03:11:38 UTC,6267423020,6267420935,false,2085,988612
74b5bd62d3eb2c7dd98547663bb67cf6fb46bece982bc2f49776e94b6405114e,988623,2020-09-29 03:11:38 UTC,6151032727,6151030634,false,2093,988612
3af29f74b1ab4b689a1bba128b8af8d07ceb4b53f42590432a19defb8495de82,988623,2020-09-29 03:11:38 UTC,4848934020,4848931927,false,2093,988612
b19f31e3ee40d57559c830d5c4de7f3fed19e0668ff2b78a0dd6af022d615fc8,988623,2020-09-29 03:11:38 UTC,6135990543,6135988450,false,2093,988612
6ff7b496a04145cc9a8cad6ae86643f38cb0b57687d69ee13a2fb240ec04c632,988623,2020-09-29 03:11:38 UTC,6165985515,6165983422,false,2093,988612
e4cb98c1fd9c3216293a831aafc2af46d5418dc371e62239b065fc8fe8f89cf7,988623,2020-09-29 03:11:38 UTC,4889298666,4889296573,false,2093,988612
3e81d8898d1346e4c085b449a317e1eea5664fc007ed757a81645ca575fff992,988623,2020-09-29 03:11:38 UTC,6278515258,6278513165,false,2093,988612
4c2c66125d36e17d559511b567690a8e5b047f63e2077487fbe713045b55d524,988623,2020-09-29 03:11:38 UTC,9270968014,9270965921,false,2093,988612
029aaeff9354f27375b727985c2cd83cd1313df68930e6ea85055ee22ac929c4,988623,2020-09-29 03:11:38 UTC,6128565147,6128539586,false,25561,988612
c39fabbafeec9e216fc0e6bea63ed3b11bc9795685618b28398586a7415896f6,988623,2020-09-29 03:11:38 UTC,4937310878,4937308785,false,2093,988612
bef9569e169f9c1d1f036f8061a16db8ba46a4f8e3ae90e2e0482bd2d7ab90f2,988623,2020-09-29 03:11:38 UTC,6299406107,6299404014,false,2093,988612
b118baa11f9d54fb2f939acce4e583c6804cb7b5fb1c43f33bdb2ded621ee8b2,988623,2020-09-29 03:11:38 UTC,6169773178,6169771085,false,2093,988583
acf311413fc66102aa254d5ecf296392a1594609f252bd419a51c4bd6e8f7814,988623,2020-09-29 03:11:38 UTC,4984011958,4984009865,false,2093,988612
a5531e5e68e83355ebb2c25dda6e523dd8bf8bac5acb73b28ff637e12d017044,988623,2020-09-29 03:11:38 UTC,6158501710,6158499617,false,2093,988612
42d143d8a238af7203ede08773c6e0470d94526d77f63590ea72e9ea16026300,988623,2020-09-29 03:11:38 UTC,57462085615,57462083522,false,2093,988612
5e6533255a9282fa1046b324a43d71796d23e0565220d731508d90027edf2cfe,988623,2020-09-29 03:11:38 UTC,4987776545,4987774460,false,2085,988542
b8cb497f89bce3d636a66a375e29a997a89a5bf5794ac201b268644ad1df84d1,988623,2020-09-29 03:11:38 UTC,1451607,1433567,false,18040,988612
372bd2e4064ecccb3d4b998f6e923bea8aa8c4b15b3f931871870bd4dd36f91d,988623,2020-09-29 03:11:38 UTC,6451130721,6451128628,false,2093,988611
b79571fc9d20c300441b4c56df912768d1b6a4bb9e7cc5f29c33ffe2bcdc63d3,988622,2020-09-29 03:09:28 UTC,9274775670,9274773577,false,2093,988530
5457dbb42a520014e47bab7b2598f9f8b19d07b74dbd2ef445efadff6b357e52,988622,2020-09-29 03:09:28 UTC,6699860701,6699858608,false,2093,988610
ed26de8fab7f4a6440a1ae7e57eeeccdc2ad1ecf3292392c750ac657bf635ee9,988622,2020-09-29 03:09:28 UTC,7149919771,7149917678,false,2093,988610
40494437f4d66ce348a1c3cc353b1f0b2a594b5c641e12c0ebab04eccf49c976,988622,2020-09-29 03:09:28 UTC,7108481298,7108479205,false,2093,988610
5c872b4330d1a8b2451eed4e6d391f5e4253bc6772f6f31c1fb181345b11828c,988622,2020-09-29 03:09:28 UTC,57465843827,57465841734,false,2093,988611
6a6da94cc30ff3c2197d43d8c37529994e097851dc460948acca80972d41a01c,988622,2020-09-29 03:09:28 UTC,6473428503,6473426410,false,2093,988611
e460c6f905763600c95a83d79943261c31bf73b6cbc6f1ba48a2d0c9d19eaf9b,988622,2020-09-29 03:09:28 UTC,122772000,122762000,false,10000,0
f0c5c268cf862db00a6283d356ba7913af92258607975a008be582890b36d27c,988622,2020-09-29 03:09:28 UTC,8529949073,8529946980,false,2093,988611
71eccff330cac1045be532bdaf68f645d64f976973355648746deee3aecabe82,988622,2020-09-29 03:09:28 UTC,6625104956,6625102863,false,2093,988610
c91dab7d145b585efff002ac89b96d4ccddd3c64651406d05d4602e67a00fb41,988622,2020-09-29 03:09:28 UTC,1032154,1026154,false,6000,0
4519b3834ad4ddea09d9560a55e6221afb6beee735b62e4fd1227db70c082052,988622,2020-09-29 03:09:28 UTC,6662924125,6662922032,false,2093,988610
0bf5ba4d3ca3ea8cac61bc1d816158a71f5f019bcb775977c3f989ff0d922ad9,988622,2020-09-29 03:09:28 UTC,52702600,52700515,false,2085,988610
3205ac4471b8da84e2f7f65821076b4fa4587e2c90beabc5269c047b082b84bd,988622,2020-09-29 03:09:28 UTC,6617616115,6617614022,false,2093,988611
73f74b897660b52d09731a8b99713ec55619c3016afb5c8c76942f74d90f97ef,988622,2020-09-29 03:09:28 UTC,172470,162470,false,10000,0
02cb1b66203fa4059add1d6a30f53cd3baea38cce2c9f15fd33c74db6f82b8bc,988622,2020-09-29 03:09:28 UTC,11465695029,11465650314,false,44715,0
686e1e2e4edfdf4146778f9d02763764a7338ff6c9c1638177757b3a6a87df05,988622,2020-09-29 03:09:28 UTC,19093461834,19093451834,false,10000,0
a7767fed2e54986dae0e8e05faff82e36481b293c84d4e13a3b2fda3ce0ceeaa,988622,2020-09-29 03:09:28 UTC,6621336486,6621334393,false,2093,988611
5b3996b09ccebbc32683d8b5a22927bf06abb37df9b188085da1d5e9def9b948,988622,2020-09-29 03:09:28 UTC,1000072065,1000062065,false,10000,0
561c5507750447478fafe9839c72bfe1db5e2a6162b06ee29c3bbb3006b71d16,988622,2020-09-29 03:09:28 UTC,229470316,229467356,false,2960,0
65a30eb603d75a6676ef6d157fc1c75030e313b6b18efd945c3e57431316f14d,988622,2020-09-29 03:09:28 UTC,7115893743,7115891658,false,2085,988610
d1e8ef9a59cd0407542fe06d276f52c1bc4809aa83696a3fad6b1019097f51a7,988622,2020-09-29 03:09:28 UTC,6659204649,6659202556,false,2093,988610
03744b8e56e3b7b7967e1ed298e6a267a68e6cbee7d7124ca5f4221c3bf5d7f0,988622,2020-09-29 03:09:28 UTC,6703580276,6703578183,false,2093,988610
84bea011fb4b5212b51bb9be0dee1c3cadee2dbee9b837023abb3ee1b4e07f9b,988622,2020-09-29 03:09:28 UTC,7088240081,7088233629,false,6452,988610
b968ff1c531e77c455e427d1b1158f5e7da6202032b772c1f086060a03ecff0c,988622,2020-09-29 03:09:28 UTC,7112265973,7112263888,false,2085,988610
5b4ae4c02d9b44b986d20205e6890a0580156632f70c2ddf4aeb652343a39f57,988622,2020-09-29 03:09:28 UTC,148700000,148698080,false,1920,0
edf4cfa21ac899e0ee6216686a94dadb1ac12cfa5497c3b6a83f25d1bbcf470a,988622,2020-09-29 03:09:28 UTC,6639405067,6639402974,false,2093,988591
d2aad40f6762ff6fbb2abac9cc34456ebc8d5434a68c68891b516eebba236036,988622,2020-09-29 03:09:28 UTC,568826,551346,false,17480,0
860349bd4bbc262a3fc6e587e74a8e45b86cf6fbc12bd1e73125cadc1d00c2b7,988622,2020-09-29 03:09:28 UTC,204096240,204093280,false,2960,0
0228a53548384ac70db34c94f393d187ef26645154c5044f77bbada64dc650e4,988622,2020-09-29 03:09:28 UTC,7104715603,7104713518,false,2085,988610
1f97f19634d850d0538295f48a75c0c4150d015428f98ee72fe103eb567a7b68,988622,2020-09-29 03:09:28 UTC,6583616799,6583613253,false,3546,988611
a59c1192705865951911d83476cebb3334220e22f4b8dc2a3705c444d5ad7579,988621,2020-09-29 03:07:17 UTC,57503093410,57503091317,false,2093,988610
4ebad474400336fa9c61e5e0f9a4999753b8f76cc76260ffc64243d830698bc1,988621,2020-09-29 03:07:17 UTC,8456701303,8456699218,false,2085,988609
b3481a9bb5abfb60410867020bc3175980957b1c90f8976bb4d6309517c92a38,988621,2020-09-29 03:07:17 UTC,7491603291,7491601198,false,2093,988610
22b4551ef55b36b43c0463bc44fad89b3aeb037de64b9490af02a73b1acef886,988621,2020-09-29 03:07:17 UTC,7663950920,7663948835,false,2085,988610
a72872b183521a24831fb18ef6b6642caefce64a6a142e0ca2b9244556413798,988621,2020-09-29 03:07:17 UTC,7375868041,7375865948,false,2093,988610
181ca0ef5b76caab980255ecc4820800537f7969cf98befb7caabcee70f2faf6,988621,2020-09-29 03:07:17 UTC,7371904566,7371902473,false,2093,988610
045dc0b161bfea7bd02cf17185a9f5cca75a3a6e6aa7183844a7e5d133599dde,988621,2020-09-29 03:07:17 UTC,7439761402,7439759309,false,2093,988610
3950acb048f56dd8fe5e2de4901f9aed2399e8ed6e82e3cc0b4f905d883d5e95,988621,2020-09-29 03:07:17 UTC,7929711851,7929709758,false,2093,988522
745d3ff7ffb79fdb02139fcaca6ecfd0f4a684258f65df1328cdb441ef5c704b,988621,2020-09-29 03:07:17 UTC,7396173479,7396171394,false,2085,988610
d9a227e93f2ed225a1350c5b12b37f0a34a20aa0b59c7e10e4793ecfdc010d8f,988621,2020-09-29 03:07:17 UTC,500166356,500156356,false,10000,0
2257d24866f31e7d59cda68772c01b408353d535d775cd135a75e3f0959b60e8,988621,2020-09-29 03:07:17 UTC,7989810431,7989808338,false,2093,988610
414b3dfc7567af90929d97025529a323e5475ca8062eb1461cbe8d395e54c12c,988621,2020-09-29 03:07:17 UTC,7447493285,7447491200,false,2085,988610
4023218fde2df7613fe5edf26f9e4f871a6afe00194e65a42f0b0289c7c63f36,988621,2020-09-29 03:07:17 UTC,28283468,28281375,false,2093,988609
037238e7d383dfc9861232143b49afb9327768bf00c574ab6ab886710c663e54,988621,2020-09-29 03:07:17 UTC,47039699,47037606,false,2093,988609
4761ec225c69e0ad578879c26152d8f3eb4e04f0d104b286ba08396eec04caea,988621,2020-09-29 03:07:17 UTC,2899394363,2899171039,false,223324,0
026adcfac3df57efeb0e5104c6a0ca29cc9c45f327521cc8a56693244bce57f8,988621,2020-09-29 03:07:17 UTC,20820781,20817816,false,2965,988609
2b3653fa376c9095134e51491b87afb30fa4f86ebebe51ef1833d98627550156,988621,2020-09-29 03:07:17 UTC,7292648106,7292646013,false,2093,988610
9c661f3ce8482b4932265684a3a26e3f15202d537cd8bcaf2268361ab8efe575,988621,2020-09-29 03:07:17 UTC,32118743,32116650,false,2093,988609
468b5ce95382a8d9b97c447382b5ffa96134b7a6a78cc47fa37a5a4e06b4270f,988621,2020-09-29 03:07:17 UTC,7399869753,7399867660,false,2093,988610
509c597d27521b54f95ab55d8b33320fbf450ab7bb65328393cb61ac07b4e585,988621,2020-09-29 03:07:17 UTC,7613305368,7613303275,false,2093,988610
4f83339d6be312b3aa8fc4c0e21ae9cb52ff1586f397c6c28b2bcadd2c7fe656,988621,2020-09-29 03:07:17 UTC,8533638557,8533636464,false,2093,988610
fbe873297213c78fc0ee7d7106568c9c02ff195808e6f1b1d4532a014e2bc35b,988621,2020-09-29 03:07:17 UTC,7487882246,7487880153,false,2093,988610
c60c23e671e85102987b39faab23ff00b0b708f78592d405a8867393ddf7f074,988621,2020-09-29 03:07:17 UTC,7157281345,7157279252,false,2093,988610
0cf43c414a20cbcc9d94fccf7265db07f4ccb61f2a4503fd3aa2c0bcd44dd50b,988621,2020-09-29 03:07:17 UTC,7451196642,7451194549,false,2093,988610
0114bc159feebcf9781df5887a785ede78b390bfa868260301f7bb7b405547b7,988621,2020-09-29 03:07:17 UTC,7421048572,7421046479,false,2093,988610
4e57091b7801cdd459f1bf8abc13a74a645370572a82bb07c5dfb0bca9e10750,988621,2020-09-29 03:07:17 UTC,7933594495,7933592402,false,2093,988596
5df5e86932ba1d9223f87dca7e84e467d9586c35ed10c594d0600d86dbb3d2c6,988621,2020-09-29 03:07:17 UTC,4000138679,4000128679,false,10000,0
42a1b823b18e21f60bd511ed330706c2929cc01f46d82130ec8a9638549a1b12,988621,2020-09-29 03:07:17 UTC,35887900,35885807,false,2093,988609
4d4e86332b09eb5cb5ea1ffcbb69abb0a3167a46532ec6c4621c8329f0ee63bc,988621,2020-09-29 03:07:17 UTC,7576452985,7576450892,false,2093,988610
e70484b422cf813de34ff259ee2068fd6d19e044ff0a24f4a3d6f6afaf2686aa,988621,2020-09-29 03:07:17 UTC,50490948341,50489648341,false,1300000,0
93af3670c5fdb4053a64e09bc0d1f4a362f99d2ffddca149b3a747b4b5a9fec8,988621,2020-09-29 03:07:17 UTC,39592743,39590650,false,2093,988609
206bdcd27ea7ecb34761fc4a536d74ffeb4c813ba9a4f150f0c0f5be3e6ddf4c,988621,2020-09-29 03:07:17 UTC,43305146,43303061,false,2085,988609
af804dcca15ab92f8fb3a03847519680bb0918572c646bdbb5bb2f5fb58c25c1,988621,2020-09-29 03:07:17 UTC,1833155004,1833040616,false,114388,988610
989ddd3c583ae18267b6b72730bd43c002eea74007902a178e98e35980846d94,988621,2020-09-29 03:07:17 UTC,7878859548,7878857455,false,2093,988610
ac5e0eebb63fbc8b7f3df15abcda6bfbdc8fd37a9ad6304f1808f50e8050ee3c,988621,2020-09-29 03:07:17 UTC,7918422416,7918420323,false,2093,988511
c0c4136609bece1c1ce5065e6edb955536d3e0ba2424580378485bbb00fc5d4d,988621,2020-09-29 03:07:17 UTC,7443669869,7443667776,false,2093,988610
c59b97b7f96a5e8290ac8a13726055e0e1964b14072062698bbed81b28e089dc,988621,2020-09-29 03:07:17 UTC,7288943683,7288939274,false,4409,988550
a0b51ef7fe89c90f404683285e9d4933170fa1ba581b983ea98318fb40c4225c,988621,2020-09-29 03:07:17 UTC,7970641691,7970639598,false,2093,988610
3eb477861c7b239fe79c5440180924bc5d0243cc366be9c81b3922d2bb8f33f3,988621,2020-09-29 03:07:17 UTC,78472396367,78472250103,false,146264,988610
75aeca4e3c1c1177cceefab02768887025450339d2709e54e6173223cad55bfe,988621,2020-09-29 03:07:17 UTC,7403620612,7403618519,false,2093,988610
bf44de5b78ac1bdfe75d2840d0d58dc9fe8e435704ecf0d7ec037eea80cc5bee,988621,2020-09-29 03:07:17 UTC,8241323103,8241321010,false,2093,988609
ad84a69c61507362e9a92fe7de3dad87d0fc61b44f70dce55117978f75894a7b,988621,2020-09-29 03:07:17 UTC,236035396434,236035392905,false,3529,988610
f99f186961bbb65c118dd4d9131c8acddce49d06e338b1e1b093cc6d762a6c81,988621,2020-09-29 03:07:17 UTC,7532023126,7532021033,false,2093,988610
55c77389677c63581c3e548f3a0691ce2aa5552e0dac084fb84e42edec43217c,988621,2020-09-29 03:07:17 UTC,7572599179,7572597086,false,2093,988610
2df3b97f1ac4dce017957ca199ba69bc444bb04993063e713358a0d7d12072be,988621,2020-09-29 03:07:17 UTC,7528352993,7528350900,false,2093,988610
93171f5a64e952e6ad9016eb8184d6cd888d3a4c19487707c5a2f72632fd70d8,988621,2020-09-29 03:07:17 UTC,7922286468,7922284375,false,2093,988610
7c9f9a3602f29a069eaa8961539da69971e21c64e5ebb760d63156bdc2c9c115,988621,2020-09-29 03:07:17 UTC,24559083,24556990,false,2093,988609
b96daddabe1d816001a1857fd12448a0cc2d3656096f8ae999a99f9e854b691e,988621,2020-09-29 03:07:17 UTC,8025577430,8025575345,false,2085,988610
ab03d1d0dd27722e95832b8f045a3be36609c85d2adf87f9320328e69c31d871,988621,2020-09-29 03:07:17 UTC,8062874683,8062872598,false,2085,988609
65536c426497653ab1b60164a91d2a5005f77436626694ab4743a3ac3c6bc0cb,988621,2020-09-29 03:07:17 UTC,19093471834,19093461834,false,10000,0
a7e3d26d86b09c9cc152f00b7f722ceab98ccd4c054f5fc5dcb5715562770512,988621,2020-09-29 03:07:17 UTC,7914614506,7914612421,false,2085,988610
07387e89c4f084f7d3b669b36804947d4e8bed793936e2dfdd1427a302feb0ac,988621,2020-09-29 03:07:17 UTC,7379693800,7379691707,false,2093,988610
d889306fcf9ea4bca59eb72b3502faea737e45d66a57a05244e458643828c165,988621,2020-09-29 03:07:17 UTC,7843283726,7843281641,false,2085,988610
d99ccd0902cd7b692ffcb420070ac484653a538909aec1ce9f803a4272146fe1,988621,2020-09-29 03:07:17 UTC,7153613894,7153611801,false,2093,988610
d60d44142f7a4747d9ce8a6747463deaabe849775023c3a8c36fa39197d679ce,988621,2020-09-29 03:07:17 UTC,5887842,5884484,false,3358,988609
f0501c3b536b0a2d221bd1e0ccd098261268cf4fb099196d5c4fd52ecc6e61bb,988621,2020-09-29 03:07:17 UTC,7568830333,7568828240,false,2093,988610
8ead2f0b6eb677bd949fbdf7406e4a88716e02d06e29a0a7c71b302742e07edc,988621,2020-09-29 03:07:17 UTC,7650582057,7650579972,false,2085,988610
0cf5b3f427bc52e975970765243fb8f42a0d5c31345018b997c16ca6940739b7,988621,2020-09-29 03:07:17 UTC,8278706712,8278704619,false,2093,988609
ea46fa3da15b151f9019beba7790acc07c19466d59036cf346534a82bc6db37e,988621,2020-09-29 03:07:17 UTC,7925945109,7925943016,false,2093,988610
52e06f4f958819481f3f8ae650bcc9f6556a8342570255c517d3c8453acc35aa,988621,2020-09-29 03:07:17 UTC,7407430520,7407428427,false,2093,988584
42c33dfe473cb6ef1f04b4d918a8fa69054db1b8c645f98c1035c415866cd1a8,988621,2020-09-29 03:07:17 UTC,7355584705,7355581740,false,2965,988610
ea2dc02c4cb2bbcf636ca361317fb1ca4d658af913163185fe27116c70000078,988621,2020-09-29 03:07:17 UTC,7296348586,7296346501,false,2085,988610
32ad62a56d0b83afa4877caf4a5c7a478580a0e48f8ee0c611d163e432aef745,988621,2020-09-29 03:07:17 UTC,115467072,115464622,false,2450,0
2302ab711c67770f0911c0c57da3626bae6b1b4733d145abb3019fc13a18c428,988620,2020-09-29 03:04:49 UTC,66961140,66959055,false,2085,988609
9b0fff4553fd14a611102579c3ae5c8a57341868c1a9b6ea5fa3ecb24230fb29,988620,2020-09-29 03:04:49 UTC,144493863,144491770,false,2093,988608
7b022b1d41cca6e75f9b22ce85df9a60180fd6d87321ec560ce336aba4a40e33,988620,2020-09-29 03:04:49 UTC,63209254,63207161,false,2093,988609
4f7bc462529c11bde5e17e83dcdd6aaf2e9764e927e68d93115602bdd0ca8506,988620,2020-09-29 03:04:49 UTC,19495875263,19495865263,false,10000,0
b98b479b0f48bd6be0631620024e539c867826c3f6471c6f0e20a8fd557ec8d0,988620,2020-09-29 03:04:49 UTC,88509918,88507833,false,2085,988609
cce922da7bcf4f463048396dda1d6fc06de3a4e5579eff846325fe07b4baed00,988620,2020-09-29 03:04:49 UTC,95916505,95914420,false,2085,988609
6b5d24795cc78b35b9a556126b9e3e4212ad173847dd3decd0953ab5b5518486,988620,2020-09-29 03:04:49 UTC,161028239632,161026439632,false,1800000,0
af717f3819a388e82e2daf4e37e0f5872cd62ba4ee16a7b7bbd897f0ec4354d9,988620,2020-09-29 03:04:49 UTC,133361647,133359554,false,2093,988608
583370520cacb97aaed74d2803bbb2f8683e02ed593fb26f77548debbf8de8eb,988620,2020-09-29 03:04:49 UTC,129585832,129583739,false,2093,988609
6fb29dbef8cfaa01f629afc4258293ece23e2c92c9d6cb4be6c03b87e936d984,988620,2020-09-29 03:04:49 UTC,71894436,71885890,false,8546,0
fede76fd4f2d341ea21d24e47d0b3ab857343ec8281ced5a6ac56f8b3fa3af1e,988620,2020-09-29 03:04:49 UTC,237513366939,237513356939,false,10000,0
db8f5183a557deb633afaf7fa5241ba702fb17d4a207438789ea0825ab9f4a8f,988620,2020-09-29 03:04:49 UTC,8537452769,8537450676,false,2093,988608
9bd792f7532e531370236127fdb9ea91f420f76f94c6a98540550f3c6f6d3aa5,988620,2020-09-29 03:04:49 UTC,8493630643,8493628558,false,2085,988608
b3241737e44950b37fe5843ecc8016f8a45da6ed6d4d870f4ce160614145c217,988620,2020-09-29 03:04:49 UTC,57506780606,57506778513,false,2093,988608
c69ad0c4220c74a17343ee3ba44d3f3a4946972a4b3eabfa46e491d8aeed6299,988620,2020-09-29 03:04:49 UTC,92290996,92288911,false,2085,988609
3cdcc183608f7cea52eebacde989a2e4da90e9d695463eb4aef4bee9b8bbd29e,988620,2020-09-29 03:04:49 UTC,179152158,179150073,false,2085,988607
c0a40ea2f806660da08b75ac6c61c6a0699cee8bbae0f062ec38205695517568,988620,2020-09-29 03:04:49 UTC,140857176,140855083,false,2093,988608
352c8f4844975a9e6d27c4fda35cb3db601332f35fa3e5e39ac0338487044963,988620,2020-09-29 03:04:49 UTC,70665380,70663287,false,2093,988609
07ec6eec76c043f7cdb80c65574a868ce9f88a946d1ef2308190389a565f1dcd,988620,2020-09-29 03:04:49 UTC,137119081,137116988,false,2093,988529
6d66630c06e866677b2af0c866687011d788b0b221deb07015a8a301ae04528c,988620,2020-09-29 03:04:49 UTC,2000065540,2000055540,false,10000,0
019a7f5728150c63905e47ec57427d8d5fd35c8ac09c0891f4801e90256ba827,988620,2020-09-29 03:04:49 UTC,72151721,72143175,false,8546,0
0dfc43c81f0238f02364434c52996cb96dfd1dedc1b22a28d4743e79c623a282,988619,2020-09-29 03:04:02 UTC,216600500,216598407,false,2093,988607
059fbceda61c235555140e10cb7b6855423dfd547362595f1b356c7ee2daa057,988619,2020-09-29 03:04:02 UTC,227963334,227961241,false,2093,988537
4792f73a9364cba89766aedb39e3ebf423e2572da92c76bbc86a985f8c0ce9bc,988619,2020-09-29 03:04:02 UTC,212871644,212869551,false,2093,988607
23d27d9996edf99eab0b860d595bca8cd883b3c02dfb2662589e7a57618ea03a,988619,2020-09-29 03:04:02 UTC,224244379,224242286,false,2093,988607
7e2d4c217c8c6a2a4e997427f0379dfbd3a2f07442cda10126842de17c8fefc4,988619,2020-09-29 03:04:02 UTC,220416676,220414583,false,2093,988607
1c829a1235fac4728790406551d6316f51e660898cb0a4375fde584bf1292bbe,988618,2020-09-29 03:03:54 UTC,406825166,406823073,false,2093,988607
f10290f7383adbeb6521b2d9bf19ce80c492fb7aeb9f0983f5bc796e7d8cc340,988618,2020-09-29 03:03:54 UTC,8497273190,8497271097,false,2093,988607
e9bb98a6ae40bdfc5507573a0de46de55b18f280d62b78a2a06cc35691371f29,988618,2020-09-29 03:03:54 UTC,362309406,362307313,false,2093,988607
a6c8552d2ac07e7d6388ae622f35c2f85fa697837af9aa0bfa3e43a94e8d9d8b,988618,2020-09-29 03:03:54 UTC,365991543,365989450,false,2093,988607
8a1bedf92b0f840b2c118cbdcefd6eae7eb7f2fc9d6e6cffaa94862a4d267930,988618,2020-09-29 03:03:54 UTC,351064308,351062215,false,2093,988607
d1efa34b98ff52641c02beab62bccb99f8ac4ff7a5298bf5b6eb98bb628ba5f0,988618,2020-09-29 03:03:54 UTC,264961541,264959456,false,2085,988607
7b01d5e28d8d92c37da1078033c55cc052c7277c4dcd5e502a0d7bb6090c7081,988618,2020-09-29 03:03:54 UTC,354811962,354809869,false,2093,988607
dbbc6da4477f109a9719aaa07ad6a2a360a5a7fb4983733f8649282c5ab05441,988618,2020-09-29 03:03:54 UTC,369660832,369658739,false,2093,988607
a0ba81c99d5acc6007e29e34e44c220213b24ca85322b2b5a0fa2267c4c085c4,988618,2020-09-29 03:03:54 UTC,57510540877,57510538784,false,2093,988607
dbf16e0876852af39f6eddf1c8d1f599f062ccbd96bbcd727cd3da345b56c74e,988618,2020-09-29 03:03:54 UTC,306704643,306702550,false,2093,988607
8464d7a85b27f4a2b03da5ac6062f6375bda0874a9072f43077f3f415343deb0,988618,2020-09-29 03:03:54 UTC,310496210,310494125,false,2085,988607
4e01b90d6c4e2e2f20f4e5f146fa71e8f60049cf201b99e2148a30052face3fc,988618,2020-09-29 03:03:54 UTC,181517939163,181516939163,false,1000000,0
ce66e5af7e2790a98794c01dd319a34bea04fd3767238d5daa7b1655fbbd82dd,988618,2020-09-29 03:03:54 UTC,302874090,302872005,false,2085,988607
2592b4a1257101078a31fce8e46b773b756f63aa8cf5db76831082dea1157f82,988618,2020-09-29 03:03:54 UTC,429177945,429175852,false,2093,988558
ba3f69ad8a90231c6231c2c95395cd98ad34f16bea39f63766e6d4fab892ce63,988618,2020-09-29 03:03:54 UTC,8574079108,8574077023,false,2085,988607
35896598a1724d0471abd71b8d5c6f0812679119237d3916b069b57e2e3f6618,988618,2020-09-29 03:03:54 UTC,358484631,358482546,false,2085,988540
5a38949227819cb2ddfc756c8c550b91e7418be3149775447e648062c064de53,988618,2020-09-29 03:03:54 UTC,19495885263,19495875263,false,10000,0
ccac3881c7228f01f8de8c579e2a45467c95f27ab1fa7bf09e52fd46e41f2065,988618,2020-09-29 03:03:54 UTC,314204971,314202886,false,2085,988607
8979b54b7ec8e0b7124c7f84a1a78b87d318a2b8cb1390d37178579454a4e6af,988618,2020-09-29 03:03:54 UTC,425402357,425400264,false,2093,988577
20bfdd1eedbb9a989ddd6bbcd005bbefa27ed41e6a964670a723c0614aab6802,988617,2020-09-29 03:02:08 UTC,201976106,201972533,false,3573,0
a4364834a95438840ab4393d4e190b3aa4f12ca0ce1cc8fc8bb315e748a813d1,988616,2020-09-29 03:01:48 UTC,8185536556,8185529556,false,7000,0
838860f1f8858c72d5041f18712cd81c9fd3959991469cc7e774b7d4caf95f82,988615,2020-09-29 03:01:28 UTC,999963349,999953349,false,10000,0
69cdc0cbd85b758e13d595eb73de2e8f6f19e2c585722103f7a8f50347ddd37d,988615,2020-09-29 03:01:28 UTC,1671388603,1671320235,false,68368,0
10fd22019c00a818fb2416e840b0e29fa244c4934ed8dbe853f1d8f0de455c0b,988615,2020-09-29 03:01:28 UTC,64528004,64525039,false,2965,988604
4410cbe64357f7720353551364bec479ec82e1dd61926051c6bd3df5b56fc412,988614,2020-09-29 03:00:36 UTC,85611857,85609473,false,2384,988602
47e93000b09923e25595eb35f777f6c0d58573b52008f1bc8e5bb4c2efea4858,988614,2020-09-29 03:00:36 UTC,1980047,1961716,false,18331,988601
38e46e4640a21471450bd483d4a7ef9a56c10f43f512633add4542c26914d70c,988614,2020-09-29 03:00:36 UTC,1706143368,1706069044,false,74324,988601
b6e7c3ed299c01e564b8fe00b8436dc681cc669894e53bd912d64dbc3974fd08,988614,2020-09-29 03:00:36 UTC,160542213678,160541908338,false,305340,988603
c1569fc662d79103b995b83c2fe9588bf05b21605321148831bac1216d69452b,988612,2020-09-29 02:59:58 UTC,87280185269,87280182919,false,2350,0
f86e5acfde79dc7fe32507fc6ec6f97bc7ffb0486dc05aa63a279dd4e5ac0737,988610,2020-09-29 02:59:09 UTC,204964963,204958963,false,6000,0
d6ec6f5e00fe7903047394f76246463f62555402d063c587ba3ced5e0f60d390,988610,2020-09-29 02:59:09 UTC,499990000,499980000,false,10000,0
efad1a69b30b70b1b13763345304515f5c99f3bdcd52b9a8fc19d4609214fa87,988610,2020-09-29 02:59:09 UTC,500539684,500529684,false,10000,0
9c01ae7ea4f0a1eef6be7da95f735da27c0a1b93d919f0d64630c1db4f2491a9,988610,2020-09-29 02:59:09 UTC,40671335,40665335,false,6000,0
d20eb9a3bff1bea5f90d9fa4b73c3b5f8ff4f1270cab79f9d374dc04a58a7b8c,988610,2020-09-29 02:59:09 UTC,56040344,56039344,false,1000,0
48cf06a71c4eebec49be2bf3396ebb1748ae887055da6e672ccfc1066b21ac81,988610,2020-09-29 02:59:09 UTC,229759469,229755896,false,3573,0
eb1bdab123bb411610e3edd0b67beeef26b9d50cf6674ba23c77ada1ee19af25,988610,2020-09-29 02:59:09 UTC,861384706941,861384704848,false,2093,988599
cf8a35001cccfb37da3ee7a11ab4123b2be703ed69eeea018393ac5461654f18,988610,2020-09-29 02:59:09 UTC,934065321,934063206,false,2115,0
bc91287f552eb43edd17f3d979c8a7b3830cfdbdf355e956b56a281232f5e806,988610,2020-09-29 02:59:09 UTC,213704800,213703654,false,1146,0
e0ec87e41f05d558bcdf6cd950bb418edc1b872cb98e63516b6e6f57deb1be65,988610,2020-09-29 02:59:09 UTC,72182777,72174231,false,8546,0
4cb33ed28451d701b9bab2e3f35ef68b357c7862127f914fe447d08088ceac42,988609,2020-09-29 02:52:55 UTC,500000000,499990000,false,10000,0
fd05134f293a43a0c9ab9086bb1ab2ef3976276abcb0eb8c371977cdc8f7e342,988609,2020-09-29 02:52:55 UTC,2673000,2666220,false,6780,0
8754b91af44b2a36651759f6803be0f34da327ab2d8362d269c77b7ffe25eeb0,988609,2020-09-29 02:52:55 UTC,684857250,684845250,false,12000,0
35cbfdb97f809350db4e6bf98020cd5ab9e7c225ce0925640a5132f7ec539d84,988608,2020-09-29 02:51:20 UTC,3781800000,3781790000,false,10000,0
d62ed9901e33f02e27a75adcee47de4834f7899fd77258f15525f22e277d31fa,988608,2020-09-29 02:51:20 UTC,1708057409,1707982999,false,74410,988597
df78b142cb4ee7dc0f8881c5917f012c3ff5c136aa50b7f2b85e5c831b403a62,988608,2020-09-29 02:51:20 UTC,863255975434,863255973341,false,2093,988597
90d484887dfc1c39c120d2c1ba1f57e1bc73a69820597fd33624e75721c261d1,988608,2020-09-29 02:51:20 UTC,204281636,204278676,false,2960,0
12ac20c49ad2ab86cb03a1bcb960cc4066d81f2f5043e429db3b6c6d8387053b,988608,2020-09-29 02:51:20 UTC,98997740,98995628,false,2112,0
0d29f5e84b4e6f5f22734276e5cf682f517cdafeff81641c1596c9a80ae861d5,988608,2020-09-29 02:51:20 UTC,2388255,2369617,false,18638,988597
ee4f5b8cb4ea0a10013aa129f999121e5326e0a431091138a60d4c8c1ccc899f,988608,2020-09-29 02:51:20 UTC,499993349,499983349,false,10000,0
eda4c7e284650a3eaf2ddb0ae61952ca9a2042fb94e345618d6c65757d018d8a,988608,2020-09-29 02:51:20 UTC,121985132,121965951,false,19181,0
ed955ccfc5955d430f538b34f847078825c07de6f807dde0ca57f67d5d280de7,988606,2020-09-29 02:47:45 UTC,122560000,122550000,false,10000,0
51bef3249ea9d5dca1b881e2f19692a95f65e5a0dee8d1fcd354352dcb51f7d2,988606,2020-09-29 02:47:45 UTC,230027483,230023604,false,3879,0
474a932fd52e3f37411686db3cf7cf5f39811bb531b3f6974478e5b614680e3d,988606,2020-09-29 02:47:45 UTC,14360044,14354332,false,5712,0
042e67a12f4e6120e99349fc5aa65eeac1ce91fa63fb0ed055a27a7318cfc363,988606,2020-09-29 02:47:45 UTC,3781877224,3781813699,false,63525,0
ff6ec91546a29e2f91972457587d276fa6ec6368be0146b30411c691976536bd,988606,2020-09-29 02:47:45 UTC,72211162,72202616,false,8546,0
45463895fac7fcfbf80d3dcbc7c9164cdda30e31d4126b84f3b3c057b9705c2d,988606,2020-09-29 02:47:45 UTC,202134451,202131491,false,2960,0
202b1a430ae25e09905c8387e9a2f89a3345809e0b6a6b88b8ca4788463a5fce,988606,2020-09-29 02:47:45 UTC,91758127321,91758124971,false,2350,0
bcf3453eb99d309fddc777273669bf92add33d7bc421b0bc1fc0007a180e1706,988606,2020-09-29 02:47:45 UTC,500003349,499993349,false,10000,0
0aa39058a5ef7ff1a5f74b2a41bcdaa3d1825e6c0eb4144320fdd3424a9cc85b,988605,2020-09-29 02:43:33 UTC,204488105,204485145,false,2960,0
874bd478180e2e93ed3cb513d7f05a9e33555b165c528aae0917a520f23bd05e,988604,2020-09-29 02:43:04 UTC,23247448,23242834,false,4614,988532
d053295b651d7e24d8cc22efe2966c6beeaf80d72d8933e28e89b90c17daf29d,988604,2020-09-29 02:43:04 UTC,145158039,145089671,false,68368,0
af8f680c0dd2dde5941e27ad304c66746b00988efbcd56e2c87d601e5f225ef9,988604,2020-09-29 02:43:04 UTC,26366879,26356879,false,10000,0
3cea5a57f63c5514127bc868f8e75c25417916b2629d07e49e47a3b3430d499e,988603,2020-09-29 02:41:47 UTC,499980000,499970000,false,10000,0
d47ac38c31a616cbdf65343a4a99adcb31c4a55fbb4fabee2976ead1b41ba1ef,988603,2020-09-29 02:41:47 UTC,24648970,24640296,false,8674,988591
038ad865d1b167b7973e6297f211dd9a011e7a311863c8846a9bd0924e3edfee,988603,2020-09-29 02:41:47 UTC,19012258496,19012248496,false,10000,0
1b1c76cc5c8d02de279f2c5107a1152f0b599375f256397960ddf2a2bde71aad,988602,2020-09-29 02:40:34 UTC,2939439,2918485,false,20954,988591
4d9e0ad555360a2ce3c5e148e12685fbd5e6738961efa388fc0f9b598dd9cada,988602,2020-09-29 02:40:34 UTC,1709705822,1709631447,false,74375,988591
05bbfdf70d14a8b01ca076b373b9c659cc2fcccbb8d31c6f22126ed254d935cf,988602,2020-09-29 02:40:34 UTC,202332273,202329313,false,2960,0
e4f49aeddc2636b6b69aa315b3c65b5985d773f24d36297749ce264fb860f024,988602,2020-09-29 02:40:34 UTC,533949091,533922724,false,26367,0
962bf94b7bc2f3372c19056c551e8ff833a6b320b1a6837f39301f594063ba38,988601,2020-09-29 02:39:45 UTC,499990000,499980000,false,10000,0
bec43e8fd08009c4c6e93882ae496e0f32ab156b775e42ae69b89f1afeb23285,988601,2020-09-29 02:39:45 UTC,230274461,230270888,false,3573,0
91585c4adf9e76b781c640f51c7524b4d681b79324c056552567b56fee2fde78,988601,2020-09-29 02:39:45 UTC,20000000000,19999905480,false,94520,0
ece9d97b421987daee10a3cfb2abfa43720822a825886ccce07f236710560f7e,988600,2020-09-29 02:37:49 UTC,66385497,66372354,false,13143,988589
d41c3667e19101f1ba70a81ddcd4d5f53df31d6922df29ac32c366b12b4b291a,988600,2020-09-29 02:37:49 UTC,500000000,499990000,false,10000,0
64364232c70468c5d4a72816ed8774a186352034d8fa3039731d293fcff4e1ba,988600,2020-09-29 02:37:49 UTC,18922632514,18922622514,false,10000,0
2d44cebb6f2e17b609986894de2ad819332bffb4ea0017db45409d73029c1289,988600,2020-09-29 02:37:49 UTC,2000191535,2000181535,false,10000,0
f88ff7368daee147bf7d9ba6a55c65a040eefbd02342ee3f5be8797196079f5c,988600,2020-09-29 02:37:49 UTC,204643810,204640850,false,2960,0
5fe06cc3e3e64d51bdfcdba1ee88f49a5a123e3670a371ba8ff341c9c4845243,988600,2020-09-29 02:37:49 UTC,1085311612,1085211612,false,100000,0
f97ba7dc680e3d02f16659c7f00e4b340e6f88bbbb4f03cf0e1cc28c402a4590,988599,2020-09-29 02:35:51 UTC,2827866,2825773,false,2093,988570
bef61c8437be8f7575a13ed81db8100806e00ca842c813f994cd90ca9fe10803,988599,2020-09-29 02:35:51 UTC,6004464128,6004457128,false,7000,0
d31ce72375faec865f6f1f56523ac9ec12958ce9fee5b854b548f7815243c868,988599,2020-09-29 02:35:51 UTC,72275026,72266480,false,8546,0
0bc5b64d701d23ea0f7a1dd5c10891f18e224853e6c0bcb2fba874f1c7e60d83,988599,2020-09-29 02:35:51 UTC,26368799,26366879,false,1920,0
dcc1c87ab219b92c90fb6b5bb08aa50c84277fda6e9fdadd9729e98a36b44812,988599,2020-09-29 02:35:51 UTC,72321144,72312598,false,8546,0
972793320793c4cef3cd6033957910b78d26e7a5072ea32b73a3045bca28bc85,988599,2020-09-29 02:35:51 UTC,33840589,33830589,false,10000,0
603d46a7d07c1d04b3fe7924d7737428b7fa5800ff06db012d9716d295080232,988599,2020-09-29 02:35:51 UTC,18922642514,18922632514,false,10000,0
a0156079bb4486989de5fb4b215153b048385b9e3d0103c06b43147d478953a8,988599,2020-09-29 02:35:51 UTC,3000000000,2999955480,false,44520,988597
52e46d3513b6044db6bcc10af8bf66fc68670a1c730b987fc92c745257a2b213,988598,2020-09-29 02:33:11 UTC,9044100911,9044070911,false,30000,0
6b3bb9ae2d4b091ef891dccdb0e1f518dd3686640a370170013dec73ec8b2ab8,988598,2020-09-29 02:33:11 UTC,72418175,72409629,false,8546,0
4aa3cac1f3aa6708d113ce1f78b17735a9d8ebf3d6c832c32f04a9728b2d083f,988598,2020-09-29 02:33:11 UTC,72390162,72381616,false,8546,0
450121cce40033fa0ce1537e2e9ff973f0ad822c5448de8f750030408b13a479,988597,2020-09-29 02:32:03 UTC,72463547,72455001,false,8546,0
c841a88fd4f9085df14051435bd6247b79da2c5fcf319023b70cf2a09615e482,988597,2020-09-29 02:32:03 UTC,3441764,3424578,false,17186,988585
cb1a683c793c49c81884b488dbe895ca6fe635375e5a66a1361207f7dfa1c948,988597,2020-09-29 02:32:03 UTC,4525010000,4525000000,false,10000,0
c8837bc76f0f32ec3a9e03fa9450a84f9d79dc9f41201e64c46f96aa00d785e1,988597,2020-09-29 02:32:03 UTC,1711212671,1711138313,false,74358,988585
932404ebff149131b8971f9c462bf846c68b54580786760a3d0826f549f6abd0,988597,2020-09-29 02:32:03 UTC,14283471664,14283129664,false,342000,0
01565c3cd780526f8ed797f7d5ff8975ab1c7ab259a9a442bc4054ba01be7c6e,988597,2020-09-29 02:32:03 UTC,499980000,499970000,false,10000,0
dda9138f52c3c0d3fb9400713e0be3f890c35ebbbc1120a3774922ed04c9b3d9,988597,2020-09-29 02:32:03 UTC,204311947,204292922,false,19025,0
59cd0f761a416c67d47e550ca93e619545d84bdc60510431c6f5210bff108178,988597,2020-09-29 02:32:03 UTC,500020317,500010317,false,10000,0
aaec73dcbb1050c8c64b4864678af73c136f317ee6258fceb758cdbaec689cda,988597,2020-09-29 02:32:03 UTC,20401006420,20401001797,false,4623,988586
840d08d77c2bab8176069912d00d9050ff5c7abac33ae16d5c48c694847e4df3,988594,2020-09-29 02:28:40 UTC,26378799,26368799,false,10000,0
700fd5c64f8409bb1c034cd6158db3c75e4f45eba03715b383e4f86a9b64930c,988594,2020-09-29 02:28:40 UTC,500030317,500020317,false,10000,0
8a6dca446eb6981fd421c073687c6ef17e48fa64f1135b15323174848378ca08,988594,2020-09-29 02:28:40 UTC,202486239,202483279,false,2960,0
ab811604cfe44569a3cd20aecdaea60ab9a475267c6a3bb269ad4e7f92ec429e,988593,2020-09-29 02:28:02 UTC,1131470000,1131460000,false,10000,0
ab0cc0ee8d05c2bcabffe5b6ea98060c77170357f64b3014062548100f52bc92,988592,2020-09-29 02:27:25 UTC,53956314,53955314,false,1000,0
422c87aa88ee8f68c981beb3ed8687525e15bc66ac003e9dcc806b2b48efa367,988592,2020-09-29 02:27:25 UTC,17668799,17658799,false,10000,0
5264d0809a50aa9c1bd5aad3714817fdeb3336f27108d9b1c57b3641c540f78f,988592,2020-09-29 02:27:25 UTC,230437978,230435018,false,2960,0
ea6db2a2cc2f22e2f126a89b57e1389166bed1c95638aced6780bb5337570378,988591,2020-09-29 02:26:19 UTC,499990000,499980000,false,10000,0
8f3d41b324f4f11aadb9f3b15bfa4f5871b8281d729e253db98299239180ab16,988590,2020-09-29 02:26:17 UTC,500040317,500030317,false,10000,0
165021312661f7c62368e4bc15f19da6adb929703bbaa620705e5ee70570a0b2,988588,2020-09-29 02:25:18 UTC,103230840,103218840,false,12000,0
068ae87e807e5a2f8115dd92ece8ba172c002343b37a64674f54b677262d8d94,988586,2020-09-29 02:23:52 UTC,352148230,352138230,false,10000,0
14f7e9f972da4a4b4c8cb2a8f34b2878fb68e4e7e41d432b54ccc01116d5bbef,988586,2020-09-29 02:23:52 UTC,204949979,204946100,false,3879,0
d2b8b1d2dd9e7a64b9c5a3596922dbbe0f40dbab1187b6d8a1732a25b9ece79c,988586,2020-09-29 02:23:52 UTC,999804643,999736275,false,68368,0
516ef73e597a45e7583b2f57a1140951949e56ddd9ab1c654d7f951b1d36bf10,988586,2020-09-29 02:23:52 UTC,500000000,499990000,false,10000,0
25b30b089d9761e1e7d3387295ec4c0f67594f4166c4fb1b4eb4db2587252a65,988585,2020-09-29 02:22:37 UTC,72492557,72484011,false,8546,0
e138a9cd97129fdfb096ea98477b58972082178edcf3b82c8c7a3bac77024964,988585,2020-09-29 02:22:37 UTC,84088975501,84088972811,false,2690,0
0182cfb5188fcfa19bd04df359c9a17a6c1ad3cbe42a442f9e89a369b2ec6934,988584,2020-09-29 02:21:37 UTC,1014222,1007095,false,7127,988573
020dd42f757cb1e70568b683189b81f1b97b501b570576364505b9ab0343b960,988584,2020-09-29 02:21:37 UTC,17670719,17668799,false,1920,0
34eaccb75dd57287c626a51115c1d197430cc413c90ae28cfe94e21b47f92d75,988584,2020-09-29 02:21:37 UTC,2769903195,2769894709,false,8486,988572
bc06a8321564feab4022e45b8a280b4bdb53438181456adcd5d2953ebd7a4eee,988584,2020-09-29 02:21:37 UTC,219299649,219297389,false,2260,0
f14eb1b3b9e22316c62a868c915cef84846ec179cb71dcf2fe3fe9c2e80332a8,988583,2020-09-29 02:20:31 UTC,1713002314,1712927956,false,74358,988551
3b1cface9bb9e6d5bdf5c088c420eb22e24bd832f31a07e3eeffc3cc8a181edf,988583,2020-09-29 02:20:31 UTC,132010000,132000000,false,10000,0
fc7d78f555e5d17335a4be335bd0c2188637e0b4487acce2e27bfcc549988efa,988583,2020-09-29 02:20:31 UTC,5226787003,5226783352,false,3651,0
bd3c065737b858efef1778c99a7311c6f0d512716d695b2e586aaed607a07f23,988583,2020-09-29 02:20:31 UTC,4030861,4010479,false,20382,988572
ed3e8f4dcfbb61096f606634fcf64ef7ec0faea772a70b9bc177d1f83f599959,988583,2020-09-29 02:20:31 UTC,352542785,352540335,false,2450,0
8279440732137dc0cb92f88c2630e05e7e203ce24375bb76f70eee898946d640,988582,2020-09-29 02:19:29 UTC,84683246851,84683243821,false,3030,0
b56a8e6caef75fa84a71029e9d2477d1ba5ae2472fa3e8bd4b08fc7ae720a800,988582,2020-09-29 02:19:29 UTC,26765126,26761768,false,3358,988571
060973478b03b630bb59606fb876c1dc9bf39ba29882b29be0f6b88170adb55e,988582,2020-09-29 02:19:29 UTC,202671687,202668420,false,3267,0
a7d454045d6f415361a6938a42258445294ee2f65b59583ce7f4ee792d11a3ac,988579,2020-09-29 02:16:35 UTC,100000000,99997550,false,2450,0
fe89e11c1b77d7cd0bae71b433c925d5c9c8255e77137b6d7a60f8e2e305aadb,988579,2020-09-29 02:16:35 UTC,370174797,370172261,false,2536,0
473da00cc1e557f33b862f90e9651905757c7830626115f9c11595c21ee2ba2a,988579,2020-09-29 02:16:35 UTC,497975496,497965496,false,10000,0
36d070939d8075e4b960736cc69436b1abb266173803c3a71735f451e2ee3882,988579,2020-09-29 02:16:35 UTC,5447872274,5447863312,false,8962,0
84a907a33ef82b66ac12064f3d2bf5405b80d72938a1e6213736322be8e80609,988579,2020-09-29 02:16:35 UTC,21674370,21645390,false,28980,0
d9b9be7edb34082c90017ade78600e63b4b16d695de84203dd61bb1858088220,988579,2020-09-29 02:16:35 UTC,370685857,370174797,false,511060,0
c988aa8e6c50411226f8ba986790f8249995a4d3e6bb8950c44847123c67836b,988578,2020-09-29 02:14:04 UTC,11874240995,11874239574,false,1421,0
3893536a6b638eeeb36ada5636a54030091ae91628a9fabe4582bfd911ef4575,988578,2020-09-29 02:14:04 UTC,1100000,1090000,false,10000,0
e2cec2362c6621f3b2cbba35a803eac343bbcf9bbb281420fd6a5b7d873efeca,988577,2020-09-29 02:13:47 UTC,1777861,1774121,false,3740,0
75f5698d3e1d8ea317eee3be4cdcc9aeb63a8941d20f0692167676372b5e1f3e,988577,2020-09-29 02:13:47 UTC,4908998854,4908991853,false,7001,0
5bb4c70e34630c3664333a413eb8ecbd22143fb0ab4fd58a3e3397ca586e5f3e,988577,2020-09-29 02:13:47 UTC,13296634,13284634,false,12000,0
fd9eb6f9a9c109fd365c2e0f0305f734c541b971203575e2dbe96095e105d252,988577,2020-09-29 02:13:47 UTC,206292,203332,false,2960,0
84bfc90225ceec96c44995576766f14a4eee7544fb25854e68a80c5203daf614,988577,2020-09-29 02:13:47 UTC,1559764,1556024,false,3740,0
9c9fe147c22f5cdcf5a5c85bab238aeb9359792135ffc7eca9fe45c63df6f938,988574,2020-09-29 02:11:56 UTC,4510010000,4510000000,false,10000,0
e6717925009e50d377d86093c395f2b6e45b963d8ed70c20d1d4605c03e86ba1,988574,2020-09-29 02:11:56 UTC,876048,805708,false,70340,0
abec0d87c4b7976078fcba274df0a51f2ed3ea41222ab6f5409f6b3f1521834b,988574,2020-09-29 02:11:56 UTC,424351010846,424351000916,false,9930,0
3b901a759800bbc2c6078fed9238833a2e8ee0361e2af2515bc601b095c7ad98,988573,2020-09-29 02:10:22 UTC,223685039,223650629,false,34410,0
23bb98db2496472767f6771b69d2942576c902e5dc3fa01a0d626cddb20495ce,988572,2020-09-29 02:10:14 UTC,230634792,230631525,false,3267,0
517af0b7bd7d7fab2c810f94bb881540c9d654edf4847da35f1508392dd9ad7c,988572,2020-09-29 02:10:14 UTC,1714719152,1714644742,false,74410,988561
76a7af9d516c71c13f84f9a459c48ed457c3db15cb8f5bcecdb37f45a39c4e5e,988572,2020-09-29 02:10:14 UTC,73345457,73336911,false,8546,0
740e68f2416c4c73a003234a94e0c692f99ca7c9515bc4ebb1b3be6b1c29c79b,988572,2020-09-29 02:10:14 UTC,4699041,4673720,false,25321,988561
94ade371520e3161c87161711ad6f43f37dfc68122c62eb922086fb4711f9b05,988570,2020-09-29 02:07:35 UTC,170286472519,170286468019,false,4500,0
a6613fd8d2ea4d28c49646cd589b1d9a0aae8a6c07e67afd2b727ac8ee6a66f6,988570,2020-09-29 02:07:35 UTC,132470842,132468458,false,2384,988559
ba95ce715a3e24f68a6db8daa51abaac0c402266125f69408e04cbebddad0c2b,988570,2020-09-29 02:07:35 UTC,500000000,499990000,false,10000,0
bbb8848be042e72c33ffe594f26bdf8c9219d7415394e1a229bac7d6d1ba0b3b,988569,2020-09-29 02:06:06 UTC,478876933,478808573,false,68360,0
5e1c8c088b1c0fb3d5b4a249ca24d0cd341c70f0ecd2df18d59af2dd7d896c45,988569,2020-09-29 02:06:06 UTC,205099306,205096346,false,2960,0
cff22605ea3f6b8520a058178253f3341093125fddcafcf20f5931845179dc9b,988569,2020-09-29 02:06:06 UTC,2336938991,2336928991,false,10000,0
15680ee2fb5205e8ab5df3c301d607a2cb4db673b83f2a2eec760d0f479b4074,988569,2020-09-29 02:06:06 UTC,4000148679,4000138679,false,10000,0
28b9390a57cd9635eb91f099aac92c1dff915754a2c17499ce7220cd5a8fe4a3,988569,2020-09-29 02:06:06 UTC,236939547325,236939537325,false,10000,0
97f36c60ccf684b7985fdaedf2cff92ec7331627a4f05d7dd91fa9e56369b002,988569,2020-09-29 02:06:06 UTC,2500068360,2500058360,false,10000,0
b06a94c4f6bb60eebda666c17903149bc736ebbaff59a13a49c9fd60d35f5505,988569,2020-09-29 02:06:06 UTC,2500033589,2500023589,false,10000,0
ade3d36d37f5540873c02d80466694b6804825795f71dd6793105163d86f3a13,988569,2020-09-29 02:06:06 UTC,79697570,79695140,false,2430,0
331b4921b1a260604b1debc622829a8938179d115b08d2a3dceb40b9fe77798d,988568,2020-09-29 02:03:30 UTC,160542223678,160542213678,false,10000,0
2c51480a6b95aea9deb8ed7f0d57b8f372b261f79f22682a482b5adb7b53d052,988568,2020-09-29 02:03:30 UTC,85332766494,85332764144,false,2350,0
a04c4897e54d76239a970850b6a74621d85bbd56e306d50b781fe31946ed64a6,988568,2020-09-29 02:03:30 UTC,18281239865,18281229865,false,10000,0
3d3ac61b0759ad1e890ad78a8dfea4bf1e3c7a20557b96b486809af05d3ee3cf,988568,2020-09-29 02:03:30 UTC,100000000,99997570,false,2430,0
275bfd2feb9b400fbc7c70534a0e187c023442e3b3c6d694e849926e6887c612,988568,2020-09-29 02:03:30 UTC,73389757,73381212,false,8545,0
b24474caf24648977a5b417e9c485aa40b023a6aca80c120bdf760819d55efce,988567,2020-09-29 02:01:29 UTC,1716295565,1716221233,false,74332,988556
a7a2b27348ab0644959c73ae3cb97726fbf8ec7ad4fa1674b7fa277d435b35a2,988567,2020-09-29 02:01:29 UTC,18291440275,18291430275,false,10000,0
bd4451e67b2971da957a4a93972e84109c6bbab09b035b4d024262c1a3d0a693,988567,2020-09-29 02:01:29 UTC,410010000,410000000,false,10000,0
56e0d763a3030ad8da80c5cb51703f1e0956a393db95c75a40a4cd2a46bd8669,988567,2020-09-29 02:01:29 UTC,202826820,202823860,false,2960,0
a2dbd8ff2b2b32b2de25cd8afe6e60dd37228b1f6898a7983b9dd639fd8dfb30,988567,2020-09-29 02:01:29 UTC,138648275,138645310,false,2965,988556
62d1d17eb92fb26655ead5d14d2c327ff7b2debbf69020e433f429bfe962edd7,988567,2020-09-29 02:01:29 UTC,154382254,154378999,false,3255,988556
02862a7351a3d0bf4dec5c9267705084663eacfc85ac4a947ad143ce04677d99,988567,2020-09-29 02:01:29 UTC,471951735,471949285,false,2450,0
72cc2abdc450f48d920ea014ebfd1a75364595ad3ef98c4ed703a259240c1a38,988567,2020-09-29 02:01:29 UTC,73427480,73418935,false,8545,0
855c4969c9d2000c7fd3ff6a6d2e0daee9f4b9959bbe1ccab33558241708ea4c,988567,2020-09-29 02:01:29 UTC,160542233678,160542223678,false,10000,0
bee9b3029dad81b03f62e853b38d693518d5c94e717127f309579221ee571b56,988567,2020-09-29 02:01:29 UTC,206669837,206663837,false,6000,0
811920c3f9dc34c6aab30d85aa86438bd24b5bd50f0781059a8e4faf8119437c,988567,2020-09-29 02:01:29 UTC,239509470,239409470,false,100000,0
7ea765a4501996df64f60e5b13872a93d4e301a39ff104d8a1cc49fb2027a016,988567,2020-09-29 02:01:29 UTC,5131048,5112121,false,18927,988556
d64bed738201a7e68806279fb66324cc8e4b6db8fff842d75da9a808cfd889d2,988565,2020-09-29 01:57:50 UTC,230864127,230861167,false,2960,0
0b17cb23ea56c1ee7a7fc904fb6c84f813112160870491bf3de6dded6bc46a14,988565,2020-09-29 01:57:50 UTC,4972503005,4972500745,false,2260,0
0e7d72fa82d48ddff95458e339835b52a19222bf133da178e0969eea8d96da54,988565,2020-09-29 01:57:50 UTC,306675837,306669837,false,6000,0
88965d241083f84174589bbb63d4ed22014c4ee9502560606780ffca58081f59,988565,2020-09-29 01:57:50 UTC,4999800000,4999797570,false,2430,0
c0ec9aff7d967fe002c3652d4b48a94f448d942cf181fa665d4ffe97b6cc177f,988563,2020-09-29 01:55:10 UTC,18291450275,18291440275,false,10000,0
13516a192ff3a7043024841d8099c84f8e84f0703560ae01d0cc42e07b7050cf,988563,2020-09-29 01:55:10 UTC,6826865124,6826859904,false,5220,0
5ae340142ce65335ccf7d48b76039091211b4aceed2e827eb99aa255713f22f4,988563,2020-09-29 01:55:10 UTC,73458914,73450369,false,8545,0
585709de3df010f2b12274b3e73bb2ac2d73760a48216c1401c5c27d0fdc65c9,988563,2020-09-29 01:55:10 UTC,7844992,7842899,false,2093,988552
feffcb374605085025c8140090c39d6b16497a9a4b095cc528abc22ce5615a0c,988563,2020-09-29 01:55:10 UTC,406681837,406675837,false,6000,0
409474e882fe4822fd7d28b99f044e41cb70f9ee1ed570979e30f544e47abdcd,988562,2020-09-29 01:54:09 UTC,88528892651,88528889961,false,2690,0
7079a60fe4a63471c90e6016549ce155b5b5355067af4c2c64eb7b95b3b87cd8,988561,2020-09-29 01:53:34 UTC,19078473209,19078463209,false,10000,0
2dcd3027a25f3aa5a641f13814cd521a01b412b0669972725f844ebb9d6d9a49,988561,2020-09-29 01:53:34 UTC,4541167568,4541165648,false,1920,0
76a3257b7e2766903ba66a85fe188d850fd320af6d6fd5b8445dfa4b3846a78c,988561,2020-09-29 01:53:34 UTC,394461,391194,false,3267,0
7048eaaa66e44bd78a913f6c082d740b0b7fecd5de2c0a474db021f2e38d2bee,988561,2020-09-29 01:53:34 UTC,120148242,120142242,false,6000,0
fc9e0aeb6d6e0cbdfdb0ebb9087b7c199c032bab2709a34e73c7b24990bfc25d,988561,2020-09-29 01:53:34 UTC,5172506745,5172503005,false,3740,0
d4370f1acd55666ed258024a9071411e2d788bb995373d10430bd394e8b80d10,988560,2020-09-29 01:51:08 UTC,1639010000,1639000000,false,10000,0
b7e4abfc69d717babedc825516d6bb46eef17915bee82e14f4329bfcfaaa5152,988560,2020-09-29 01:51:08 UTC,4104902216,4104897254,false,4962,0
6b9346f41f04998cd80304bf1d68093bb32c49516607f37ed4ddeda0a2d3a5dc,988559,2020-09-29 01:50:34 UTC,5504157,5483769,false,20388,988471
1ece28a8042dfa214891d2352ef8180e2fe80630326619222fb1147575df2bf0,988559,2020-09-29 01:50:34 UTC,174263177,174261084,false,2093,988547
d36b64f7c308d187e51e761c5d0594c4563f0ece3369c20f91e3a00d843f18ef,988559,2020-09-29 01:50:34 UTC,4741169828,4741167568,false,2260,0
bc2e6fcb3e127c59ff10bee8933379f310a6a42e8055937a413a6e91b2674deb,988559,2020-09-29 01:50:34 UTC,1718066242,1717991858,false,74384,988548
8bf749364fb9684e9544eedcd3cdd803fe511b77d827e143c7fe97e54ff9cdf3,988557,2020-09-29 01:49:27 UTC,205316957,205313690,false,3267,0
3d66e6f4d19dcdce4d3a3a204ba9e3cb8804b787b483a17ce0cd3753fc3e8038,988557,2020-09-29 01:49:27 UTC,872531755641,872531753257,false,2384,988546
ad0a4bf62d6007701a0b31988b94bf3f51d86262200544c14d9c06a981a77909,988557,2020-09-29 01:49:27 UTC,365723934,365643934,false,80000,0
a0d65b7543e8be54e327c1d7a8ba864f69d34a7e126ba555136926e1404a19a6,988553,2020-09-29 01:44:47 UTC,4841173568,4841169828,false,3740,0
ef04db66f996f56489ae6ad2856a96276a69c98cf0ba74b080cabd5dff2681a8,988552,2020-09-29 01:43:30 UTC,88903441355,88903439005,false,2350,0
72cbe4c92022ff7d29235399d7f76a146d8c2c945b9c28f665d7f82136a8e630,988551,2020-09-29 01:42:32 UTC,92786795300,92786792950,false,2350,0
392b87084d39d88deb8a2c2c887e5723b38b40643131579ce90efd63e78a37b7,988551,2020-09-29 01:42:32 UTC,258355379,258353119,false,2260,0
38597db9404bde31837efd7df2d3e22d82c0f5874dc8bd7a7d29f13fb232fc63,988551,2020-09-29 01:42:32 UTC,231094783,231091823,false,2960,0
e7ece75347c3dad36e9f9d98dbee4291c6e0e0c14d61292d4ee4d531554bf816,988551,2020-09-29 01:42:32 UTC,202973432,202970472,false,2960,0
0cffb2f40771bffe537627d5b8ccc00080e7f27e2ad7525d2b16d6326e60a817,988551,2020-09-29 01:42:32 UTC,499990000,499980000,false,10000,0
f58acd08133bda8f1e0f9e21d188ef0c58133840fb169f430e58841e533e22aa,988551,2020-09-29 01:42:32 UTC,1719695971,1719621639,false,74332,988540
37eabf4a816f55285c3871fb2ada8c4c2ef17f0eee22cc1b409a22db0f7dafc6,988551,2020-09-29 01:42:32 UTC,6013782,5993727,false,20055,988473
f483e8148f8cd7c3d28f07eab6cec6a9550239cb98b94501ac6f99c5fa6ef10e,988549,2020-09-29 01:39:42 UTC,872786513168,872786511084,false,2084,988538
5bb76fb1bc8f85b1e854f06673fa545bec39cc5a393d3ae6eca48bffb236813b,988549,2020-09-29 01:39:42 UTC,2820393798,2820390058,false,3740,0
2cf11501a65fff205e40f86d4f4e662b7dc7261644b990294cc37da341a3c8db,988549,2020-09-29 01:39:42 UTC,3038700000,3038600000,false,100000,0
109d09921b20b8a4e54fc07c0db6ad0ae0efa22e4c2a03b3b2f42e0df2baa6f5,988549,2020-09-29 01:39:42 UTC,1000114326,1000104326,false,10000,0
2c3981a583c41cbc74c49efa433664eaab44f6e9ca1f1a319d040bf6b5754301,988549,2020-09-29 01:39:42 UTC,399000000,398998854,false,1146,0
809c063ce97d1832cd7f466a85e6c6a538f9a963f54ae8bc01b0f3ab5d10ffb7,988549,2020-09-29 01:39:42 UTC,500000000,499990000,false,10000,0
fe91373b0abdfe87174e3e9d01963314ff65bb855d53893c258e4e8059c2acda,988549,2020-09-29 01:39:42 UTC,80000000,79999000,false,1000,0
7a8cd0b2a35627039b61864155dfdfb5a76ed201be477b665db3b66287e39e7d,988549,2020-09-29 01:39:42 UTC,250,,false,250,0
cdce77cc1b22f084fe196213cf8e90105248add292ccf616514d8edfe06c5369,988549,2020-09-29 01:39:42 UTC,1451527697,1451520775,false,6922,0
eef0e0a692b0e702a24617f0bc4fd8124316269dd7fa891956a4c3def66e00e9,988548,2020-09-29 01:37:09 UTC,4700000000,4699997916,false,2084,988530
8da7f23484a4c833f0622d5f465314ca9e117d7f302254cfeca0df3a5a7938bd,988548,2020-09-29 01:37:09 UTC,4551641018,4551637660,false,3358,988530
6d63ec8954811158251642ebeafa4e9fe7818b651d161eddee6281bc1ecec34d,988548,2020-09-29 01:37:09 UTC,3799900000,3799897907,false,2093,988530
dde4a9276a9e440b1b31218d306232ab2b8181521a24211c76efc8731c0840ab,988548,2020-09-29 01:37:09 UTC,51522,41522,false,10000,0
c73c8ab52cefa0977f38cf01817b6b9c4b91b6e021b4cd45e45ea8ce62911096,988546,2020-09-29 01:36:26 UTC,55698166929,55698151349,false,15580,0
e69a8a2b0e2a14348067dd84a03a3cff53056c53d6553b6b6c72a039fd8cfd1d,988544,2020-09-29 01:35:58 UTC,386551595,386539595,false,12000,0
cba0cee1bc95bc3e6a4437fa2488dbb884fc1f524e876e40a926ee2346542a06,988541,2020-09-29 01:34:54 UTC,544348,541388,false,2960,0
f0b54604fefc2be6af3375af0ebc7a6b97d112e936c132f454097e566f589450,988541,2020-09-29 01:34:54 UTC,1002589852,1002588852,false,1000,0
d05f363677e246a4c2aba0e3d1c17108d0189566078d663d5ff6d512395ef173,988540,2020-09-29 01:33:44 UTC,200000000,199998854,false,1146,0
e70b08e555e3b340b0e1bf7f2093b0501ae07b1d39c43d836dec21261f7644ad,988539,2020-09-29 01:33:15 UTC,73493831,73485286,false,8545,0
6b31f8c238d3a92fbcdad50683b89c94693342d88c88b8abedecb0bc436c359a,988538,2020-09-29 01:33:07 UTC,399997740,399987740,false,10000,0
3a22042b81c029aaebd119bffd8c8e25e0e25d327f60236d5bb3fcfba13cb7f3,988536,2020-09-29 01:31:24 UTC,205542340,205539380,false,2960,0
8b8975688dfa2933b58409d6220c60d0687a632a03acd144edfd335b419daa2d,988535,2020-09-29 01:30:53 UTC,203290076,203287116,false,2960,0
50204e259d6d539be369958c82aad09945e364708322699a336918489af91db6,988535,2020-09-29 01:30:53 UTC,1721320197,1721245847,false,74350,988524
92212418d417fca2682c48574183753a16241e216e2140ff3d9e9fa1dc9540da,988535,2020-09-29 01:30:53 UTC,73761753,73753208,false,8545,0
0b300447a99ab86f53ceab1e58dc75a6cb4232b33de314704ba137fc5f3de8cc,988535,2020-09-29 01:30:53 UTC,900000,890000,false,10000,0
7d9bcda34fa3fcc8d47c8733fa0d1142283874d21926fe748716d11b4e3640b0,988535,2020-09-29 01:30:53 UTC,338315307,338246947,false,68360,0
17f78a8027cb6e93645e97c896d7fca2a39ca8ab1baa51a0f8c1a0cd1a5c8067,988535,2020-09-29 01:30:53 UTC,100789314,100699314,false,90000,0
eda919935b8da2deb818477f3254df9fee21170fd78fe2f5a468bf197a3c7df7,988535,2020-09-29 01:30:53 UTC,3000174,2900174,false,100000,0
019739cbbff474924a3164b56c35fa7c74824fac24a080b90fdf618b9c79576f,988535,2020-09-29 01:30:53 UTC,6409682,6392481,false,17201,988479
8b91afb9a13d7f57a140471083df87bb46146e1087c04f633cd0ced1a3245328,988530,2020-09-29 01:25:37 UTC,518010768,518008675,false,2093,988518
ad15891fbe3233e132b05bbfa54f0a15005aed31c18dbfe7a2946a0cda2c2b2e,988529,2020-09-29 01:25:26 UTC,117621000,117618740,false,2260,0
aa9d63f4bcea0ff87be7721de0e68cdaf75c80225fd1298272f7271534d2289b,988529,2020-09-29 01:25:26 UTC,231400892,231397932,false,2960,0
35cd0e658b6a527c20cbaab434dcb8740513ecc05fbe08cc5d7f3c989fbfe2c7,988529,2020-09-29 01:25:26 UTC,499998464,499988464,false,10000,0
56574be2864bb5581526316a35b64f5408a730bf8ce382363371b91284e0306c,988528,2020-09-29 01:23:58 UTC,132200,118440,false,13760,0
6c9779a5e5f5e86e8706725efbbe64592c31bb53262203d8955f28e2bbc1bdd3,988528,2020-09-29 01:23:58 UTC,94317138463,94317135773,false,2690,0
0aa9ef5707b459725fb76bac9ea176c42cfae31a625ad72ab836d1c932445d6d,988528,2020-09-29 01:23:58 UTC,698597495,698594095,false,3400,0
99b69232cf1668a8afe5becffe3d5ba5d33abf17a6bdf9f80d1d8f5b6bb3a940,988528,2020-09-29 01:23:58 UTC,73793011,73784466,false,8545,0
9df83fd15d691b4d9ba8f5fd81cc7d653d024a46ecec73e1009bfa967dbd1c07,988527,2020-09-29 01:21:34 UTC,1722721358,1722646957,false,74401,988515
aa2208cab10d10d1d15976e965e85f1df09445ff90dd2a87102d00e02e7d5b5a,988527,2020-09-29 01:21:34 UTC,686296,683336,false,2960,0
dd0268b8a035647c44d474a2bae49a51e01b9173630430c624af96d3e0b697d1,988527,2020-09-29 01:21:34 UTC,74123310,74114765,false,8545,0
399ead2ecdd7d40905d37dbc04a44b66a2a72c83d401d03a62ef82b21f3881be,988527,2020-09-29 01:21:34 UTC,154827329,154785147,false,42182,0
e35c834c004c3e8df2d8136baaa005c6ee02e1c5779b0c78e47e93c1f68e6219,988527,2020-09-29 01:21:34 UTC,581927969,581912016,false,15953,988516
7c4ca35f201ede863ad66cf8c3ee0ac74ee3c466a9899ad062364aa4567978ca,988527,2020-09-29 01:21:34 UTC,15523495,15518881,false,4614,988429
149895342d3ea886c913db7d152fa2fe64a7f533b9a1191f1bc31b14695f926e,988527,2020-09-29 01:21:34 UTC,6813093,6795892,false,17201,988515
89d38b1905170a4335e1c1fe6365ab53921417cf61c6dd7d47abc1cdf8abd5f5,988525,2020-09-29 01:19:45 UTC,888486015235,888486013168,false,2067,988513
7cdf90de7e1820b53b0e84b76647ce17c780fcf8f224c3346a8b6693c5f62f0d,988524,2020-09-29 01:18:47 UTC,4176005316,4176003288,false,2028,0
050d22565ce76e02ec3da6589caa612a7ecf274c51f3bde8081a70fd3aca8413,988524,2020-09-29 01:18:47 UTC,23448,20998,false,2450,0
55774fa02f9cedb4aefa96acb5e80a15063d485127621184f902006f8771930e,988524,2020-09-29 01:18:47 UTC,18578503209,18578493209,false,10000,0
30d2e26418a2ab1d27c91cc57c14a0c67984678f39a0363d7ced1632ba565c95,988524,2020-09-29 01:18:47 UTC,12800511119,12800507770,false,3349,988512
9bcf0eeb2ae75549180a27e423098a0a11b3f79f3ec243ed0fc8768d63a12b15,988524,2020-09-29 01:18:47 UTC,118270127,118266387,false,3740,0
270e66eda1a1dfc9a870fdd006d1f11c715aa740cc4927896edffdc6b975867c,988524,2020-09-29 01:18:47 UTC,209287717,209285633,false,2084,988433
f3df908ab9eeae3bf8f02a8d977283585295632c0f05713dd2f50388992a527d,988524,2020-09-29 01:18:47 UTC,362133296,362125944,false,7352,0
80ef7511e51c815997a3dd31a5609d2bccd0ba40682d638b9dddeca8fcb9f100,988523,2020-09-29 01:15:22 UTC,614985450,614983357,false,2093,988511
557576931134416d1145fd01fec997ab4924413572c00b6e521e8f65ffbc1936,988523,2020-09-29 01:15:22 UTC,205718778,205715818,false,2960,0
67ef4711c8e6d128b683f4379fb77b4477a01550659f870217f9eaca3b37a6a3,988522,2020-09-29 01:14:46 UTC,18876814468,18876811119,false,3349,988511
5181cc90a290b81c096b0263cdb118f46908e29b9a2b5fc38c4eba85e25baf1d,988522,2020-09-29 01:14:46 UTC,10000,,false,10000,0
dae7be4e7255be1b58ed2174eda38f4354e505350fe5ccc8e23f3716ef9edb63,988522,2020-09-29 01:14:46 UTC,100000000,99997550,false,2450,0
8abaea990f6fdcb7fa39d6ebb928fc10ee4b595a9725bd3fa8340fc3b1c2fd89,988521,2020-09-29 01:13:35 UTC,500198293,500188293,false,10000,0
a8dad2847dbfef8840340aa49dea35adf91325795d467d158c57a67b27e6d00a,988521,2020-09-29 01:13:35 UTC,497871351,497861351,false,10000,0
013191ca148e7f831370204d66140be57fa3e0f01d59178a334b4fd8a67140c4,988521,2020-09-29 01:13:35 UTC,3538656644,3538654194,false,2450,0
65823444aa1f9b5f630c70c87057d70ac47be84ff46fb4182ddb5080edbbac0f,988521,2020-09-29 01:13:35 UTC,894624388458,894624386382,false,2076,988510
e57a842207e3ca8ef2a2553d9fec636b3fd2fc4ae66de150587497971aae8ac3,988521,2020-09-29 01:13:35 UTC,74231063,74222518,false,8545,0
900c324404fe973abee57d0949e81e6c3db327e4a95f5f79ea75304af87e6da9,988521,2020-09-29 01:13:35 UTC,8107208771,8107205422,false,3349,988509
780225cf310fa5edb0fcf635a8dfde6c0b4e10ad32ce0f7a91583a9555c72226,988521,2020-09-29 01:13:35 UTC,27075250378,27075238003,false,12375,0
9f312c59dba286670d7dd9bd878098d3458c765d1602fb203c9a69e4b85f64f9,988521,2020-09-29 01:13:35 UTC,201076121,201066121,false,10000,0
bed142a25658a152838f01bcbc78090e2bf824880d854fe4477639c87668ad4e,988521,2020-09-29 01:13:35 UTC,214968079,214965405,false,2674,988510
d424fd88d6191ffe8c80e7cf6777e08d75688fb71b68ca5059f5c9b038bbbb52,988521,2020-09-29 01:13:35 UTC,499993400,499983400,false,10000,0
04d9ce6a95fe1d16986777c08c931360752347d3e8c72ffb61cc17c411bb2008,988521,2020-09-29 01:13:35 UTC,203632073,203628500,false,3573,0
c5b4f3d0f87c1c06a1ac514569a93b4c54230a8721aa8efd068e3c595133019c,988520,2020-09-29 01:10:56 UTC,204441,177361,false,27080,0
58ec5dc7e297c0dca56e2c653f435a9316df1ec726bfa57dcaf8605e8d1f3083,988520,2020-09-29 01:10:56 UTC,904623890551,904623888458,false,2093,988507
b2f58d554572c9e177e8d9b0568f6609755e834c25c25ae88423d175664b69b5,988520,2020-09-29 01:10:56 UTC,225162294,225093934,false,68360,0
7035ee5d1e2d5cdb92a3d628212f29004f5e1ab055d184537f1bb9a15c076aa6,988519,2020-09-29 01:10:26 UTC,7263159,7243113,false,20046,988507
ac09edd51a6b0e561ccb5f3ef1a23393854d5d633a89af2f0da5217cd3c4d691,988519,2020-09-29 01:10:26 UTC,1724304217,1724229850,false,74367,988507
271656907cc5f051f5981d9c079e35fdc808201f2789a2dd988ad514f7de1f89,988517,2020-09-29 01:09:05 UTC,231584621,231581661,false,2960,0
af0a1112dafd8748941e6a046f6a3de99fd68eab054da5f33ad6fb30a6411627,988517,2020-09-29 01:09:05 UTC,1000008543,999998543,false,10000,0
23e1a8719f26fdc62de55ec709fba2c040d0d3f0431e3eea92fefbb9be08d4c0,988513,2020-09-29 01:07:07 UTC,500003400,499993400,false,10000,0
a4e3ebfa790a7cf3f887ec9609d9da387ea014ba44a590f74a36c639d3f939de,988513,2020-09-29 01:07:07 UTC,914623392627,914623390551,false,2076,988502
0c4665e2f9d8f34c92685ee75f86d2081b41859baab4600d15d15b5daa4adb55,988513,2020-09-29 01:07:07 UTC,241558719,241556635,false,2084,988502
af972634d83970e7e915a59de114928cb4f56b5103a59ad6913fe3eae3f9cd82,988513,2020-09-29 01:07:07 UTC,380887921,380868241,false,19680,0
18e181b9c60b91240ce556f3edc057112751f6c59fef4380e760dbd69fb18885,988513,2020-09-29 01:07:07 UTC,937153,934193,false,2960,0
52afc6cc7a9bff90afdd9a2b20aaf00ad6954d0d61a558d5450e6e257691af8f,988513,2020-09-29 01:07:07 UTC,500023864,500013864,false,10000,0
6385afff097a5d4205295a9f529ccd81beff39bbf9529ed90ccaa9fa9404d260,988513,2020-09-29 01:07:07 UTC,74521416,74512871,false,8545,0
18844c642d52ae5c69d0dca57824d47d03fbe0dbbf1b274907ab15476df60b1e,988513,2020-09-29 01:07:07 UTC,201700,184980,false,16720,0
3e6ad3c134fb9b7cc8944b349c56ecf810952136b947b3cc7cdafd6923d23679,988512,2020-09-29 01:04:58 UTC,2500043589,2500033589,false,10000,0
ece9d22b5a993e8da5c52161411f38a63c592bd9868381d231d759d5cf0f9824,988512,2020-09-29 01:04:58 UTC,236786132980,236786122980,false,10000,0
1c7c27ef549305c4c1b64b32578790690d0ca8f51710ef91bc22a4f76ea9da16,988512,2020-09-29 01:04:58 UTC,1500003724,1499993724,false,10000,0
bd15cbbcca0ad4e3f8e2960fd48cc03f37f55a36057646c98e560fde5ec1e07c,988511,2020-09-29 01:03:56 UTC,100000000,99997550,false,2450,0
3746f8a734dda5cb3b57c819de84ff436e041931919fda1962d23991da6fa235,988511,2020-09-29 01:03:56 UTC,500013400,500003400,false,10000,0
50189ea1bf50b99c5bf628e1b0fbb485d01a7e28ad05a007925ef8a16c2e62e5,988511,2020-09-29 01:03:56 UTC,12187300,12183951,false,3349,988500
98b7a89c76c59da579a17052846f1e59c64784841a1b5efbcca04dbb8c6c157f,988511,2020-09-29 01:03:56 UTC,10001003690,10000903690,false,100000,0
a2fb00bf6316d4f11ea1b27da2a0725cb18fad797f52c0617a57f11149b15407,988511,2020-09-29 01:03:56 UTC,72360177,72350177,false,10000,0
325393b84192d51b2e60267f0a9c54bb904228d93044d990ac69e1110565121a,988511,2020-09-29 01:03:56 UTC,204093449,204090202,false,3247,988500
9633387773560c9791ee50a5ee06b68dd5847d1048854a0b3082639152dd5762,988511,2020-09-29 01:03:56 UTC,5196340,5178436,false,17904,0
ba5e3777f154f52fbc7de55978df4150380312817820d6dd9598e5e363de5104,988511,2020-09-29 01:03:56 UTC,262037641,262035548,false,2093,988500
e1c7cf2831096b9b3e26605695e14436eb624edec0418fb2d25693dad10d06ce,988511,2020-09-29 01:03:56 UTC,45844976,45842526,false,2450,0
f82def1007cf0fea7a1b4ed33e89f40ea74246c9a87ee586c2cc0e23aced94bc,988511,2020-09-29 01:03:56 UTC,74720763,74712218,false,8545,0
a0df5399d4c764c773907dc9117a6725266c1d62eb9941f42d21aaf49a400e00,988511,2020-09-29 01:03:56 UTC,843449993,843439581,false,10412,0
deb2fa3d8f86c1a9153f2089e1ba0504271538789b56e0cf9ca33af08418b059,988511,2020-09-29 01:03:56 UTC,7849165,7828188,false,20977,988500
43b41d065556d8da0c17f829b5028f26848ef72552a0d9e63e503d3288a60229,988511,2020-09-29 01:03:56 UTC,24811401,24808043,false,3358,988500
2288525c2a62e566c70e2c2d1a5442c01a25206e43d3e216df9cd083f07bbedb,988511,2020-09-29 01:03:56 UTC,927422894720,927422892627,false,2093,988500
550e514ebd1635b30f9eb878de87fae88e1d4160bd2c3ce22350b4b0741e5054,988511,2020-09-29 01:03:56 UTC,1989595495815,1989595493722,false,2093,988500
a5599a6917efac24f3746546c342e966da6bae17ba1804270697197db7c933c4,988511,2020-09-29 01:03:56 UTC,1727173765,1727099330,false,74435,988500
ab229c2e975f9cfe513eb13060e4457737d977d23235879e6b163499ab7fb31c,988511,2020-09-29 01:03:56 UTC,3422,152,false,3270,0
75a32f6b97bd70b8c4c03616de746539049bd9056fa7b1fce3c838aab603fc77,988511,2020-09-29 01:03:56 UTC,673000000,672997907,false,2093,988500
b92b41f2498b34c56096ffc59415bef11510e3c5dfdf776e023d950876a55008,988510,2020-09-29 00:59:34 UTC,1455987543,1455985450,false,2093,988452
01d952ccbe47f6572690a0facb90ed029d2b76a23fc72f2264647db6728f903a,988510,2020-09-29 00:59:34 UTC,205872474,205869514,false,2960,0
b1d8c6ad2325e80bb392da88f77580afe82d37624952252ee9bca7e670b8686c,988510,2020-09-29 00:59:34 UTC,1076098197095,1076098194720,false,2375,988498
f0890a2de9484422f6b4bf1d927060199197548ad51a22aa6454db040fa88eb3,988510,2020-09-29 00:59:34 UTC,131626220,131621000,false,5220,0
f54f5c08ae0f08b2f0462fa08b25590e70e35d0640e704740e91cbd681449c1f,988509,2020-09-29 00:58:55 UTC,4143402190,4143397978,false,4212,0
920fae2cf8565785cb0234f19d80d1ec08e996dfbed5b49d1476e9da33edd9c1,988509,2020-09-29 00:58:55 UTC,3121225,3112843,false,8382,988498
444947f956778e5d90236318aa57be36a2eaddd7979567a9ac950ddbec005237,988509,2020-09-29 00:58:55 UTC,74932562,74924017,false,8545,0
b72fa510ebbd7316bd8cfbea8fd6b84935787e9027d46903dcc8dc224d18d8f0,988509,2020-09-29 00:58:55 UTC,12304860000,12304360000,false,500000,0
fe937b2672d5482efcbcb68585a068a96eab8407714a4e75cbafa68ae7457783,988509,2020-09-29 00:58:55 UTC,74762903,74754358,false,8545,0
2d15e685fbceb8039224d2e9fb606d18b607d35d96cc472f14e49c1a38063088,988509,2020-09-29 00:58:55 UTC,500208293,500198293,false,10000,0
8a011c74360b6bac364030faf9bc1f769541f76cf0ee0fa344cd9a42d705a4f0,988507,2020-09-29 00:53:44 UTC,1097988710034,1097988707095,false,2939,988495
e7f0421e08fd209c08308024d124bc4a35de2e10c794393c7a6afbc90e4ac56e,988507,2020-09-29 00:53:44 UTC,1007880,1005430,false,2450,0
9a25b52aa1e626835a1c947bc6ece931c472079767d04ecd36bfad1950a0e8ae,988507,2020-09-29 00:53:44 UTC,285928002,285901000,false,27002,988495
9ebfbf3b03b4630982abcc9b0c4a8aed9a20ec15e5372cb47cd4c2bb112ce06b,988507,2020-09-29 00:53:44 UTC,143500000,143420000,false,80000,0
4d11ad919df625b5fa4d18fdb42e63d63cbca553ffd4e1c9606b95a88220ae2a,988507,2020-09-29 00:53:44 UTC,32036547651,32036535276,false,12375,0
792826ebff545f56ba867c7edb485dcec1cefbc564160d6c6971263ed14883df,988507,2020-09-29 00:53:44 UTC,500218293,500208293,false,10000,0
25c594643ee9c791cb70f0fc5d01e469f1d2c51f109b92b75264e743c3a1ea44,988506,2020-09-29 00:52:25 UTC,203841860,203838593,false,3267,0
e348f7623c86e15aba4350765225de30d407375e689cc83e6db314a99de0bcdb,988506,2020-09-29 00:52:25 UTC,1177160,1174200,false,2960,0
cd6d37734c6e7d510ef8c1af0389469d4cfc3eb4dd9e2edfc529a38304888d61,988506,2020-09-29 00:52:25 UTC,2475000,2468220,false,6780,0
6f322aef1acde9a6621e3cc59c5b1cbd3e41df93432d8975b24b3208dbdcf98f,988506,2020-09-29 00:52:25 UTC,1906630344,1906626325,false,4019,0
5ccda5b707b0ac305533060ebe8844437daea34a73408c5dc7ee79296ec6a2ad,988506,2020-09-29 00:52:25 UTC,8574036,8555383,false,18653,988495
6b84595e123977b07decf62f80344ab9b1124ccaa471a0bea65515b5df1a3f24,988506,2020-09-29 00:52:25 UTC,5332671503,5332668145,false,3358,988495
85a54039dd3a11281ae8af305f09189f98fd2d4bee37b40f4b5d994ee26d3ff2,988506,2020-09-29 00:52:25 UTC,114684700,114683554,false,1146,0
9bfb95381d4dc504627c3644221e900989bbc22db44ca019a05ae37de7e28a6c,988506,2020-09-29 00:52:25 UTC,1729747015,1729672614,false,74401,988495
b756ec6abbd1c4dba049ae8c910face5b126c2b08b0e0cb89e5a6bba97dfb48e,988506,2020-09-29 00:52:25 UTC,100739956,100720276,false,19680,0
fe94245f0b4c72f6614b84bb11abc92c39af4c32e4503a7405c971788570f18e,988506,2020-09-29 00:52:25 UTC,6245018,6241660,false,3358,988405
29ab85d6bebe9676e96578e077b2e97ae15d766938e3c48783766245a5f766cb,988506,2020-09-29 00:52:25 UTC,231738926,231735966,false,2960,0
c38afea2951718d14a4b652344c6279d7959d73f71b34fe32f080529775a135b,988506,2020-09-29 00:52:25 UTC,5622430275,5622427825,false,2450,0
d2df18dc25e44b518c5f28c58a347cef7d10591de4c65dc981387ec6934c7192,988506,2020-09-29 00:52:25 UTC,75015165,75006620,false,8545,0
61b8ff66c6501993bd94b2a552e486d383301f0c76f717a1c0410efc7ab927a3,988506,2020-09-29 00:52:25 UTC,75290,65290,false,10000,0
91c88b8f08d079eb3e2a54b0b1c85513e3f60f9a139d3c67cd31ec9739018929,988505,2020-09-29 00:43:23 UTC,3129433,3126084,false,3349,988494
1f9307b2e03a73565e2eccd58cd54a6e4bd8d2f836630b206c5afef7ebdc0f21,988503,2020-09-29 00:41:05 UTC,1197967212118,1197967210034,false,2084,988492
460f665b1d6249c47761dc1d96c70747cdcb4d632e9c3936a52e65f6122ca2d9,988503,2020-09-29 00:41:05 UTC,206066885,206063925,false,2960,0
5d8c4e7c21458a2960ff905503951dd7dee6cefe161490ca788f9eb56a4b9e05,988503,2020-09-29 00:41:05 UTC,1731857396,1731782995,false,74401,988492
bfc86dc0501fe670991620c80838adac03feb17466565c42e744e0c5860e73f9,988503,2020-09-29 00:41:05 UTC,25975378933,25975376840,false,2093,988491
adfe41675360f3c5004375fe6e0773336c4b241955cae02095a71793a8da4989,988503,2020-09-29 00:41:05 UTC,1500181641,1500171641,false,10000,0
c80bca9fab70753c07cbb43a0f0d73c03374e3d5d994722dec21b20a1e629cf7,988503,2020-09-29 00:41:05 UTC,75071335,75062790,false,8545,0
47dafe2c41bbe2b0f818c55e788ad401930cdccd49ee2e23466060d211bfc360,988503,2020-09-29 00:41:05 UTC,9020328,9001965,false,18363,988492
0b8dae93dc89ee8425fd24b7c105e1b905a9091ff17a2828f8df5d40ba896406,988502,2020-09-29 00:36:38 UTC,259617268,259615184,false,2084,988491
eda8a22fe3fb22b15b089219ed6fa0f05255d38e09f5a574a6f790a80c4b9c27,988502,2020-09-29 00:36:38 UTC,262308933,262306840,false,2093,988491
7b256545794e4a07cabcd43d2f5ee73877603f795e448ffd85103d27f705479e,988502,2020-09-29 00:36:38 UTC,85449069,84532294,false,916775,988490
fe98ced6cc60759816861195b6b0072dee8ce0fb72a3fec86feb2a98b5eebbc1,988502,2020-09-29 00:36:38 UTC,1259619361,1259617268,false,2093,988491
87eddb8900796ba971770ab256010e03faecc42175b6590f720414fc827a869e,988502,2020-09-29 00:36:38 UTC,2038054476,2038050452,false,4024,0
b7d4c6f1a27f26d3361954cc05076bf3f66c4c95a6da176a1da2d7c2832f20f7,988501,2020-09-29 00:35:09 UTC,2000045300,2000042850,false,2450,0
4f5981af879bcbc300c1a8adaeeeab5c1ac6faaf88f39e4852578d5226bb59ac,988501,2020-09-29 00:35:09 UTC,204008636,204005676,false,2960,0
cb3c73eb5dfe5d5a73c3c6131e5e08ad188dd27289ef97e5bb52022a3f68645c,988501,2020-09-29 00:35:09 UTC,1058839645,1058759645,false,80000,0
2dbd63a5fa9393a9954371da308b5f9b8cd9532dd2f2b900d5554cad37e61d47,988500,2020-09-29 00:34:16 UTC,1416533,1413573,false,2960,0
c75fc41afcb9d6299d6f142cc9dfe92931d71854ba5e17194d77deaf12d09cf6,988500,2020-09-29 00:34:16 UTC,31230609,31220609,false,10000,0
c60343cc74bed5e864d356b95c9052098fabede40cac50fc4bf0f3397b3a533e,988495,2020-09-29 00:32:02 UTC,2294653632,2294651539,false,2093,988484
57373c187bb4a2a9d7c1df31682e0e7c8d27d5dad8f89bb7996fad391fd5b974,988495,2020-09-29 00:32:02 UTC,203916,161916,false,42000,0
e1e11e983962141524fc440a6385b81b006656ccfee821770fe602cf67052b23,988495,2020-09-29 00:32:02 UTC,9370835,9357428,false,13407,988483
abc038bb7741e7d9b618ccde6680f1b2a13126cc25e6399d15c617a68e6b29fc,988495,2020-09-29 00:32:02 UTC,1733806217,1733731867,false,74350,988483
1d6e1dd205ba1c96a7350044c16ccc382d0cafc4fd8466049d92e19c9bc68387,988495,2020-09-29 00:32:02 UTC,75129499,75120954,false,8545,0
5c5f6fbc3e2068b721993b0a5e7f843906804ba9046805497f16c56b36d5644a,988493,2020-09-29 00:29:22 UTC,18317672502,18317662502,false,10000,0
c8f9007011593f177404b69fca109a9b000d8743514715f5e5a92186fd32d940,988493,2020-09-29 00:29:22 UTC,231953482,231950215,false,3267,0
a461aaa4aebceb514a400737b0d4a9b534cb4000939e92e18d22d4a2474969b8,988492,2020-09-29 00:28:28 UTC,341086121,341076121,false,10000,0
08d9c25de16a9f152c010aba6bfad5beaf76ec50f4c0d095946f66be4cc55b6a,988492,2020-09-29 00:28:28 UTC,499980000,499970000,false,10000,0
b42a6d8e768f004d25eab59834ff7918d58a3e4127a993520080be7c93ab4bbb,988492,2020-09-29 00:28:28 UTC,84249229,84246779,false,2450,0
0f619854b7161ff5b6116700caeeb7cd3e5bec82111922c5382d23ac0c093e8c,988491,2020-09-29 00:26:36 UTC,153794840568,153794836883,false,3685,0
c32a7ade85efea74d65c2fc1d63efa266606c6a3b242b51ae6a39ea2ad0ebf85,988490,2020-09-29 00:26:26 UTC,1269392,1230472,false,38920,0
cc659e7dda7231d382ec84ed13fb9e0285678ce40a8effe6dc5087a6aa6b4a6e,988489,2020-09-29 00:25:44 UTC,10000,,false,10000,0
84b1af474824b6c6893ece4a473b96ac3466edd34a885f781fc134882b43f022,988488,2020-09-29 00:25:38 UTC,72382395648,72382231742,false,163906,0
8c93b9881a49b15590284d21e38a6e5842911f8544c0a9cca50026287f31a872,988488,2020-09-29 00:25:38 UTC,100000000,99997550,false,2450,0
a39210d746f8ff278f7ab2a36aa6af1e2316420728b57e17fb1f9b68fce84150,988487,2020-09-29 00:25:11 UTC,206317549,206313670,false,3879,0
ec94d718848a5d0e3bb1f21660a81939173a92de40fa85737ed1bc471738bdc5,988487,2020-09-29 00:25:11 UTC,305000,302550,false,2450,0
0a2ec8c5cd39b23a7c8b41fc60c0ea7c672d2460ef888b1da268d4666f652e8a,988486,2020-09-29 00:23:39 UTC,139104621,139064304,false,40317,0
ce861aea48fbce408d853e2a51f6702897893b8283590e4e5ba81d68b9b03f34,988485,2020-09-29 00:23:35 UTC,9715862,9700704,false,15158,988474
67b08c39a5b1b86a6e2b54ff60a61af21a59f4546c501ad703271fd879763b2b,988485,2020-09-29 00:23:35 UTC,500008545,499998545,false,10000,0
5d89bc2278a83ec6089c800cef7e73caf5b0d456f044a543b5aecd7e3347e6c0,988485,2020-09-29 00:23:35 UTC,75158180,75149635,false,8545,0
30aa101cc115e275d27741d1ef9131185ed8b0e40b949865eabe2bc5f3be51a8,988485,2020-09-29 00:23:35 UTC,1736227983,1736153616,false,74367,988474
c85de42a8139e2bc25f28d5884e244e524fe6c8687d139197c484e5d326ad7d3,988485,2020-09-29 00:23:35 UTC,4549467188602,4549467176692,false,11910,0
870dcd8d2f8768ca8a9178892349ed428d7118f54f94821a320d41cdaeb60384,988485,2020-09-29 00:23:35 UTC,2539330955,2539328505,false,2450,0
a2bc04e11815a2ed9a179610fcc11e19c13473a7d3e1dcdde64b1289dadbd260,988485,2020-09-29 00:23:35 UTC,499990495,499980495,false,10000,0
d3c306bc9ae47380dc72d39d4535a6b499cf76ab0f223c0a693def2b1f6b1e1c,988485,2020-09-29 00:23:35 UTC,1309981,1305376,false,4605,988474
4bd77147ea5a6b8a4087393b3a335e286c3406d4a67b92a385d43e4d6af3597e,988485,2020-09-29 00:23:35 UTC,26044029351,26044013771,false,15580,0
24533e53e4aa2290dbd6b1a48dfa9ec07721ac02be94a539116aad60e1225452,988481,2020-09-29 00:18:04 UTC,1264657694,1264648329,false,9365,988470
4520522f310bb24725b934dd5cdc60429af3762e2422408d4ed29d0c91193003,988481,2020-09-29 00:18:04 UTC,46021906071,46021893696,false,12375,0
f633bd32e0698871173456ffa226bed79c8be1a22d0f9a82fd3b5070a12efe29,988481,2020-09-29 00:18:04 UTC,776822895,776742895,false,80000,0
c0c5ec26ecdbbabf14f5d08106ccbb644cc8b5d9ac77427f7b31edc1a077cdcd,988481,2020-09-29 00:18:04 UTC,1348203302,1348201209,false,2093,988470
8b67921749503a204e572bbd36db0f70ed5b60f7634fbd6aff088cfcbd83a1f3,988481,2020-09-29 00:18:04 UTC,1208766714194,1208766712118,false,2076,988470
eaa7db0d94c55eacda3232f0580aac2e440a85f890f978ed732a879e1625266b,988480,2020-09-29 00:15:39 UTC,204150234,204147274,false,2960,0
4751807e46b2e150b8775c0121105ecbdd4950f35bab68980c34e22b8e461356,988480,2020-09-29 00:15:39 UTC,499990000,499980000,false,10000,0
5e75e13966d0cf54b4c9ce88f128a659e9bccf4f6645ba97d0a8ef8298c47934,988480,2020-09-29 00:15:39 UTC,7984228559,7984224819,false,3740,0
ba1596cecd56e04c9d768e0632cdf95db89a1ffbe5926ef669d71b86c3567dcd,988479,2020-09-29 00:13:54 UTC,501013487,501000080,false,13407,988468
fec05ef08cf0ed97a3c4f6168eec516418080b05e3b798ec766ef127e6b37ef0,988479,2020-09-29 00:13:54 UTC,95824495300,95824492950,false,2350,0
01b410986796f6e07c7c5ae6ec6146561db3a11988db22e03e7c4b5002c01feb,988479,2020-09-29 00:13:54 UTC,500000000,499990000,false,10000,0
d2e9f3eb61dc20caf5e30e184c9da3c614dd79fa45f636661cd017f996a18d9c,988479,2020-09-29 00:13:54 UTC,10257583006,10257580913,false,2093,988468
591a2ea2265fb71e397a6b57739b161645def87a1747fcc3e48829fb4544e5d9,988479,2020-09-29 00:13:54 UTC,75209491,75200946,false,8545,0
e69aee7ca443f833829aae14837e0013866cac6b7b408f462f71455d8dde8074,988479,2020-09-29 00:13:54 UTC,504964994,504954994,false,10000,0
aaf8cb628364d1d893e00152b7785b12cb76ce375fdae867abdf02938bbfb975,988478,2020-09-29 00:11:01 UTC,1738158579,1738084178,false,74401,988466
0bae83e9a42f80c4a02bef65ab32b55f1af693bb9af243fa382c347cadd57130,988478,2020-09-29 00:11:01 UTC,10385757,10368001,false,17756,988466
22abd73fa50d9ac35336302f44e7ba80473f1f734554d9625f2c0d679c1ad05c,988477,2020-09-29 00:09:57 UTC,500000000,499990000,false,10000,0
f35ea9d7201f10d762e6d472bc334791a1655ad2c6a4b64619a4cc878140bc51,988477,2020-09-29 00:09:57 UTC,1593939,1590979,false,2960,0
db48b17d6198c78b7ac2ff6c9ba5696510da17ce98e8523f33bd9a7b7487da9a,988476,2020-09-29 00:08:18 UTC,1279499810,1279497360,false,2450,0
cbf8ff1463df80ea6f642da71411634a9adb1f232ccf45f11744e40cf13be059,988476,2020-09-29 00:08:18 UTC,500000000,499990000,false,10000,0
93f3f68750fbdd681b3d464192b420bc5a0fb6fbfe6d5777af6b3371022a8965,988476,2020-09-29 00:08:18 UTC,75703477,75694932,false,8545,0
eb03064854c46daa7ca4d9da45464e3579d521366d4974f31b9f563c7fca6e89,988476,2020-09-29 00:08:18 UTC,13501581455,13501571455,false,10000,0
ed6e673d1106c53f3ef8a22bfe0775699539487afb361bcd13f75f4e6e31a3a1,988476,2020-09-29 00:08:18 UTC,87164,81164,false,6000,0
3a11bbfc39e3a80087b6aa814b9a7aafc6b5a360eb5db4d96e51070a52645fe6,988476,2020-09-29 00:08:18 UTC,2500041151,2500031151,false,10000,0
458dc89b469eb1087af7c63f5fb529fa3ef8a7f2df06542eadb72bb987e0573c,988476,2020-09-29 00:08:18 UTC,75304534,75295989,false,8545,0
0393efdc0c639a174f4770e505d274033213b7537659fdf5263ebd8991956cef,988475,2020-09-29 00:06:43 UTC,76083073,76074528,false,8545,0
c85b89501d087dabf32499a0c520d73d57cbaae3e8f56bd9e3b0a703f5ba68ce,988475,2020-09-29 00:06:43 UTC,10174634335,10174604335,false,30000,0
3983dc40cfe6a38ac0febf90079889c5d4f846231629dc48b2860d1c56a4d5e8,988475,2020-09-29 00:06:43 UTC,1018545,1016452,false,2093,988464
9a04f55bdc11a3fa1513f7e997dbf4bcfd5c506c919d00b19be76a9cc49cedaa,988474,2020-09-29 00:05:40 UTC,284034027,284031934,false,2093,988462
f633127b9623c1314d35a8b6473f6e07635c09d9ab7186711fd6c28cc25eb6d6,988472,2020-09-29 00:05:21 UTC,121183249762,121183247412,false,2350,0
2dcb649fcf1496f3328fb8d1158860170c101bdda3a31183f729652f9cc7e6f2,988471,2020-09-29 00:04:44 UTC,232002258206,232002248206,false,10000,0
6abde422bee50de726467bd4f50fff133c3854f09ba9d6a5904831a97f9fd0a5,988471,2020-09-29 00:04:44 UTC,5000153319,5000143319,false,10000,0
25ae92dccc05a5e7a992fdd453d349243f1b86aac4407cad9142f5e663e33819,988471,2020-09-29 00:04:44 UTC,1500013724,1500003724,false,10000,0
74616b832f66976bd28dfc5fe3feaae30b24875c7282c95d1a17658aa8349f08,988471,2020-09-29 00:04:44 UTC,76147763,76139218,false,8545,0
3e316287cd4fa9db0100b751120943e5ae3b39d1c463febcd5c8e0d5c4e85f98,988471,2020-09-29 00:04:44 UTC,3801618668,3801614063,false,4605,988460
19fac7a934eee7d81d5e9a8b94bb4e04875a4ab2ef6e382b917e730e49e16291,988470,2020-09-29 00:04:04 UTC,500000000,499990000,false,10000,0
59d56cd7ba0a55b4b5dc1a1648503c86abdce9d6bdc90102bbe69849536eb0b4,988467,2020-09-29 00:01:50 UTC,122949381250,122949378900,false,2350,0
44d0bc4979cbec1f81637c67f11982d0c30c4440d5de62b7b4f8e647dfa65292,988467,2020-09-29 00:01:50 UTC,245811020,245808354,false,2666,988456
f2669c3b38407e2da15c7d6c64de592f36a38adea17c424e028703b8c6f23039,988467,2020-09-29 00:01:50 UTC,71660834,71654383,false,6451,988456
2b7833cfc936286c2c9b2b656893636995a674d5125c81256ca6840559fc723d,988467,2020-09-29 00:01:50 UTC,1843,697,false,1146,0
8629ea636d0b33daf3a5db76600ec163e42ac7f874a8277dd406ca8bf0145b06,988466,2020-09-29 00:00:56 UTC,1740321539,1740247164,false,74375,988455
be53052febb77f27cc0bc43dcde4af0ba78dad8f9e82330334244d3b54f71069,988466,2020-09-29 00:00:56 UTC,9852317,9849867,false,2450,0
3a1fec4ecfbea9c8fd8bd8f4909f7435a4eda9617d9f2b8029f50387d201f3a1,988466,2020-09-29 00:00:56 UTC,76215270,76206725,false,8545,0
dbca926d340cd864d52671c503759592af80392a1404b5daad0db5ff57a7fc59,988466,2020-09-29 00:00:56 UTC,37593555,37591180,false,2375,988455
8a96ad5c0fb090bd79d2cdd252003fe709a6892c97e09dff3dc0819af143cf72,988466,2020-09-29 00:00:56 UTC,12187300,12185207,false,2093,988430
773a369071ced0fb49b01283bf530ffc9f8dbf7269fc6b156875d8890b049ea6,988466,2020-09-29 00:00:56 UTC,10782342,10766910,false,15432,988455
94ed30eff4396d6e00e278de4ce0200f4731d2cae652f737c9761af52946cc66,988466,2020-09-29 00:00:56 UTC,5403903,5395358,false,8545,0
040331a821dc2b383a77fbc707de877a81ce0e86e4dbc67ef812bd03aaee97eb,988465,2020-09-28 23:59:06 UTC,206512014,206508747,false,3267,0
14bce1d73ac4364818ed9aff7dd724f267157352a1af31d5e46b2cdb3dbb81a9,988465,2020-09-28 23:59:06 UTC,33878714133,33878702928,false,11205,0
f9589e6845b29c9f027da0737cbc0d946eddddfcb8b27a3a4f1be395fa3a7ed7,988465,2020-09-28 23:59:06 UTC,700010000,700000000,false,10000,0
957a0b22b8d3d8b15c785bad2589697698f6de35c65586ea5506fecfc216701b,988465,2020-09-28 23:59:06 UTC,53295110,53293025,false,2085,0
5f3fb37b48c206b4dc0079a393ab1864c5fa5da9d5e6ca7bc8320fa43ce4077f,988465,2020-09-28 23:59:06 UTC,143500000,143420000,false,80000,0
77293264e67fc83e42a36c8dc3a3a89032564e29b93291c8b81a68aedcdb5018,988465,2020-09-28 23:59:06 UTC,232114571,232111611,false,2960,0
6c3a606659c7c901906247c69096d2da6feb91a0d743878ade312ce8ae18f78f,988464,2020-09-28 23:53:30 UTC,18457085099,18457083006,false,2093,988433
49f40a24c12ccc36e5f3e3a165bd4e3cd09ef6720b8d0a12dd603c965af081d6,988463,2020-09-28 23:50:16 UTC,1742155763,1742081345,false,74418,988452
cf8e0712f01de7f6049e1b1b226234f766adf10940bcc9dd5158d90521831b68,988463,2020-09-28 23:50:16 UTC,1247066216278,1247066214194,false,2084,988451
f362025591165e445848be66c6b3ae0734196d4abee7f6e6fea249dbdf80da50,988463,2020-09-28 23:50:16 UTC,76263307,76254762,false,8545,0
2c7d3f6538e87c0b4d326fdb1924e16cf1db82ba03beb98c5a3d1f086410a726,988463,2020-09-28 23:50:16 UTC,11225938,11208464,false,17474,988393
36fe8fcbea86934de27ed1df53ac09b9045fdfd36ba04eae790d3bbdac899991,988460,2020-09-28 23:47:46 UTC,2018441947,2018438598,false,3349,988449
f1d4102f7c368533fd40a0390d404ec2b3fe4a21456c98192f52c69822c36d62,988460,2020-09-28 23:47:46 UTC,81291686,81281686,false,10000,0
39c15923f529b7e857fe41fa34010ec218394f54f63b850fb3f535a7845fea4e,988460,2020-09-28 23:47:46 UTC,602317466,602308146,false,9320,0
bc742859e0235285c71d0f6a111471e733eb9f990fe0ae3bb9a1f29ea9fe273d,988460,2020-09-28 23:47:46 UTC,20000000,19997570,false,2430,0
c98a7b0c3a864778dd7a01acb9d3dc9c2c25ac49337f5378c047202d5d1c8800,988460,2020-09-28 23:47:46 UTC,50444434953,50444334953,false,100000,988449
8830135ac8f6af881bf894419f8b653755e308a97f4c1855a889efb153e09ddc,988460,2020-09-28 23:47:46 UTC,1753971,1751011,false,2960,0
0c683cf1b48d7d700adbe3ae0c4398e1725eb20ecad51f5cbfb556c21b7ac4ac,988460,2020-09-28 23:47:46 UTC,1718189,1706189,false,12000,0
4b7614830a0500f29cbfdb4c05254e7210f2b7c1cc428c5bd4d103c3d5b4c6d8,988460,2020-09-28 23:47:46 UTC,636272895,636192895,false,80000,0
bab6814f2644cfbec0ce4f8efefffdddd6c96b0b2dd1854a35252203fe05e42d,988460,2020-09-28 23:47:46 UTC,76320163,76311618,false,8545,0
4e9acda4b5405be6c1f321f732dfcd17fac33f95dab9e6182a9739436f4fae4f,988460,2020-09-28 23:47:46 UTC,204306905,204303945,false,2960,0
73956e7b825d9ab4fc4809f15b5f48048ce1c981be7db44b8b9f0fa9760ef37b,988459,2020-09-28 23:40:48 UTC,11525323,11509302,false,16021,988446
8357dd0ca3efca77cfb1120311442a592694f232544b5e96e55bd9bc8888aedc,988459,2020-09-28 23:40:48 UTC,465104318,465102234,false,2084,988448
bebd9bc10039542a85e2701fde95c234f96f0d08ec084fa0d626b6be1b2bb160,988459,2020-09-28 23:40:48 UTC,1743816955,1743742537,false,74418,988360
b6edc4ba414a6c7f19fde9086ac264e8962274dee5eae2d27e624360e8316a96,988456,2020-09-28 23:38:59 UTC,2507600164,2507595489,false,4675,0
aa5f16b02a735c113e0bccd960798c88b3a2ba48b58b402c7404a6e8583f3992,988456,2020-09-28 23:38:59 UTC,206672194,206669234,false,2960,0
a003a128c959722e0b47d58b3990945395a80c8ba04ef44d5de1f5e3f3b81678,988456,2020-09-28 23:38:59 UTC,500019958,500009958,false,10000,0
30d9c1c687360e6ef1e82247199b19f8e9cc91e6d1d216e0d586de356676067c,988456,2020-09-28 23:38:59 UTC,232334565,232331605,false,2960,0
a33a76a930777f41d02c68548d16160d504bb40172ffa5171b9d920c7fa5242f,988455,2020-09-28 23:35:54 UTC,27954613192,27954611099,false,2093,988444
4cfef6ce734c38efba6705f774e65fd523cfaa62cd1d2a1901eaec78cad7c8c1,988454,2020-09-28 23:34:41 UTC,14144495680,14144490701,false,4979,0
9da9d571cc15deccd2396513073bd5fd5ee290f3b0f6ff0b56a27d1fa6315e86,988453,2020-09-28 23:34:18 UTC,21227296,21223947,false,3349,988441
7116ecdd0a5539e273d798bb6082e7711be8a698dc8c261e721a2c1ea24411ee,988452,2020-09-28 23:33:29 UTC,39554115268,39554113192,false,2076,988440
c260ba5da2b561d10ddc66f2612582870967caa07a89f21fe03cf829bc48e81d,988449,2020-09-28 23:31:10 UTC,6254978059,6254973141,false,4918,0
fde2ab07512ddf90c7584e68aa0e2558068c6c6e62e49c2a5ce756b753279fb5,988449,2020-09-28 23:31:10 UTC,76355987,76347442,false,8545,0
1c7b98467bc7b36b9ede135c54e0de01e38f6756cf7399344a01962196a5872e,988449,2020-09-28 23:31:10 UTC,204504498,204501538,false,2960,0
72e07cf28241598c47d96a2dae0c809a81f380f922398b7f6defd63fe7571f2e,988449,2020-09-28 23:31:10 UTC,12119369,12098417,false,20952,988342
5c75bc7a563df60d45f4073117fbd1991a4be8e6d87d71ce790a3062f3a4cc3c,988449,2020-09-28 23:31:10 UTC,50933064181,50933062088,false,2093,988437
7dfd7e0ac0a47ddfcef777724c831d117e8935bf6523f62006456aac7368b512,988449,2020-09-28 23:31:10 UTC,1745564417,1745490076,false,74341,988437
8e301b2533542dadceeeaaca734f57d636a7e291f01c1c0eef834f5c931a90c8,988447,2020-09-28 23:29:28 UTC,76424395,76415850,false,8545,0
243d7186d86584fa3f480c3d8b38034b2a64c8cc8667607cf59665a3586a823c,988445,2020-09-28 23:28:22 UTC,2401500000,2401487625,false,12375,0
386ec98b4cc2fc26900e8d848868381008db4787f13dae84945c4ccc48833bc6,988444,2020-09-28 23:27:00 UTC,53334566274,53334564181,false,2093,988431
ab82f4f376710b4bc0def66a321c2a363df98decee7b3b32dc7213568925867a,988441,2020-09-28 23:25:42 UTC,1909633,1906673,false,2960,0
b752406d9f812e729c565e3e941bfd55245d27077c576ab9f6eaa708d46655c5,988441,2020-09-28 23:25:42 UTC,550000000,549994780,false,5220,0
022b4f34685381a59cc038fecb247d7293a59d571ef9d35c540e62b63de1f795,988441,2020-09-28 23:25:42 UTC,20010000,20000000,false,10000,0
91021fa338a7821e8f321a47cffbae5edc3505276c343b02a552dfbe6a1eeb46,988441,2020-09-28 23:25:42 UTC,76473367,76464822,false,8545,0
a937987d553e4ecd7e47e10e200798b0244947196e1d4417df1a243ce94725c1,988441,2020-09-28 23:25:42 UTC,1917515516,1917510726,false,4790,0
985589e8977b3f8efa82b4a767f42cb905526942bb1bf7171ffda212ab04570e,988439,2020-09-28 23:23:10 UTC,351499349,351430989,false,68360,0
81abf53956ed5b5606c19cd3387285606ca069d3bea0d1b346c67def9746564b,988436,2020-09-28 23:22:32 UTC,10399500000,10399487625,false,12375,0
50738f7a8198e3e9424c5f68a7ef5f59b67d20590c1a01bf21c35dc5202a2f3f,988436,2020-09-28 23:22:32 UTC,52386,49936,false,2450,0
2beb91ae7c93c592ae151131dfa05eca33a53956ddc7bbc569d2b70a3209a545,988436,2020-09-28 23:22:32 UTC,311503979,311501886,false,2093,988341
bf7405575023b61ce564f2785dc4afc788bff4b04fe50d891b37dff39f59f756,988435,2020-09-28 23:21:43 UTC,63734068367,63734066274,false,2093,988424
6376b54f03c0c644034744a313ef4a3b4e61d6c33ef2cee29c971e4fd4bcc20b,988435,2020-09-28 23:21:43 UTC,1747551925,1747477524,false,74401,988423
dd08217868619c3c5af635e3ab8715576aa1c2e34f0f2ea9cd05fe1412c75a85,988435,2020-09-28 23:21:43 UTC,12451055,12435598,false,15457,988392
ff22ab22980640788a2497f94d7a6c90d6453dd576c41453710210fb0d6a5892,988435,2020-09-28 23:21:43 UTC,85839143,85829143,false,10000,0
2047958991fd188ffece373b1339d80778157c0521b807bd2865ee14975fa538,988434,2020-09-28 23:19:50 UTC,1652714219,1652698639,false,15580,0
fe8811134510f9028a8f745fb94e7bcd5e5010e6cd81e371b9f442a5dadec7ed,988433,2020-09-28 23:19:22 UTC,24888393965,24888378385,false,15580,0
1f04c925ff5157211b46bf451d42d2fa256fd340af492304e4ffa0ae1b3dd36f,988433,2020-09-28 23:19:22 UTC,4594750963,4594735383,false,15580,0
a2787ace42f28ba3c9653ff19bf4910ee0f9a161ced52e8dee618febfc4ea591,988432,2020-09-28 23:19:04 UTC,56378300381,56378284801,false,15580,0
e8daf26ebf9d9c6521a704a2871cc28d0ff4d08e61af07b196e8555f86823471,988432,2020-09-28 23:19:04 UTC,232523593,232520633,false,2960,0
b19fca630bb02202da217311ebfe9bde07992d9b2409c4299993c801b7c3a036,988426,2020-09-28 23:16:43 UTC,63762567651,63762565567,false,2084,988414
95339e5af65b5a70f140b67f65a177a433fa636a798000b4134ae08f81b68b57,988426,2020-09-28 23:16:43 UTC,298490550,298487139,false,3411,0
ef395376ba94e6dbdec640e7152564c0e7270927ac9c180bdcece41d705bbea9,988426,2020-09-28 23:16:43 UTC,206865671,206862404,false,3267,0
eb6434bc2e2a4a632ed64a1e8c371219c4044e4e54c085c63ccf0c5b79d15d0d,988422,2020-09-28 23:13:19 UTC,76512399,76503854,false,8545,0
b6a85120db4503449e6bdf0879656d081dde6c2bb3e0c5348601469743443b2f,988422,2020-09-28 23:13:19 UTC,52937,45097,false,7840,0
859d12db03d545063bf424a1302303e508593d3a79e4ac6ff3ce165a35ebe0d8,988422,2020-09-28 23:13:19 UTC,10000,,false,10000,0
f058eda7a3e0c2ebb0f4750964fc4206914a4b3636c77d3c4538647429259562,988420,2020-09-28 23:10:45 UTC,71612413,71609013,false,3400,0
475819bdb2fe7d47a96012b123ed4923a315353f2eb6f20b4618ebde9d581fe2,988420,2020-09-28 23:10:45 UTC,224563470,224526729,false,36741,0
f0484495c0d5a00d3065eecbcd67c5812a72f6fe19c85a1ee6b2875177b58404,988420,2020-09-28 23:10:45 UTC,204662154,204659194,false,2960,0
9cfe502127e946512dd6fca519918a3e388a4b1b395fb4a6fe7db1c9302f1660,988420,2020-09-28 23:10:45 UTC,76561735,76553190,false,8545,0
c2eb1d93746c24f66554b30596d0f5bf8c5fa41f4c4feb38c4b7e5e5e679075f,988420,2020-09-28 23:10:45 UTC,12917437,12899365,false,18072,988409
6d4ddf4f040d2c5790a4135089df0794db22a023a4dfe84f98f35a4a22a18184,988420,2020-09-28 23:10:45 UTC,1749998276,1749923858,false,74418,988409
a76e434b221782eb4ee17d6d152538009970ba6aaf64a4b09ed404c9e8da666d,988420,2020-09-28 23:10:45 UTC,14743096,14737235,false,5861,988409
b02a3df2ee72143e33ad979b14b0f4c24770a5b80f6087ebdf56acdf83c76aed,988419,2020-09-28 23:08:52 UTC,76596479,76587934,false,8545,0
557ff4112f3f76f3151f4f0ca62d402540a893d630b2c2273d0f4d41794a74ee,988418,2020-09-28 23:07:50 UTC,49599972920,49599968990,false,3930,0
080d54bdde4ffaed152d319023de9b51cf98154e79e7c6f404cd044084ab0c2d,988418,2020-09-28 23:07:50 UTC,13100,3100,false,10000,0
4ea374f58c0e87b199752f3a22fa4d47d2a3bfa3f11ac7938a7c48e6ed1d6955,988418,2020-09-28 23:07:50 UTC,1000045385,1000035385,false,10000,0
deb26e5850c7f3c6e57634f72177f1d450ac8a2eaae1c2ca6bdac9d6868fe290,988417,2020-09-28 23:06:37 UTC,18094247955,18094237955,false,10000,0
4ee9feca172c8ddb7c41f52e1121efcbd09030c5f5533d181d5007a649659a18,988417,2020-09-28 23:06:37 UTC,242689933364,242689923364,false,10000,0
2c2c7c4659007b3585f851b21d51dd9691f04433339398a135557ccc263d22d6,988417,2020-09-28 23:06:37 UTC,5000163319,5000153319,false,10000,0
509b2387c950c03cde02ce6185c2b72576705a239689a359a36596b7dcee701a,988417,2020-09-28 23:06:37 UTC,143500000,143431640,false,68360,0
9883a60c7bbc8cf5ecd913a604055894c5be19c3368530e8808763c1ba37d073,988417,2020-09-28 23:06:37 UTC,2500168251,2500158251,false,10000,0
e3f426401454eedb1087f0f1e137a77fc4ea214a04e06a11f498d413e5214843,988417,2020-09-28 23:06:37 UTC,198006151,197988151,false,18000,0
c31be0b45df0b5a0979d5b7f76a7b8d5fbbec2998ded22772903e70914b37bf4,988415,2020-09-28 23:03:01 UTC,328802589,328799334,false,3255,988404
5aabe023581e56a900b60cf9e85e0810f22ad72fd5507b84df373f374928fb6b,988415,2020-09-28 23:03:01 UTC,345538724,345536631,false,2093,988404
27f3382dd6efc30cdc65c7100500c6fdbc384edf982ddf5e67e51c27827c908a,988415,2020-09-28 23:03:01 UTC,5352328610,5352324970,false,3640,988403
dfa2ebc3e7bed8210ffd0ffad996eeebaf31683758790ccd01baac55fce9b638,988415,2020-09-28 23:03:01 UTC,2118351,2115084,false,3267,0
f9a3587d5160fa8d37f95e6b4e5c5284895cc020d1b7cd1964f387eecf96ab37,988415,2020-09-28 23:03:01 UTC,19137112412,19137102412,false,10000,0
a14b9148fbc0c1a8f8b40162d8e244c96216fcd1b619b022d2c7259ffbbaa1d8,988413,2020-09-28 23:00:07 UTC,1752559383,1752484982,false,74401,988402
dd29591a43dc1592c0a8c7a4a23a71b8153a19af42c3874dc4f3523b60451215,988413,2020-09-28 23:00:07 UTC,13333239,13315466,false,17773,988402
ef3de9c154883b412c9a089d987466a3e2a5c014bfd7df0705013f92c8c29116,988412,2020-09-28 22:57:51 UTC,232675538,232672578,false,2960,0
eb8cd7b90b0bbeb5caa20548a605e71e97d919488d0c821cd5dcf179d2c64c87,988412,2020-09-28 22:57:51 UTC,76652951,76644406,false,8545,0
ff3ab49a869678cd28df91018bac109314eea4f85d5be521c5cebe66c24ab77d,988410,2020-09-28 22:54:57 UTC,5037085,5028968,false,8117,988399
d5b62d7d56d107cee3e5a85ae1886850527180e43f59906691c7ddee579a59f0,988409,2020-09-28 22:53:39 UTC,19137122412,19137112412,false,10000,0
6c7257f78aaffbb8a19e46242a32a8bd7c351e40a170d7780d44ca0818d5562e,988409,2020-09-28 22:53:39 UTC,230199,226799,false,3400,0
f71b50097b800165f6bc92c20da1dfe8f5030db808ec534f3a2cb0f896457228,988407,2020-09-28 22:51:29 UTC,999960000,999950000,false,10000,0
0199300cac517a4780b1e78683437cda01453b75a11e28d6832d343a2839454d,988407,2020-09-28 22:51:29 UTC,207064437,207061170,false,3267,0
a68244383a20e08a7ea93507020abacc867168940986d4fd6071ecfe5d3a4def,988407,2020-09-28 22:51:29 UTC,13736516,13721059,false,15457,988396
536c240cd491102fdbab2d5a16a7d0a6768cca1dc95df6eb244863f5f273dbaa,988407,2020-09-28 22:51:29 UTC,1754619033,1754544624,false,74409,988396
008e291576b0ef24fb80640b924f0b489d64f36e5678165894c0a6c1e06af004,988407,2020-09-28 22:51:29 UTC,499992384,499982384,false,10000,0
a34fb09a2970f2e7f810c06d133e7bd2739fd8d3fcf7dbff4791cbdd15cc7432,988406,2020-09-28 22:49:01 UTC,1518125109,1518118219,false,6890,0
0c484aee581b1cf2cbe7c584f0b412640c21cf18eec640ddd9528f1bdb7de6a7,988406,2020-09-28 22:49:01 UTC,500002384,499992384,false,10000,0
d88792d0ff9663fd66fd2a5abe5ef9c486467a2cb16325355813479f89a8dcff,988406,2020-09-28 22:49:01 UTC,5093025200,5093024054,false,1146,0
1f7205b74d0613e8d03f029b7c793243be458a10cb45cd0f26769f4cce17f8e8,988406,2020-09-28 22:49:01 UTC,203398676,203330316,false,68360,0
7f495dc4059dc5bfe40ec196915ca0cfd12f50d6fb0706728ca51137817e0f3a,988406,2020-09-28 22:49:01 UTC,76695128,76686583,false,8545,0
6f206c1f1b87b6c1603ab13f626441a2c5264b9e564fa76cd429355aea69bdc5,988406,2020-09-28 22:49:01 UTC,5906498338,5906476850,false,21488,0
d984a35f4e71b14543efd83c5c695e1246c26239688b3ac44bbf53607362d6bd,988406,2020-09-28 22:49:01 UTC,192853538662,192853459158,false,79504,0
9cbb99014c2fec484d90ce22bf39fb64a21e46c8213e60aaa8c48cc6e003025d,988406,2020-09-28 22:49:01 UTC,50677335,50671335,false,6000,0
75807e848d6846561df25444bba517a59e9fa1566c4bc4e42dacabf2a16849ca,988406,2020-09-28 22:49:01 UTC,499990000,499980000,false,10000,0
daeb69982ab96f0edd536e4b66a0927b3d36ccf852f3b18f68a49f6f28c398cb,988406,2020-09-28 22:49:01 UTC,156629,150269,false,6360,0
51e871151a264dc5dd6c127051a20416686962a51cfe39e1c1116087048fc566,988405,2020-09-28 22:44:24 UTC,47715570520,47715554940,false,15580,0
26559569819be3995d793b7752119d9fa171c5fc6133b032aba52627cda752d3,988405,2020-09-28 22:44:24 UTC,22862494582,22862479002,false,15580,0
73eca9bc2ac96002e87574271d5a91012ba8368b3c2999116e5e3b7cade1066f,988404,2020-09-28 22:43:18 UTC,204840074,204837114,false,2960,0
6e1e45e97a737e5473e7e2a8d3f2f273a9ed02d2af1c61daae0a0cb9b6862eb7,988403,2020-09-28 22:43:06 UTC,500000000,499990000,false,10000,0
eb62968e7f730cc1f713ee196d34eff67da554409fee0bb250fa52b8cdef08f5,988403,2020-09-28 22:43:06 UTC,76910535,76901990,false,8545,0
43a466828f6d2c5c2baa9b36943ed434059d17e3637037fbff2fdba60b44870e,988403,2020-09-28 22:43:06 UTC,76723973,76715428,false,8545,0
2ca5d1d2d79662c50614df3ce5779d454d98d49034c7cf9b740265e539cd6513,988403,2020-09-28 22:43:06 UTC,76771506,76762961,false,8545,0
908b848dac1261c1434ee44be338ae942ec16406aba521e35406495373645ad8,988402,2020-09-28 22:42:07 UTC,415863700,415848120,false,15580,0
380aa76895d5e849b6f8813798864bdb02c664abb01862090fc43b315229e32d,988402,2020-09-28 22:42:07 UTC,640106355,640090775,false,15580,0
81526b614b7412f3448ac8905909705a4954499bd2feba4fc9d83801c8cb6f22,988401,2020-09-28 22:41:06 UTC,499990000,499980000,false,10000,0
b27117689a66c92261d7922b21022044976cf6c2708ef74066e71ee08b930214,988399,2020-09-28 22:40:31 UTC,2236637527,2236621947,false,15580,0
624e64b9dcae41eb548ac49d2347f79cc6417d04e00d00b3e6c4958a7a919d12,988398,2020-09-28 22:40:06 UTC,14395320,14375795,false,19525,988386
fb1e3471155a066ff1e5646bccc540ef3c5c619a64d8a0357d2b5b3562c475f9,988398,2020-09-28 22:40:06 UTC,1756696450,1756622092,false,74358,988326
b5049351c756e488f8e4cafd6c4d1a149d6147cc76f9caf241c2e7b9fe03a301,988397,2020-09-28 22:40:05 UTC,12103767,12101093,false,2674,988386
5a47e83536cebbaa3d74ca4fee0487937a5871dec44480c74926110d3ec4998f,988397,2020-09-28 22:40:05 UTC,1361327813,1361312233,false,15580,0
d1a96e958ce6899466ac553d8d590b07bfd6f7908072a43385d54565ea09f59a,988397,2020-09-28 22:40:05 UTC,65470569644,65470567551,false,2093,988380
717b8380c2a6a8229333b494ce324d1ccc40257fd5b456fcd9d937335e8864cf,988397,2020-09-28 22:40:05 UTC,499980000,499977907,false,2093,988386
9295bb8fa634bbdb7dd07453a4414d1e6923a2a8ca9fd09190d8d528728d5221,988397,2020-09-28 22:40:05 UTC,358558177,358542597,false,15580,0
b71330f33ab22884ac13a02c675a3ca2279f33e6d274b11d5ac8a00163102553,988397,2020-09-28 22:40:05 UTC,2291376,2288416,false,2960,0
91ce7664c5537570ea3bdd954ff5e9a5e87e315afbe3d0c389d752732a2b0d2e,988397,2020-09-28 22:40:05 UTC,4548652835,4548641685,false,11150,0
22015c28413b643a38e4c7e387767b00a68f142bb205b527794a5a8a176fb2d9,988397,2020-09-28 22:40:05 UTC,500000000,499990000,false,10000,0
72f3021bed876edf5ef26bcfdeaab0c77696be5a22004da7e040c520f8f72711,988397,2020-09-28 22:40:05 UTC,4323011185,4323005314,false,5871,0
e19722d46c324a79ffa4eb740d274339df4d8ebbb1858ecac17ffac6e275aa30,988397,2020-09-28 22:40:05 UTC,499983267,499970441,false,12826,988386
34d6dd1aea60ac85ab7a28c1f92ca81f5ba20fe211fff5c37be1894d07d965c8,988397,2020-09-28 22:40:05 UTC,382525933,382523849,false,2084,988386
acf57c12bfc3502257a86dd3575ecb300f35f3bd81f98cd2f5e11aa32963cb71,988396,2020-09-28 22:33:51 UTC,2412734042,2412718462,false,15580,0
4209c7d960ac81a8ab552d86a777dc718b62f0a928a3bd3ea20b7aebe00a04d7,988394,2020-09-28 22:32:57 UTC,400504863,400494863,false,10000,0
30a652bfb398fbe07ff90436517dfbe2e2901ad39f33957433d7e90c4ffba1f1,988394,2020-09-28 22:32:57 UTC,232944397,232940824,false,3573,0
d75455dbcf457238b4ce2e03bcc21d9b3910039da645b493260e0736e491e565,988394,2020-09-28 22:32:57 UTC,500000000,499990000,false,10000,0
11633cf9b81ce691bdeda7136dc4c3b14fac2ce1f996e82bda6e7fff8cbb7581,988394,2020-09-28 22:32:57 UTC,5927200000,5927193000,false,7000,0
fca4bb952048aa4dc2ea81069909d5ff657b33680269f5ae9e30cc6223345cd6,988394,2020-09-28 22:32:57 UTC,15694305379,15694289799,false,15580,0
fb3eb080fc244aaec2451c4f35644052ef8b415a122f2316a28bc363dfa69510,988394,2020-09-28 22:32:57 UTC,50533982333,50533882333,false,100000,988383
8cc4b6e6ab7016fb99a0bc44e51e99d30a25bc76ff668b39be0d9509196f299c,988392,2020-09-28 22:30:34 UTC,205893896,205787792,false,106104,0
e55799cdf50312ba7b8715df1d31a9d2881642c5605cebe140e5f4ba9f2da3e4,988392,2020-09-28 22:30:34 UTC,1758463454,1758389053,false,74401,988381
fdc599df0745d1ced604e05d0dea4268e29368120aeda14a6b8819fa9bbe8ea4,988392,2020-09-28 22:30:34 UTC,1762728974,1762660614,false,68360,0
2c98ae521376a6579fea25183cdba62088feb4e5c7d877c554c1bf7e41afa988,988392,2020-09-28 22:30:34 UTC,207218937,207215977,false,2960,0
d7a64091b93cb048614aa70d92140d7cc99a00d5e24fe040b4496e8d546adb5f,988392,2020-09-28 22:30:34 UTC,499990000,499980000,false,10000,0
92e0fa264fa81b4ddb3ab8cd4082f4c65ee5aef20f101bd0af0778359fd141e1,988392,2020-09-28 22:30:34 UTC,3077010000,3077000000,false,10000,0
6b39260d5af1c08afe9564a2a7133c0a010f1a09e4b56a6280987b01a1223e60,988392,2020-09-28 22:30:34 UTC,14865397,14847034,false,18363,988381
e09ac98d4bbc8321378b8b04b770e86bcfd39fd5f5b21d428fa0529acf4924c6,988391,2020-09-28 22:25:41 UTC,5430563000,5430559260,false,3740,0
ae36606e68f3e06957f3b1a7f8b0be0b89a64d90494502957a06c8b61ead08bc,988391,2020-09-28 22:25:41 UTC,831935730,830659827,false,1275903,0
d1d8715250800e26c1e07660cd9137fdac8f8c39cbce05cf677603c03fe69262,988390,2020-09-28 22:25:04 UTC,500010000,500000000,false,10000,0
63f06c66d7955eb1197bd594989d682eb527a49c2491d239e50a1d676c9264f6,988389,2020-09-28 22:24:18 UTC,18190275296,18190265296,false,10000,0
fe862547f129df4a00729e331fc14d4eb3ddd4065d958b86ae87395383122d82,988389,2020-09-28 22:24:18 UTC,76974027,76965482,false,8545,0
ada2626fddaedbbd0f2afd30740571879907206ad763691dde521ba0c1918df7,988388,2020-09-28 22:22:34 UTC,417702999,417700906,false,2093,988377
bdd32bd73d7d547f7fd39db31c563ff0aa4e149a350e04562d7e1730a52b8e30,988388,2020-09-28 22:22:34 UTC,11364766,11364314,false,452,0
f6bd7a82db1542b92daa1039d7eabd0b23b1e819c6269ad9a8059c92cacca28e,988388,2020-09-28 22:22:34 UTC,27952186,27942186,false,10000,0
e7ff04e97afa3cde5a9766c096f9f2bf20c0d7ecb0e2bd91bb993d909b9360d0,988388,2020-09-28 22:22:34 UTC,72087226531,72087210951,false,15580,0
43d784cb5d93e9457b03fc688761541c7975ad349193bf4a3568fd7ac42b3609,988386,2020-09-28 22:21:44 UTC,1618381663,1618379743,false,1920,0
10451718bf0a731b9d862cc213fe41eaf58c380052002ea7a557881d8a71cb71,988385,2020-09-28 22:21:06 UTC,19038915,19038463,false,452,0
37ff874a3b9869c0f5372f5c7ece223b8af2e5b73562f3960b99a0a809171c07,988385,2020-09-28 22:21:06 UTC,205019430,205016470,false,2960,0
da7c4d6ed1198d409007835b6481b94bed618670b7821aee50299b72ec62e53d,988385,2020-09-28 22:21:06 UTC,15263310,15262858,false,452,0
b89a043cf217a70e5d6979645a82036a1dd63ecd25910373af69728be480f813,988385,2020-09-28 22:21:06 UTC,18629213888,18629203888,false,10000,0
f57e39a6e6d1d49a93e34b775e0d259f6082a8d657a3ca321470ceaa71170456,988385,2020-09-28 22:21:06 UTC,314900000,314890000,false,10000,0
e76f0f6d279de900b00ad554276fc2b3006422f15ecdf8e76ec6764555c66498,988384,2020-09-28 22:20:15 UTC,20035452,20035000,false,452,0
67dabbc57e6696b73e8cb6149462546bdbd7a9594f4778c9bcb74562734d6981,988384,2020-09-28 22:20:15 UTC,15221963,15203600,false,18363,988372
8d745479771ff3073a368877f51eee115b639bfc4af480ae5b6e4e3062e25c14,988384,2020-09-28 22:20:15 UTC,195376575,195354442,false,22133,0
5aa4fd8afc62ad8ced3cf684cbcdaff65b16e31db928db6288c49f96b8a1ee97,988383,2020-09-28 22:20:05 UTC,500000000,499990000,false,10000,0
7f4f593f408a7a46110bf239ec1b403ab3139aa1b78099bd62b3372ccd62365c,988383,2020-09-28 22:20:05 UTC,128267585539,128267583189,false,2350,0
ff3a99bc35f3232c9e62c825acd44689ab71003ac1d86d4f7f0c0a080bbad702,988383,2020-09-28 22:20:05 UTC,7377302568,7377173506,false,129062,0
a3c148fca139300b177490a498530431096d659e27989fee2228d046e5da6b97,988383,2020-09-28 22:20:05 UTC,253309336,253306718,false,2618,0
24d6a19c6a36b8667f29afc040a8ce1a5c695b13c6d04ee2ed28937c4f6e1da9,988383,2020-09-28 22:20:05 UTC,404503576,404493576,false,10000,0
d2a0525c0dabef898a92d484546e902f8b58479212fc7fc2610b7dfe3c1c1436,988383,2020-09-28 22:20:05 UTC,1760348775,1760274417,false,74358,988372
11f3ce26203401dac5a27ad7a8f718375115b89116bce814df0811f74c52549c,988383,2020-09-28 22:20:05 UTC,2537726,2534766,false,2960,0
ecea7f04a94271e3d87df373eacfe2f1ed7aae6a8b4e328b805b011d05639091,988382,2020-09-28 22:16:31 UTC,77007209,76998664,false,8545,0
db025ad2c4b1d97df2fbfb118abe59c7faa896cfa84aff5417b4afc1ae807fc3,988381,2020-09-28 22:16:28 UTC,233207985,233204412,false,3573,0
f0ba7e0c7051c203f614f21df4dbfe469431fb98d0424fb829b331da6a07ff03,988381,2020-09-28 22:16:28 UTC,3018131453,3018121453,false,10000,0
61ee9d76fe15e0f407bf73fecd666fe36254dc18daf6c578f599c7f9e05d32e7,988381,2020-09-28 22:16:28 UTC,5064407785,5064397785,false,10000,988369
624bb212dac6c54cba1b6ec68a6e6d8140cb38f0f769a11cddd8e5411436fdb4,988381,2020-09-28 22:16:28 UTC,18629223888,18629213888,false,10000,0
9756053c2be5b80146679453faf885f5808e9fe535b40da9a1ddf2e607732d85,988381,2020-09-28 22:16:28 UTC,67305622,67295622,false,10000,0
ce2bceb37724aae8289a2d1b799fd908175fc3cc49956ea0ca89d3144a73d876,988381,2020-09-28 22:16:28 UTC,828026537,827926537,false,100000,0
22f349df949bac29d1cd99da8fb325df1efc62a4c1ed5d2287e8354da8edf0a9,988381,2020-09-28 22:16:28 UTC,47500,45050,false,2450,0
850f85dbce6b7fcc0612f82e8131867f4c77d7d5fb0a5a8c821f2c668684f067,988380,2020-09-28 22:11:40 UTC,500000000,499990000,false,10000,0
2d01d406cf598f8a7e4d326d0d7591414aa36d1438a03ec5679acea88fa309d3,988380,2020-09-28 22:11:40 UTC,3345519287,3345419287,false,100000,0
e9cd50643b2cecbf63f1cc0914d411078512c4a7c769ed5540a06c3f8280e65a,988380,2020-09-28 22:11:40 UTC,4048146760,4048143020,false,3740,0
9b2de5cddad83bb90b808e8a595073f711dc329359a88112117c47d53e42967b,988380,2020-09-28 22:11:40 UTC,18425291235,18425281235,false,10000,0
a97f8e393faa83e138ee1e7484b3f1347c85dc5a73cb8c83c17b2db64ec2c1e5,988380,2020-09-28 22:11:40 UTC,16021527,16000558,false,20969,988369
7b4258b38ab6c306dac08dac8b0b56b391fdf2f8a989f7610a3d81b1a0b336bf,988380,2020-09-28 22:11:40 UTC,1020111711,1020043351,false,68360,0
0348be960667978cd7ff5c24f1196464bfa254ab8a93153e714d633db9835ff3,988380,2020-09-28 22:11:40 UTC,1762457718,1762383403,false,74315,988369
3bf3b38e5c69a1b8514d32543f371b1a0eecdb10a8808962f4204c49e503ab1f,988380,2020-09-28 22:11:40 UTC,77115821,77107276,false,8545,0
6e9e0ed531874b7aaceed708bbdaeabdb8dd0712392e98a874a44962541c5fa6,988380,2020-09-28 22:11:40 UTC,134191155,134158179,false,32976,0
5d3b352849304d05a487df9b39fbe18a9b2aa9ff9c49846d7492f6364646296b,988380,2020-09-28 22:11:40 UTC,22545251,22537841,false,7410,0
bc118290e4a652ac67013420a6ff5276526121d196d1a20b8375d4b8c4c276ac,988380,2020-09-28 22:11:40 UTC,1126974000,1126964000,false,10000,0
005d120803987f829fc920ff4f6744dca60a361288ecca02a6ae8e011bccf5fb,988380,2020-09-28 22:11:40 UTC,20916543,20910665,false,5878,988369
1c47dd316bd4026691578dae11ec5fd5335c35b062e039f2b05ed410d940dd89,988379,2020-09-28 22:07:27 UTC,77145261,77136716,false,8545,0
22a948972fe9f28729e89ce6173c3e3483b82fb39d7b6dddf70bacd8ec72e195,988379,2020-09-28 22:07:27 UTC,500010000,500000000,false,10000,0
2792250812a13549b4b49a507619a0742ebee91c9f6766021dbc344bf93796fd,988379,2020-09-28 22:07:27 UTC,447081038,447078954,false,2084,988367
57aca98188df029400c8013b7e940de93806c5cbde393d163bedb110813c6c57,988379,2020-09-28 22:07:27 UTC,1000005808,999995808,false,10000,0
87df996b099f2e579d97546e80b755a9df282dc7969ad751f0ff9519bb118e40,988377,2020-09-28 22:06:33 UTC,500015442,500005442,false,10000,0
92d92a77436bc4853dc264020698529261d3960294b8d5a1a95edbc39ac22bc2,988377,2020-09-28 22:06:33 UTC,500039525,500029525,false,10000,0
e49b7126a8b6d1ffc9e309f489e78d966ce5e4489de90e2c4d8c2d1b14ee3893,988377,2020-09-28 22:06:33 UTC,18425301235,18425291235,false,10000,0
8ac6a549635ee8ebf876b7e4417d47ff7b205aac646e8d7a8fb4a4312b46d11f,988374,2020-09-28 22:05:21 UTC,34270,24270,false,10000,0
eec1f25927caf801b8c9838ff2248d0360d443d7301d3d7a3c3071f32559bca7,988374,2020-09-28 22:05:21 UTC,2000324162,2000314162,false,10000,0
0355e5958582b85da71f362bba024cdc61fcba992a745389ec24bf5eb4951ac1,988374,2020-09-28 22:05:21 UTC,499992960,499982960,false,10000,0
c8c03791f6b6625b843c35cb9142c25ad6bbd857af4e739636e818fb9d0ac5d7,988374,2020-09-28 22:05:21 UTC,207426646,207423686,false,2960,0
0af31f50f3f98f1572c17332160d0c763e9577c0e672cf2e6acd060082ec2a93,988374,2020-09-28 22:05:21 UTC,68520,58520,false,10000,0
248294578c6826b2b0027404634b5c0d456c7cc3f7cc771e2aa41a9fd83a85d5,988373,2020-09-28 22:04:45 UTC,2500178251,2500168251,false,10000,0
f01311a00064f8e5100dc1fadcf4056ae588efce6fa60943f6b1e25b35eacdf1,988373,2020-09-28 22:04:45 UTC,241156428250,241156418250,false,10000,0
c4517fc1cfe982dca2590919d6ad2b492067763c48f5aa3e39639cc03a1f8b85,988371,2020-09-28 22:04:03 UTC,500000000,499991454,false,8546,0
0d4aed28768b7fe7461fa6e9014b540bda2f61805d7352584bdff691d5ae5dbd,988370,2020-09-28 22:03:12 UTC,499980000,499970000,false,10000,0
680d6d5a1059e59c31a20692f16188d94855365d7c5e477e62d44076cf8c1ee6,988369,2020-09-28 22:02:37 UTC,500002960,499992960,false,10000,0
62a3b34f62483ed5044a897c8e97fb67ce7663a7d6b0108803a261a5aebd9760,988369,2020-09-28 22:02:37 UTC,10000,,false,10000,0
34c77fc6892e553eae26076b7ee97eccbff730550e5c8c93c03e7ca1b9afa609,988369,2020-09-28 22:02:37 UTC,719585528,719582179,false,3349,988356
f32a2b12ae6a8b0361e3551437e1d0e7dfe5fb1e4f941442432aba11ee76d5bb,988368,2020-09-28 22:01:29 UTC,950662230,950658112,false,4118,988356
67301049482bf3f5f9a2ba826b979642a38190d8c57eab98d9786822b12267c8,988368,2020-09-28 22:01:29 UTC,601868895,601859223,false,9672,988355
de4c579eddae060c768929ca5dc22af2087a06e4cfe9ac2b1b9bbef0eba58858,988367,2020-09-28 22:00:57 UTC,205194282,205191322,false,2960,0
aa426c96804e8f23753eb430fecf267b445da7c1370f380cf7a62cd10ef4271c,988367,2020-09-28 22:00:57 UTC,1764061672,1763987305,false,74367,988355
f0af8d4928fa696ea35187b99c30f1c179e148048775cd60bdadf432b9923f16,988367,2020-09-28 22:00:57 UTC,16864492,16841506,false,22986,988355
a0d525f503162b3a12d0874dbd519a986fd5d8d34e3c16299b816ad3cdee3fcf,988367,2020-09-28 22:00:57 UTC,423863743,423860488,false,3255,988345
f314c28537d6c53811deadb92d3cd9da9861753acd90271315bdac58d288f7ef,988367,2020-09-28 22:00:57 UTC,1464243085,1464233085,false,10000,0
b9adb2af064338752e9265d5c7e739480eb6528e5d6180ce521c3135319e7b15,988366,2020-09-28 21:59:52 UTC,272986004,272983943,false,2061,0
dfc2efe1cdaa9410611128b610d78a2b69de7db4c70b5bca77a6d7cc7ef6caf1,988366,2020-09-28 21:59:52 UTC,23260510,23255888,false,4622,988355
6c35daea37b838c0a5eca67f7e5d8807ed112d8ac7c94c2942d4696e5b1b317d,988366,2020-09-28 21:59:52 UTC,10241831,10239738,false,2093,988355
642e5e28388bed5d81fadadd0e26cc5d54db3f72ea1b51faa5aa68e426afd04e,988366,2020-09-28 21:59:52 UTC,20479887,20476538,false,3349,988351
bced4e504619639e6071bc9b4c1f62e0dfd95ed8c9ebcfe54ba59210969224fc,988366,2020-09-28 21:59:52 UTC,31510232,31505618,false,4614,988355
2287eee04a960b815262d8d9b5a08603341233251ac6d264ab1ba3f1d09e6b5e,988366,2020-09-28 21:59:52 UTC,4388863,4385505,false,3358,988355
1d1fef2b73467601eabb26afe8656e44a22dfd48aa77723d8d50ad3e026064b9,988366,2020-09-28 21:59:52 UTC,2732950,2729683,false,3267,0
5a77cca7a53e993e1186a088c65aec5218d6272ff8eec8f1899507b25184cb6e,988366,2020-09-28 21:59:52 UTC,10551155,10549071,false,2084,988355
aa1cc635e288f6b550a258b6173b9404d4dc75dfbe3c6a8eb6f0e18aa358aa84,988366,2020-09-28 21:59:52 UTC,9189733,9183855,false,5878,988355
8321be4dda46426d6497371d163e990a7d750baf428298bc84a2ce65166c8a93,988366,2020-09-28 21:59:52 UTC,20623140,20619791,false,3349,988318
9e5dfe5802760df661c3b62e9779309872752eb85d918ff331dc94d729933fb7,988364,2020-09-28 21:57:42 UTC,733287774,733285514,false,2260,0
4a96c0fa66a36fa670901a1c9447ed7f9d4d82b9d7c723192be5ba7cb6e3917d,988362,2020-09-28 21:54:59 UTC,100913849,100903849,false,10000,0
b6eccb436b7c6e21aabd60adc9efc38476fb02f50df6714a44c6a7f39ec32143,988362,2020-09-28 21:54:59 UTC,859513047,859444687,false,68360,0
c5d85c2317e73d376d0ea9b4412ce45cac7778254ac3066c37aa365c7e47852f,988362,2020-09-28 21:54:59 UTC,65090611,65079406,false,11205,0
1306ceee50f5ce1fc36f8889b583fb2229125eb36a088ca60151d2558c1ecca9,988361,2020-09-28 21:52:12 UTC,4555102332386,4555102318225,false,14161,0
5cd03ddd07faaf00cdc6735df1993e70277322fd087b15990d576ccd60b6688d,988361,2020-09-28 21:52:12 UTC,2673000,2666220,false,6780,0
d49997a01a2bf39a75b877cd561e9d295ef102e6175b455de3a855c0c3e67413,988361,2020-09-28 21:52:12 UTC,77363513,77354968,false,8545,0
1ad4bbd4245811944c7e7f23052bf44e20c1dc70d91a05dc43ebbbd85a296af8,988360,2020-09-28 21:51:31 UTC,17398842,17383692,false,15150,988345
39797b0d12e63984e42d966413c746179cb283435a0accf2ff98e435ad96481b,988360,2020-09-28 21:51:31 UTC,500000000,499990000,false,10000,0
6db4053eae16f11d59c5d2ad0cc8b87cf0c9fdcdf2634f59a68caba7fec68bf4,988360,2020-09-28 21:51:31 UTC,499990000,499980000,false,10000,0
15069e3d964ab6311fb7b0c5b9195ba00f59f9f3f8b69880a2fbcfe98d6957d0,988360,2020-09-28 21:51:31 UTC,77501658,77493113,false,8545,0
24455e4d4f62922946f4cce764787440bade2815c5d5f2ad52adfb0fe039b408,988360,2020-09-28 21:51:31 UTC,67234633409,67234631316,false,2093,988349
53c9ebdb7c5a41c3b95b0ed5ed0b2a835f8881877ca4475c3d4a935885cb1741,988360,2020-09-28 21:51:31 UTC,1248118110762,1248118108678,false,2084,988293
b5e858fd8415a30917cc4ef465591c14782a05313c8c30d2a38c9b50317fb8c3,988360,2020-09-28 21:51:31 UTC,500003740,500001647,false,2093,988348
05acf9ae96f1b379ea61ac79bdba860b57ad4fe02b31da5d2a87581511138639,988360,2020-09-28 21:51:31 UTC,2073028547,2072928547,false,100000,0
1d098e7d0f93289d71b8ce94034745fdd1dcd6a5e449c1bfbf73376ab9d5ad8c,988359,2020-09-28 21:47:30 UTC,10000,,false,10000,0
c0372990698a35e41ec33d80db2d8fab3c373902c8e7551676e115cf812a1b5c,988359,2020-09-28 21:47:30 UTC,500000000,499990000,false,10000,0
5cf3c17eb583f843d79835a199f6edbaa97dd5cb70247f87c8ad20293569d7de,988359,2020-09-28 21:47:30 UTC,233355463,233352503,false,2960,0
7cda7f7fbf4c35eda8b807882f14f3eedb02e559105a65b8a54456264bc481a1,988358,2020-09-28 21:46:52 UTC,17625912867,17625902867,false,10000,0
65c952ea6f848dbcbb2fe4c42d52552fb54b5b7a91a768510eaf02d09ad07379,988358,2020-09-28 21:46:52 UTC,2390554970,2390554247,false,723,0
65bc241321a8a238704e1d2fbe3a40cab3b13d232c5f934f64f657c34df4f225,988357,2020-09-28 21:44:58 UTC,481975860,481970960,false,4900,0
450c8ee9722cb7303a4b3f05167df2f1815e23eb552982b7c72da7d22d723807,988357,2020-09-28 21:44:58 UTC,207804628,207800137,false,4491,0
0203c22e6ed712d85aef2fb12ac6bc872b349843a15ff8fda561898da685dd6b,988357,2020-09-28 21:44:58 UTC,499980000,499970000,false,10000,0
27546f1546945031ac5e69f654a5fc0b061c0229f504a8da249ecc3f66bc3672,988357,2020-09-28 21:44:58 UTC,77848851,77840306,false,8545,0
6acfc2fcfa228b219e8eca2a807ac59a0687f61b387ebec3a3389a6c4005402b,988357,2020-09-28 21:44:58 UTC,1034159853,1034156113,false,3740,0
ae90f35daa6e75b65c26de3b7585196025f7fa2cf06c4049818501ab900c1934,988354,2020-09-28 21:42:34 UTC,68257752128,68257749744,false,2384,988341
60a7893240360c1f5fadb39fd04162091ddbd3a778b9900a495fcd9493491369,988352,2020-09-28 21:41:36 UTC,8290355,8283811,false,6544,0
5f70c176c8471af699d48832f1b26073e1a6eb65e34388778e2d562b16ffa6f3,988352,2020-09-28 21:41:36 UTC,200000000,199997464,false,2536,0
0c963946f8b36d8b9012152fd357585098628714196fcd0565b7e579e8583493,988352,2020-09-28 21:41:36 UTC,209993220,209990960,false,2260,0
05bbee8ac1fb0bfa948fd249689305f62c31e74bcadae5894aed6776e22ddb09,988351,2020-09-28 21:40:38 UTC,17839212,17818243,false,20969,988340
7ae59bd3334ab1f5da085637b636122418931a4b89dab18cb835bd415c2b1479,988349,2020-09-28 21:38:47 UTC,499990000,499980000,false,10000,0
d70316151efb83c3e5e45ae16de4e4d80e036905418867865e0015436223a6ff,988348,2020-09-28 21:38:26 UTC,205593976,205590403,false,3573,0
69748fd0ea113fbfb5bc69735c1b7450eed8bd2e51a047fd3ac6a89bcaeb5cad,988346,2020-09-28 21:36:57 UTC,4500205917,4500195917,false,10000,0
74e28fbffff972251fa428c63b6f769638b6ed530e00892dc727faa5bc4382ae,988346,2020-09-28 21:36:57 UTC,500000000,499990000,false,10000,0
b8000e2ee767fb793ee7eb29a7c7909908971806079b4c3a59da7f6e4c580ee0,988344,2020-09-28 21:36:29 UTC,42847718,42845625,false,2093,988333
45f331cfcfc532beb2f88d0e44ed32670a1a8efdd9c2333ac58005fd65f64e9d,988342,2020-09-28 21:35:00 UTC,94465677621,94465662041,false,15580,0
f258f5421dbe056301a6477c95b089dc0b9f81e0e63b2546ab8716ce3b3241e6,988341,2020-09-28 21:34:36 UTC,38661000,38659854,false,1146,0
42bac5e7f8ba57d773708ecc74d1982eb124ecdbd9ed0045631465ab35780646,988341,2020-09-28 21:34:36 UTC,145852250,145783890,false,68360,0
f606ac94d805d92eac25821c9198a3e6829a5d0617596f2aba54203f890f66e1,988340,2020-09-28 21:34:09 UTC,3212318,3209358,false,2960,0
b88ef0d09b55d6f47b0299f1c5048d3b75e9bfcd696b3a201112b0f1b57441b5,988338,2020-09-28 21:33:31 UTC,77927227,77918682,false,8545,0
d5261e61a1de792e05e6d76f32a6d27ff9a4165c1e855917085b50b7c171ccec,988338,2020-09-28 21:33:31 UTC,10158889,10152109,false,6780,0
6c689951c725e55832e585bbc8a6c788d0c33833278808d5e427b422e998ca63,988338,2020-09-28 21:33:31 UTC,70972754221,70972752128,false,2093,988326
6fb9dbbc184f863126633a0c8696916cecb1cfa158a5fdd79676816430dd1ba1,988335,2020-09-28 21:31:12 UTC,2464500000,2464487625,false,12375,0
5676902c1ba41c0c43eeeef52762d3323cd4c768a174db91472fddddd21b1474,988334,2020-09-28 21:30:09 UTC,18355768,18335662,false,20106,988323
be1dd587a9fc4fdc4e486072dc65f3dfedd68ccbbd47a867f36e04a75e0f7c0c,988334,2020-09-28 21:30:09 UTC,20463881,20461961,false,1920,0
e930e0f7feb86de91263fcbf726c71b37177995a293263d6c151749cd621ae1b,988334,2020-09-28 21:30:09 UTC,233549309,233546349,false,2960,0
8b7990ccd4b1b92591b63abc05f8eb7d6ad75dbf85b213b32db99222ffa87219,988334,2020-09-28 21:30:09 UTC,73437256314,73437254221,false,2093,988323
11208709d94483e5a42a466a1d365b639ab6560f08fe6ac74f7a907450263599,988331,2020-09-28 21:25:13 UTC,208044329,208040756,false,3573,0
5060b1772ee033e662a12b82e9046f2545aabb3defe955985d83cefff5870fec,988331,2020-09-28 21:25:13 UTC,1023888,1021795,false,2093,988320
58ddafac226c6aa1f05d24ee0c7f686a230a403bb70838ef3dc5f977ad7f7c2a,988331,2020-09-28 21:25:13 UTC,84683335,84677335,false,6000,0
d677dad3d6ec1c50cc4f74361068aa65611ae378e596a310028b6ade8beb180b,988331,2020-09-28 21:25:13 UTC,77959856,77951311,false,8545,0
6cb1438674ee7431b32a8a1214e0239b6ecf43d602175c7d93fe6bc01176faae,988330,2020-09-28 21:21:43 UTC,19061721,19042777,false,18944,988317
ad5c5aa815b7284394524095851038739ae0b6a23d70a0cdc7293b6479b0ca77,988330,2020-09-28 21:21:43 UTC,73499858407,73499856314,false,2093,988318
279aefb9ba711e7fcec3413233170a594daa2e622016a16049ce2884a9f0aa79,988329,2020-09-28 21:20:37 UTC,392156545,392136587,false,19958,0
ef35524363d8e3a1c0027e9918e9f61d0b1b6e93cb82b92702afe77e4b8ede24,988328,2020-09-28 21:19:35 UTC,205883175,205880215,false,2960,0
d93dd5efbb6f709bf00ce853ef7a5911f37b4d2d0c576e3e6d2f1f241a48aab1,988327,2020-09-28 21:18:26 UTC,84942000,84939550,false,2450,0
67858d322a78c78b56763a3b9739d5c2103a8963490b8c011b70c0ffe8f8d201,988327,2020-09-28 21:18:26 UTC,17620070263,17620060263,false,10000,0
3289c5b3adc2e8c3aac81d85a61e5d401a1ddc13f7963e0b1e6689e3a8f4426f,988327,2020-09-28 21:18:26 UTC,107972849,107954309,false,18540,0
b00b942fb4e823fb7495c320702439f4a2940df2531f2c4fabd2fc5abd2a3324,988327,2020-09-28 21:18:26 UTC,576037517,575969157,false,68360,0
403ded1f6490bc19fd9a4606e543eb85ed3ff8566062c0e939910ee5cf34f250,988327,2020-09-28 21:18:26 UTC,7520545480,7520538480,false,7000,0
12e6a770f21633c04e30ffd1a5657472c3b65e020c6464ae41d9637066c6ab5c,988327,2020-09-28 21:18:26 UTC,20174422,20165057,false,9365,988316
24358e85d379794fad1a410cd2def8c20c969074996fe9683acaafc5e6f73b06,988326,2020-09-28 21:15:21 UTC,18856653860,18856643860,false,10000,0
2e0b04caeea7ae16726e8390ba5af85a01f40ef2bb4fe87159ccdbab017315f9,988323,2020-09-28 21:12:09 UTC,78002995,77994450,false,8545,0
f996d1bc9dacc732e5432b36b051a045e91517529a7cb86618beec3b7482657a,988323,2020-09-28 21:12:09 UTC,499509999,499499999,false,10000,0
ca845022aeb150dba4515cf827957b0ae2cc33114944c2cdf8647ee5dcf29dc2,988322,2020-09-28 21:11:22 UTC,8042205,8040112,false,2093,988311
1c9b67772b6f50e651b3817b0e3c1b423702077a8f17af737d10ababd9a09813,988322,2020-09-28 21:11:22 UTC,1290285266,1290268873,false,16393,0
d53d5e3eb75171d42544798c235532b5cc4f76073ba2759f051a9f358f30b06f,988322,2020-09-28 21:11:22 UTC,154500010000,154500000000,false,10000,0
67b96ff55e581178ffa79f8baf47978e78a65e49b03d0f78ba63a79aba6438be,988322,2020-09-28 21:11:22 UTC,7629262,7622372,false,6890,0
735003eb7449dc4ce429a7727145f22311e7a91c14a884434dd1b05caac344e5,988322,2020-09-28 21:11:22 UTC,1137240961,1137172601,false,68360,0
5b65c804e55d0e9b3a52434a1106526f6e27aacbc5b2ce5ae4fba883e652ff58,988322,2020-09-28 21:11:22 UTC,7000406,6800406,false,200000,0
fff8d57d84cba44fc3f1c0cf96baa5f983287cb158866f128f69a080e32a65f6,988322,2020-09-28 21:11:22 UTC,1099955700,1099953250,false,2450,0
cae7b1a9d197a00e19967d9c3408b44f118e9d94c952b67ec5a8c20bcb7e567d,988322,2020-09-28 21:11:22 UTC,1500029933,1500019933,false,10000,0
b99668cad240d18cfe64f999bb27feca19f670466fe001bf83d07e8b257751b8,988322,2020-09-28 21:11:22 UTC,500000000,499990000,false,10000,0
7c92184a810d3d56bc51db365b025db4a7d420dc1f5ee857e12d190114a19155,988322,2020-09-28 21:11:22 UTC,233717958,233714998,false,2960,0
5f7909ba98b8dca5295916a41d4047285b8225401c8b639439f660e24cb4be2c,988322,2020-09-28 21:11:22 UTC,5520435,5511890,false,8545,0
9e19d3009f6feaa9dff8fdef7d6a2934eb7db5222654657267ddfd9f45e7cb14,988322,2020-09-28 21:11:22 UTC,25192,18832,false,6360,0
d8998d819e853c7c8f7d61dedbbd9c2a783c6dd3d97f3acf1c45e8926051e09a,988322,2020-09-28 21:11:22 UTC,20973812,20950228,false,23584,988311
6ee41c391e7f1c3883588a02cd4c20e40dfe9cb02e2bb38776e3d035f5a0e3fc,988322,2020-09-28 21:11:22 UTC,20201622,20179491,false,22131,988311
75e56c41fe381e5d4a776b336455c0abd8f87b1f954b94c6a8a83b5875ef2e79,988322,2020-09-28 21:11:22 UTC,452236353,452188353,false,48000,0
344b1a6b052e961c3e0ad6eab100c510ba34f18c54b520775a3f986b769fa840,988322,2020-09-28 21:11:22 UTC,1000085958,1000075958,false,10000,0
8aec4ebf87ffd13370d15d8d3c50ce045e843722ca2f10f3eabfa95b2f10f8cb,988322,2020-09-28 21:11:22 UTC,73805851606,73805849522,false,2084,988311
9ef3d5ad246198e1b0afa1e089937ae1316a2ba6dbeb138b92ea6121fce48284,988322,2020-09-28 21:11:22 UTC,237312881261,237312871261,false,10000,0
48ce748ad31e5e7e7cf84595e24b34684c6e77e638fcec985342beece93d3d71,988322,2020-09-28 21:11:22 UTC,485866468,485863213,false,3255,988311
5b17c7d1a0034c298e8b779985982c246eebbb2025841739b24f0e88ed68f4e4,988322,2020-09-28 21:11:22 UTC,4500369781,4500359781,false,10000,0
f5d383bd0106686b60d529b40058eef6becefa85ae6d60433a70ad775bf9d07b,988322,2020-09-28 21:11:22 UTC,208381594,208377409,false,4185,0
418e5b5a292ada8299ee8ad68c7de03fc089d66442b8405b240e5d5ec011f256,988322,2020-09-28 21:11:22 UTC,1248450167253,1248450165169,false,2084,988311
de2e70c6da423cc53cb038459aaf08fb14564610b6537e9842f93eb33c455852,988322,2020-09-28 21:11:22 UTC,3406594,3403327,false,3267,0
4f3adb1720213eaff8f1f5c071d8f3cfb6e54e3ab29c6080df22b24b213e200b,988322,2020-09-28 21:11:22 UTC,110040041,109978731,false,61310,988311
f4b7204ae2718344f8a2eadc87697194f8675aab0a0f1ff41277fc39d828deb7,988322,2020-09-28 21:11:22 UTC,197668649,197621216,false,47433,988311
65b040dab011503e5238c0013862b56d23ef6dacf0f5e253375f4c9fa2c007ea,988322,2020-09-28 21:11:22 UTC,78034023,78025478,false,8545,0
6de6b5f95f7cc7e3181aab21c3e139f49773fe7fdb42b3dcb2dc0ad4943059db,988322,2020-09-28 21:11:22 UTC,2000334162,2000324162,false,10000,0
1ac41016ef9c172a61668f920828b980122ee1ebd422efb4cf5736e803136710,988322,2020-09-28 21:11:22 UTC,101969818,101967434,false,2384,988311
ea4456408b5e1dfa16afc5ed76ba4420fbdb2b60b99d0826808051d8c5ac30dd,988322,2020-09-28 21:11:22 UTC,70883180,70881096,false,2084,988311
b875f18435a2bcb9891ccc088e2b12f02a9b2ba37af66a5ae06917615b6dcd13,988322,2020-09-28 21:11:22 UTC,15614,13164,false,2450,0
16a0582484caeb5cf963aaecfe8f14c9ae3b904d0a4cabc8971eb59d7de965d0,988322,2020-09-28 21:11:22 UTC,10000010621,10000000000,false,10621,988311
39338e2c514a93308e58dbd0fdd6165946b67a9ab6431b4b248c7be0ce7d2cbe,988320,2020-09-28 20:52:21 UTC,94994599,94987495,false,7104,0
69a6724821c22e9c0980d9117c09350a2fcf8a7fdf79c6ba1299d3f4dcdacf2a,988320,2020-09-28 20:52:21 UTC,78341079,78332534,false,8545,0
08483a7d5458d0aae72be6537d5ee4cbf4def7cc1f4f4c4deb6dc8ddf4d336e2,988319,2020-09-28 20:50:34 UTC,78379912,78371367,false,8545,0
09878fd047240efdd066764ec02e2010e703390d516275396d81eaeec1195728,988319,2020-09-28 20:50:34 UTC,18499490000,18499290000,false,200000,0
4d1c9de7a4fc537b99e4a518d79b0926cf4ba98bde01211d0b3f5cf645120fa5,988319,2020-09-28 20:50:34 UTC,1900000000,1899995000,false,5000,0
d67e73526f8709c4490893c0c03ad7387c5bead76546e03ab2c2887e752b05f7,988319,2020-09-28 20:50:34 UTC,504942500,504932500,false,10000,0
a32feed1ef191d7649710c545e87702c76b2bb307bddfad4ffe71ac6e166bec1,988319,2020-09-28 20:50:34 UTC,73894290587,73894288494,false,2093,988308
3496a4e74ee8fb50edab9eaec48f1434edb617fba32b0515278c8dfa63848f28,988319,2020-09-28 20:50:34 UTC,22070946,22047952,false,22994,988215
9b0b7a479292a4f935686fbf5c3bb0332ca929291bc5cb1c5869a66ac4087947,988319,2020-09-28 20:50:34 UTC,10000,,false,10000,0
c98b2e0e3a0f7c3029ab67c45d48cbef86fd656255c38fef5ebde242f1f2f7bd,988318,2020-09-28 20:47:04 UTC,2107782,2105407,false,2375,0
e1de1c8dea06d11c7b35a459f670e45a5998b6215e6b173b518f7bcc7cb6d146,988318,2020-09-28 20:47:04 UTC,504288862,504204622,false,84240,988317
701f28ad70c2e8e83c819044e07923cb6d65438bd8b66728241019226f9288bd,988316,2020-09-28 20:45:08 UTC,206031263,206028303,false,2960,0
2b1ea5712edbcfecc398774032ab543a69abb5f5faa73042dc7fc83afc69407a,988316,2020-09-28 20:45:08 UTC,50543982333,50543882333,false,100000,988305
26b41f18ba7ea8029b33c7520c07d196a9ceca6d25b7e1e1268b7bfdf742bb81,988316,2020-09-28 20:45:08 UTC,8633579884,8633569884,false,10000,0
8a2574ad34387cce9499b5dfb528783fc357527d14c17d620de0fd462663b51f,988316,2020-09-28 20:45:08 UTC,7224463141,7223463141,false,1000000,0
e42e6907227e5a190a2837c73ee59900a2a898497dde8ddebe2b3acaa1698faf,988316,2020-09-28 20:45:08 UTC,2014980000,2014970000,false,10000,0
d22f4733f13b1628c1bd57f3d0338b57918977d6f8ac47071a2465ff379368b7,988316,2020-09-28 20:45:08 UTC,191600000,191598080,false,1920,0
ff61dd74c8c01962019ad14a35f1e194270e0f1fa0d5a28bd0e21938fab8a700,988316,2020-09-28 20:45:08 UTC,2014970000,2014967464,false,2536,0
8770032e85edc0f85e594287d206b4b484ddc9d39fd36a17dc36755a9009de8a,988316,2020-09-28 20:45:08 UTC,78638542,78629997,false,8545,0
c2ce2e68bca4fad33c90798a4d9becdf5d141dc13dee8d35c4ef1060ebb32d25,988316,2020-09-28 20:45:08 UTC,214411281,214408831,false,2450,0
77cde20ae2c7eaa8c470f849c41d7837877ff5a4facf29f705ea5ca8de1e07d0,988315,2020-09-28 20:41:04 UTC,78717451,78708906,false,8545,0
c3e60ffb178b20d4d46aeb05a196e517d7eece3937a485fffc56994950790518,988315,2020-09-28 20:41:04 UTC,7540593000,7540586000,false,7000,0
23c0ff10b4d2b45e9ea54674627e34b7746836569409ea9ebbc2d945806a7e44,988315,2020-09-28 20:41:04 UTC,28597835,28572875,false,24960,0
fb1d6f21de68bc698fb1edbb4887cd3e567070ba755eaee5c26c71aff8b0ad11,988315,2020-09-28 20:41:04 UTC,22572362,22553145,false,19217,988304
dfbad218cca904c040c6d4902975ab15605e7f1d6139e903dee41d4929448bc5,988315,2020-09-28 20:41:04 UTC,3559708,3556748,false,2960,0
61157e088e971e90f0f231ddbe6b3d9a2d40bc8a5783500cd8aaca89e66511b7,988314,2020-09-28 20:39:08 UTC,10137274318,10137174318,false,100000,0
11dd2eced90a270af662c9d60ba7c7a5262b6912a4ec5789b37c5f67eb7b8635,988314,2020-09-28 20:39:08 UTC,2930341,2927000,false,3341,988303
59513d6a3e1799627f66988da99283a1471699885501080561f550cdea46c368,988314,2020-09-28 20:39:08 UTC,285905820,285903560,false,2260,0
8b1ee94a0b252dbd9c3f03854f1b8fcbe6cb08ec8c16d0f0ab12d49097ebbf3a,988314,2020-09-28 20:39:08 UTC,500002598,499992598,false,10000,0
a2f304d2f99fc8f55dc26c5100e124d6682ab609ec591fe80d6ac25bcd8b6aaa,988314,2020-09-28 20:39:08 UTC,435475877,435407517,false,68360,0
d569c6c6a00572e49b2c8d3ce98d37ea8c9b6bb7b393b4bc257f173e99546070,988314,2020-09-28 20:39:08 UTC,2517708767,2517706847,false,1920,0
176bf39d202b825c8469b809f75fd42341b5b9cec8b901bdebbfc92b2a7ed70b,988314,2020-09-28 20:39:08 UTC,208566408,208563448,false,2960,0
0047ec676d1fae28b932b16008ba4e34c0478fafb88965f73f5e2a965081acad,988313,2020-09-28 20:34:45 UTC,500000000,499990000,false,10000,0
b2bebf3c27ff1984b73ed2945ec0996d4a339c448a8bbb7ed142013918005e1c,988313,2020-09-28 20:34:45 UTC,500012598,500002598,false,10000,0
b43b0fd208e18cc16eb222bd0a2820a101106b2e2f0ab0768598a153ec71ab01,988312,2020-09-28 20:32:34 UTC,49450000,49440000,false,10000,0
588b7a71c40685037113117d6b026aa580df885ba88adb811a7619d8ae10d9e0,988311,2020-09-28 20:32:08 UTC,233970975,233968015,false,2960,0
0306d2b85138ffebcf34332d3e7e5ed3e25262fd478b57def2768676ece5a8fe,988309,2020-09-28 20:31:32 UTC,41614917,41604917,false,10000,0
89b4a9299d82e84efbc68912279976807ed4c86397a896141df0f4eb01069202,988307,2020-09-28 20:30:51 UTC,131461777,131458377,false,3400,0
c59989f9dca65aeb451173d4032c24995fc448a30c8100d10072da9645e3e7a1,988307,2020-09-28 20:30:51 UTC,10000,,false,10000,0
aacb8ac4de6bb3439446a9c4d59e22ce17189d30c0f5dea760aa3a356aceb0e7,988307,2020-09-28 20:30:51 UTC,206525000,206523418,false,1582,0
3924b9037a1aee8cd9923530174f35f2afe116d4a5e7f5079b0533e58534079e,988307,2020-09-28 20:30:51 UTC,399995480,399992069,false,3411,0
36a50f4887079f9577dca8413703fd6325a29fca81d5056afba0b3def66f6ab6,988307,2020-09-28 20:30:51 UTC,81907361,81904931,false,2430,0
3e1e087f039d90d5ede62309ebb3339a3520a1ff4fb6ce741bfa7afa04de899f,988307,2020-09-28 20:30:51 UTC,14917744,14910609,false,7135,988296
f32fb0d36ff7e86443376e8f7da893f4d5ad84dd966bcf5df61a5346ed484d2e,988307,2020-09-28 20:30:51 UTC,23085964,23068763,false,17201,988265
4547ab5ffc1ac944a3fa279e10832a0fae9285fc688f40e74cf38a38e4ad12d9,988307,2020-09-28 20:30:51 UTC,35737,35511,false,226,0
7bfa62a150bb3053b5f6b29121ffba34195b1f94c7dc142ca474bdbe80e33953,988305,2020-09-28 20:26:48 UTC,206328221,206324342,false,3879,0
c6f990a5823055771a716ffde9ce1da09027a3bdd24eeeeae0bd38455cdda102,988305,2020-09-28 20:26:48 UTC,2539017525,2539013785,false,3740,0
5d84eff884c4c216c9607f98b9f945302accf5feb0a1a88e59c199b10372544c,988305,2020-09-28 20:26:48 UTC,76683355680,76683353587,false,2093,988294
d90b50651a9c7ff9f094963c474c7275d74cc9399c35aab3d2fcdf0f59727f76,988305,2020-09-28 20:26:48 UTC,50870149,50867719,false,2430,0
41e117c0b1a75cbc117237538c7ab470fed71972d01e57b5751c8189e71cba78,988305,2020-09-28 20:26:48 UTC,78765481,78756936,false,8545,0
f3c75034f8c9a78c8ea5bbcbdf20ac95d1bef875aaa745a435efeb4924f0ccfd,988303,2020-09-28 20:24:30 UTC,79250516831,79250514447,false,2384,988291
1b20c0fadf372601c8895689f950bc2e35550f2dfdfc42ce8aa318a3aee96023,988300,2020-09-28 20:23:22 UTC,18356671262,18356661262,false,10000,0
41a5c7d094a3ce5fcaf2b74d0a23acb76a4a361aa3a29eeac15035449d892c09,988300,2020-09-28 20:23:22 UTC,5212035900,5212033980,false,1920,0
d0af14ecd73e8ec0b2a09404430274a41f54b3682aa40b327d95df8f64c5353d,988300,2020-09-28 20:23:22 UTC,78797356,78788811,false,8545,0
beefd4b9f52a1c4ebdc28d97a0cf195b35d4a8962617d0c23c335fc5590d255d,988299,2020-09-28 20:22:19 UTC,84462554824,84462552731,false,2093,988286
ff4c2d252d5483a68b507b2ca2ed8fca8df3de0a4273a15c74d92521ee3f3980,988298,2020-09-28 20:22:16 UTC,3763706,3760746,false,2960,0
b9b04738e3779e6a65f95d902410abf93cd27cb0b95b057ec4fc67997a43d9a3,988298,2020-09-28 20:22:16 UTC,1276079481,1276073481,false,6000,0
907ef480a9666713109f7cef20fe7b7ec54a73b7117536538e821eee8e78d3b0,988297,2020-09-28 20:22:05 UTC,46108905797,46108890217,false,15580,0
5690e6425f797517029f33f57fd925a5aa62dfd7ac246b3e36102a905eef64ed,988297,2020-09-28 20:22:05 UTC,18966758294,18966748294,false,10000,0
3bbfba71eac3513cb2694fe4e208b04a025308113d11b7bd4d4f91531a175934,988297,2020-09-28 20:22:05 UTC,24020,13220,false,10800,0
2297d9135d9d760734cb21a59967b45e2b464da6a1d108349332cc69a41c4bf1,988296,2020-09-28 20:21:07 UTC,968943347,968939989,false,3358,988284
b1f49408ff4f49a75a7b9caf0bef4740ebcaaf915b84f99a185558693b8768b7,988296,2020-09-28 20:21:07 UTC,996679321,996610961,false,68360,0
66d4f1cf11d730ed6a12e18b7fc628217599d040ac5e8f1dc97e9db228c0d65c,988296,2020-09-28 20:21:07 UTC,18966768294,18966758294,false,10000,0
aaae6128dc131fce5137c68a559015dc607640614f18d00c5be1f049ee48716d,988296,2020-09-28 20:21:07 UTC,23814950,23793973,false,20977,988284
44fd6465e1d7a44583fb529667e58ef74ece21c3820d4987b2518270fdd1c6f5,988294,2020-09-28 20:19:48 UTC,26000677561,26000646046,false,31515,0
7096c2a53c1614b9103c86a4e2d74b1e6b9026ec75a1c6346ea31d5ac5238135,988294,2020-09-28 20:19:48 UTC,866690874,866680874,false,10000,0
5f4a24db23182bb53ec92b350a7d245e75a366d62736ddf8931f00289ec6a20a,988292,2020-09-28 20:18:37 UTC,50580421,50579421,false,1000,0
6a329b69f82146aa5a659f6c587938ef93b6a9fa07a15578d543db3055c050bd,988292,2020-09-28 20:18:37 UTC,499982960,499972960,false,10000,0
60fe94984ce7148e153dbffdc523cf2c99a287ed4fadad3ed77f98f1f1f8480c,988292,2020-09-28 20:18:37 UTC,79070494,79061949,false,8545,0
5582243a9eb22b47b7cc18f36f4491c59d5d059deba66f028cb0c541278b923e,988292,2020-09-28 20:18:37 UTC,77719498000,77719398000,false,100000,0
99e4da562079f221060195eb4e068452e042824d1ce0352e79c5a2c5fbc27569,988291,2020-09-28 20:17:03 UTC,1009500000,1009498080,false,1920,0
dbfc93539ac385c8e684dc883ca72e828511af08735706c0db454ff47533a95c,988291,2020-09-28 20:17:03 UTC,499196090,499190870,false,5220,0
f489e3134b0e8b04e1ae54899c95b598e019c3e4b32666d565359a7f6a9dc40f,988291,2020-09-28 20:17:03 UTC,85039527096,85039525003,false,2093,988279
a911df04b6f7fc120104902ae295b5d2491364bb1808ba84d0b0bd02823140cb,988289,2020-09-28 20:14:40 UTC,208791785,208788825,false,2960,0
c156eb69fbae81caa0e6eff3216a39b11b37f5745f7aac73d545829a667cb8ec,988289,2020-09-28 20:14:40 UTC,1019315255,1019307435,false,7820,0
300f5539274b4c2a677dc77551f1b080b619a0b09536bd4bdfd048cec82ff97b,988289,2020-09-28 20:14:40 UTC,218277,215827,false,2450,0
1ce2f880279dd4c240ab24b3e537794ab85fb1b478202bc23d6cf814001829dc,988288,2020-09-28 20:11:59 UTC,499992960,499982960,false,10000,0
3c01419ae09a9d66f0a547b4327851b89afe7fe840a98d78164378a91de34166,988287,2020-09-28 20:10:56 UTC,94798977033,94798974649,false,2384,988276
29652291d5f4fff2404f2730b85106be86c2ff2a6c659fed063bfa49d55da9e5,988287,2020-09-28 20:10:56 UTC,24661148,24637308,false,23840,988276
16cd5fae33aca6e004523fd6bf0e98e68883675301f80ba56bab01698b93f268,988287,2020-09-28 20:10:56 UTC,500064724,500054724,false,10000,0
45e09d5d0107b0caf04d7f0554ab1f4197ee193b7dd9e4c7ec1c61bb6a260e3f,988287,2020-09-28 20:10:56 UTC,1299298900,1299296980,false,1920,0
fc4ce0b524fca26968b80d5c55f2fcec02ecfa66e0acc98e9451cee0949c9b36,988286,2020-09-28 20:09:11 UTC,500002960,499992960,false,10000,0
395e5f520d2780defcaddc99c34f0daa8024af3d6b847d3131c88c34d0525000,988284,2020-09-28 20:07:47 UTC,79415812,79407267,false,8545,0
9f772e4d89982440c0676968a43a28a4ae653c1ea83ac9a749882356363873fb,988282,2020-09-28 20:06:53 UTC,106373828,106371735,false,2093,988270
6afaf35a2ac64477f2bcebf577c5fce6b848e9e51d8e4a1c8615a9e437d2e1c4,988282,2020-09-28 20:06:53 UTC,62825913,62816593,false,9320,0
8acb3130603fe8719ed19c6eeafbb48b0a7c9377faeb6cbdf40161ee2f7cc986,988282,2020-09-28 20:06:53 UTC,79466818,79458273,false,8545,0
d068cacc011e5a9a4441c78f66a1427ff99acd4abc289455c123457a6d7d60bb,988282,2020-09-28 20:06:53 UTC,500074724,500064724,false,10000,0
a5f4159e29877bceb13074de74a3bd3a350948376a1bda6da707e54ebd876972,988282,2020-09-28 20:06:53 UTC,2000389198,2000379198,false,10000,0
5c562263bbd11d984c5f508fd559903d00a1e2e85418f4316468b93b69cf10d2,988282,2020-09-28 20:06:53 UTC,3000195984,3000185984,false,10000,0
d2aa8739c1d1bdfb481ec666e218291bfe65678344fcf78511c0446fc9e8757b,988282,2020-09-28 20:06:53 UTC,96100979126,96100977033,false,2093,988271
8d71f48eb2efd3dbb772ae3f72b65efd8a6fcaaa72445d1e496510b2f13e2775,988282,2020-09-28 20:06:53 UTC,10000,,false,10000,0
eb0a7bb8c77bff5460ee28e5cc63a097cde7ea88b617b2e5f7a6b5b03e9680b6,988282,2020-09-28 20:06:53 UTC,1500151803,1500141803,false,10000,0
00c74d343205408cf81d3c90425a0f716281024be171d47f4131d341840cc73d,988281,2020-09-28 20:04:48 UTC,4500379781,4500369781,false,10000,0
2c925eb49c1373e1f8bee83fc9ef323cc7671ca3162be632942964165fe232ac,988281,2020-09-28 20:04:48 UTC,236344504912,236344494912,false,10000,0
2a5779ec639138a2fe88ab17cd5b0ee872d69ee7fb839fcb50bc98c52596c010,988280,2020-09-28 20:04:19 UTC,8000000000,7999993000,false,7000,0
49352a296b36948ba8cd4d8a4e395a17bcb0f390c76f4fcce6396ac8fd938479,988280,2020-09-28 20:04:19 UTC,8112323,8108000,false,4323,988262
2bbfd7b54b587bc19b2ae38a0632edbec1a88ce770d9302247bd1491b90adbad,988277,2020-09-28 20:03:16 UTC,234362422,234358849,false,3573,0
4179d76e8ce4d527c60e007fccc9e9b7f6e6e9745ea1f4b9255abf272a62b065,988274,2020-09-28 20:01:48 UTC,147766975,147764301,false,2674,988201
e6399420f08bfbb173d16eabd28c63123cd0b4a8aa8387fc8a99053816d7cb1f,988274,2020-09-28 20:01:48 UTC,284073953,284005593,false,68360,0
4c7de28801b287a5cb64685c33b9cb59ca41ad59f0623ef7b58b8345a08f477a,988274,2020-09-28 20:01:48 UTC,79517525,79508980,false,8545,0
5fd3c7425a9e8232154d23b3bce9fda244a6993f64def904c24124c287f14ade,988274,2020-09-28 20:01:48 UTC,26221510,26202857,false,18653,988263
b7af7cd2472746c7ac235c01ef37310bca7fd0a32aa3e5f9ca04fce4fffc5e0f,988274,2020-09-28 20:01:48 UTC,8754474318,8754274318,false,200000,0
b0503ba0f5938c1e122ae62f06392abc91a25fd493af308470ab474d7a9657c6,988274,2020-09-28 20:01:48 UTC,669520027,669517361,false,2666,988263
4a77e65a4c6531a16628127b074b37a862e53705781179c78434001f0ae1ed45,988274,2020-09-28 20:01:48 UTC,128997280,128995744,false,1536,0
ddc751c8f00126b9389f2802a2e26711494acee262860bfcddc9c840164faad4,988274,2020-09-28 20:01:48 UTC,121647360,121636220,false,11140,0
b092ca363f72e86fba6aa3bd9d584a42e3329d494a055699645d7e31d2773ff9,988273,2020-09-28 19:59:11 UTC,774780811,774751434,false,29377,988262
e3c5ccdaaf2681f33421cb2c5f29cf157e8f9f65c58a80327aefa82f70dba087,988273,2020-09-28 19:59:11 UTC,206558785,206555825,false,2960,0
5ab1ccab94206c08cd074302300ca3af4a3a82cf6e53c33fcb90c32f1d121af1,988272,2020-09-28 19:58:07 UTC,79572639,79564094,false,8545,0
043ecc05d6eb4b9894ce8604bb17eef3ccd607fa22a07d5240d14d2d2b3cbdbf,988272,2020-09-28 19:58:07 UTC,3920405,3917445,false,2960,0
e9d67eb64ea9accc6cf3ae7eb435cee2852e8e973ca8091329a9c6fa61eb7957,988272,2020-09-28 19:58:07 UTC,104801941799,104801939706,false,2093,988261
adb4e1573815b7e9ddd4d7a8e527b03dab27aa4c2f4024ac252d3bff59f369bf,988272,2020-09-28 19:58:07 UTC,54343982333,54343882333,false,100000,988261
31b34ba54ec3b416153dc46be6797f4a6fc2a3c938832d1bc871923725120fde,988272,2020-09-28 19:58:07 UTC,129000000,128997280,false,2720,0
440cca827cbe19e1096bf34583e127fd6730af93f714f72de4e3efaa8b169603,988271,2020-09-28 19:54:38 UTC,10000,,false,10000,0
0f383021a4c867230a557d86f03700d087fb3f62cd717bf182d2666befd20011,988270,2020-09-28 19:54:16 UTC,10680020704,10679990704,false,30000,0
36ec8f598b091e9b0d2465405298e92ac498792d7c78c509836ae71c004d9521,988270,2020-09-28 19:54:16 UTC,2796750,2789970,false,6780,0
584049311d08683d07f95dacfdd2872fe7f0b461c4d26c3c08e690b7c1d8ff08,988270,2020-09-28 19:54:16 UTC,134500944174,134500941799,false,2375,988259
0263f881bd4f15226ce42117c5b087e90925a4e0ef3afd2efc8516608a586ecf,988270,2020-09-28 19:54:16 UTC,79947179,79938634,false,8545,0
15f4be2e6a5759ed32a21c9a2a77892c49b48085660f0752c186614aba987a19,988270,2020-09-28 19:54:16 UTC,79720357,79711812,false,8545,0
82a48ac5225838ba74297ccc80489a2326872219f99ceb978e2ee8b9e1570a3d,988270,2020-09-28 19:54:16 UTC,234521623,234518663,false,2960,0
fd49a34f0e359ad1fc849cc36a8aa557fbded1342f50f483568aad439f1c0601,988270,2020-09-28 19:54:16 UTC,209015470,209012203,false,3267,0
cc6d69b52e66138b09175c74abb6c6d627d15a68379e15182f110506430fdc86,988269,2020-09-28 19:51:46 UTC,143100,133100,false,10000,0
18af1b5ab95799aa5aee5801d518aa67e8a3548b98091d15ed209f3d6e02c361,988269,2020-09-28 19:51:46 UTC,27227982,27200339,false,27643,988258
6cd410705db8674b1f2fa95666ca57012ec4a0f34f553f898d498e71b8fb28f8,988268,2020-09-28 19:48:37 UTC,206866642,206863682,false,2960,0
1baea06ae353739343f39da21330e31bb428d56867a1336f42e4eec2a5bc6816,988267,2020-09-28 19:46:44 UTC,1028742,1025393,false,3349,988256
64621bac430645c771383a998ef76f5861cddd6bec4b1adfd9859ec3c0a43fc2,988267,2020-09-28 19:46:44 UTC,134714232267,134714230174,false,2093,988256
93115030cc418bfb21ded0ede32177340a3eafe80d22eb6eeff32846dd2ebd13,988267,2020-09-28 19:46:44 UTC,62959006,62949006,false,10000,0
505bec4a1342b89efbdac65ddd2bee8eff98e65c3d7bc760d3e600ca0daab6df,988266,2020-09-28 19:43:24 UTC,856117681,856049321,false,68360,0
0fee1d92f5f9d6f086195b7b679ff0baa4786cdbd33582256f51041074fbbb75,988265,2020-09-28 19:42:59 UTC,32134562,32131204,false,3358,988254
47f81fbfcf572d6e869342de6c2aeaf22c54ffa886b24044230d62ec64d7fd53,988265,2020-09-28 19:42:59 UTC,58440,55990,false,2450,0
4896347e418c065be045fa891f096dc2df57d8b41819367326c89a0272226950,988264,2020-09-28 19:41:45 UTC,4204074,4201114,false,2960,0
99e7ebc59bd8775b2296cc71674242218af1a76d9ffa186da33632b2a8c6cb63,988264,2020-09-28 19:41:45 UTC,84848508126,84848505776,false,2350,0
b3c1e4451576d7b9212a99d31b4dac3952292e8a58e4c7d9515dc5b543858176,988264,2020-09-28 19:41:45 UTC,1248074259,1248064259,false,10000,0
96857a517f19cde0ca920b63eba059a4a35cdf04f6ac5d57677bcdb1cc9df7b1,988264,2020-09-28 19:41:45 UTC,72482,69572,false,2910,0
46d2b0547a07c5e1e6fe86d78b06a0b8df6ee8e995508f4257c53f1b56db4b14,988264,2020-09-28 19:41:45 UTC,79985544,79976999,false,8545,0
c3762e753f40f67182c9f1e5a0d5a58b371e53fc8d01c6f092eda3df4cc3bc71,988264,2020-09-28 19:41:45 UTC,250,,false,250,0
7e5b7634e1b84f3a424aeb78fb030dbebb09d2a06f3e004b898d15afc69c3ed9,988264,2020-09-28 19:41:45 UTC,147338820,147336736,false,2084,988253
44ae1680d8c5685cd2f07e54b1f1bf72ef21cf2d31ece8e4eac8bf6665e70fb7,988264,2020-09-28 19:41:45 UTC,599664000,599658432,false,5568,0
a77b4dc914461d3af2eb35d79da03d0f39fda7cae22e9547170da84dc01b71d1,988264,2020-09-28 19:41:45 UTC,1500049604,1500039604,false,10000,0
bb17481fbf1c1a4f6ad4f334c61fb5597383030b1ee6a287a99532ea867320bd,988264,2020-09-28 19:41:45 UTC,27960061,27942006,false,18055,988164
1086f35448607c5b454d2d297b4c824f8ddc4ae530f649b89bf33445fae62ef9,988264,2020-09-28 19:41:45 UTC,209448379,209444500,false,3879,0
6e22609e4222a01879c25c575d00b218a0430a1505d42db177b489491a7e5bd5,988262,2020-09-28 19:36:02 UTC,200318021,200315571,false,2450,0
4fc0ca2de31625ec17960fb32ea4067f7ea5c15cbac02b15d07ff502b23635fc,988261,2020-09-28 19:35:14 UTC,118103600,117000000,false,1103600,988248
9643b0ac0e9f3c426ac16cd416c6009190f7bd8a509a4e9df17e73fd40dbfba7,988259,2020-09-28 19:34:53 UTC,190512994232,190512984232,false,10000,0
c14164382f0ee8633e35a9c70fda70166b9d76ceccb9e5f4ce80741b8e6cbcb4,988259,2020-09-28 19:34:53 UTC,100000000,99997570,false,2430,0
f5fc28fa8e77c01812eb25a82495af1a8570e15d4b69b3def857b0c8d6ed4120,988259,2020-09-28 19:34:53 UTC,5250905600,5250902200,false,3400,0
7e7cc91d6b46b1150a9fbad27ad37240ab7fc4e7eb829010705d82662fdd627b,988259,2020-09-28 19:34:53 UTC,5200000000,5199997907,false,2093,988247
d24699d0fe0292fc659bd70a13b23bebae6f2823899fafa352a4f68c1674d8d2,988259,2020-09-28 19:34:53 UTC,234678678,234675718,false,2960,0
5b7494ba9c46e358522ee92e1ddb87241e3cc8cd998333e29c1f067402b141d2,988259,2020-09-28 19:34:53 UTC,10000,,false,10000,0
28ae92e4372c9c4b97acbb25c66e1cc8c23904c69480ea8a94dc446930ed9d93,988259,2020-09-28 19:34:53 UTC,80103474,80094929,false,8545,0
c93750b5b93e6e516a7043635eb368eb10234e8939217780d57c1a71fcc4564e,988259,2020-09-28 19:34:53 UTC,100000000,99997570,false,2430,0
26a0bd3b886dfc60d3703afa129dc1d70bfbb15bcc79fdbfdb9f40e78b6acf8f,988259,2020-09-28 19:34:53 UTC,133716469,133704469,false,12000,0
55b4a5875429a680228c2fa355a7be42ceefe4ac0957a14098de5dfedcd779f6,988259,2020-09-28 19:34:53 UTC,53241622,53223622,false,18000,0
d423aa45568a6cc88e7d083c60fab3ed207da5a0480b87cb029ce145fb6aee5a,988256,2020-09-28 19:31:10 UTC,28867364,28844660,false,22704,988245
196217ca7cd7e8b33e7d7822c01a371aafc64690199b1e7c66d1bea028c65c0d,988256,2020-09-28 19:31:10 UTC,80152051,80143506,false,8545,0
ad0e1e1b9a78e40abd5c639d35bc47f60e3ba40e2d06ee5175a23d3b057bd622,988256,2020-09-28 19:31:10 UTC,207053888,207050928,false,2960,0
a0843726308e540d54f2bbd6a7bdc76fe107875d605d0c87a38a9c68a940a79c,988256,2020-09-28 19:31:10 UTC,207286123,207270361,false,15762,0
9af43d6c90e1f82b7bbc85cebd7a4b90a58c8fe35b2df7d816ef8eb7bde96276,988255,2020-09-28 19:28:41 UTC,3319187161,3319186485,false,676,0
89940b0a1e57ead8c2a3b4b49a047983b26e720472a70141a0c48ec49b510126,988253,2020-09-28 19:26:08 UTC,4350593,4347633,false,2960,0
3dea45729802c86f4ff1c28b5ba2ee6ec5c89d6b9e9c7e0fcd784e67e4502b61,988252,2020-09-28 19:26:06 UTC,80189472,80180927,false,8545,0
bcdbe6b7e5e58a9fd2248d69232cb674d3aec096a53909e022826fe2b5160b9d,988252,2020-09-28 19:26:06 UTC,137174234642,137174232267,false,2375,988240
9978021e7f1c7dd26ed7b37769592026e838294eb3d7ccf99d28250dfd5745af,988250,2020-09-28 19:25:18 UTC,4150476,4148026,false,2450,0
9104c683fc3d1372e9cd3bb0a50f782b88e81301bb39f563683346fab32884fc,988250,2020-09-28 19:25:18 UTC,85110890729,85110888379,false,2350,0
e8d4d01fe2eaec65f9a8e1bf1063d24fdbefc2a58589754984ba9bdc80bf7879,988249,2020-09-28 19:25:02 UTC,1772879000,1772876939,false,2061,0
8bfee93f3f38f0486fc13453ddf59cc039de66a0973a2147842657ba9404d811,988249,2020-09-28 19:25:02 UTC,47627867,47622311,false,5556,0
b343eff5b9ca8d7f6392fedb87340b2dbaec53459aa8c79958a1e96b28d2d228,988249,2020-09-28 19:25:02 UTC,143512313,143443953,false,68360,0
4dd673948b4f74fe8092cfbaa246a84c3f1a87f811d9688a7e30fe4c5feb4e62,988248,2020-09-28 19:22:56 UTC,18344944152,18344934152,false,10000,0
743864488c5cc1eaa28cf42db1910437a6e478924a2fdfb09ff6757e1f0d5428,988248,2020-09-28 19:22:56 UTC,172289287,172287203,false,2084,988237
40ab4ff723e731f66a4e06f793b7752b59ca69547bde13ac9551f7aaef95c93e,988248,2020-09-28 19:22:56 UTC,210589882,210586003,false,3879,0
4ff91ab0bbef35869304e296207791083655a9c408cb536c39e97d9f04a5dac4,988247,2020-09-28 19:21:03 UTC,54807571,54802015,false,5556,0
a1f6957cabee70a0788b636ad20e431b0a8b0a357d90cb0b8996afacd8fb29e1,988246,2020-09-28 19:20:30 UTC,396787500,396785918,false,1582,0
3fa1c45394ab8f6d7a720866b83dd8974945aaea3f797980460f06e3c9efefe7,988246,2020-09-28 19:20:30 UTC,877446967,877436967,false,10000,0
a371fde105058bc2defed4f0b4fcaee25fed912e1bfc9150941fe72a5760048e,988246,2020-09-28 19:20:30 UTC,18935187400,18935177400,false,10000,0
c021a7294b537933c5aa051fa0ac3fe5e3137c955ec8c041bf74362274bc1db3,988246,2020-09-28 19:20:30 UTC,362939719,362934839,false,4880,0
0f11b2f380a83376249d47c144d0c21a56b0c51762cd6430550e424547493af8,988246,2020-09-28 19:20:30 UTC,29633838,29609673,false,24165,988235
539b63cf651cc577a92b88e667a66f894fe8980e3458923bfb79b9237ab29fd6,988246,2020-09-28 19:20:30 UTC,147573736709,147573734642,false,2067,988151
acefb2c98aa1971c95fc4e1985a4a3e8bf203c3369e287bd5e9c9abfc2f070f1,988246,2020-09-28 19:20:30 UTC,107981974444,107981972094,false,2350,0
aee14ea25ab0f8b3b76a757afa9058d457cc7caac10519f8efa7126edbad7530,988243,2020-09-28 19:15:52 UTC,380372197,380360197,false,12000,0
47998164dd7e26a46785dbe51970da0e12699f8dd0b16a4df6df123d8fe56467,988243,2020-09-28 19:15:52 UTC,6002333162,6002320787,false,12375,0
44226f9812e49e484879b5bb6bd3dce39e905fac55c393a7efd7511d7c1d69a1,988243,2020-09-28 19:15:52 UTC,10754971629,10754941629,false,30000,0
4ccdc6879b97980e69c802bb9b8999fa86ff915fff808eb2f46283ef5c283ad4,988243,2020-09-28 19:15:52 UTC,18935197400,18935187400,false,10000,0
bdece934cc0a39e72a6c40f350a34a49b9edbd86a048ad4ebab1766fe63996b0,988242,2020-09-28 19:14:40 UTC,153576071955,153576069871,false,2084,988230
c7449d373ea342906c9d8599357f86555566cf4ab791de276658d9e8a8c64249,988241,2020-09-28 19:14:25 UTC,175865540,175859984,false,5556,0
d1f01f2da267d9aaf6faa12c7991957428c5b1fbba8fc99a09c78bcc334c5f2b,988241,2020-09-28 19:14:25 UTC,500068360,500058360,false,10000,0
41da998e185fb3aef86c037c9bc9e0f3a270d57052a516e8d7bd1e7dc02590f0,988241,2020-09-28 19:14:25 UTC,45058,43476,false,1582,0
415b2a63cc37696357f77c6673d00ca910dfa3010506cc990d997e016c073e79,988241,2020-09-28 19:14:25 UTC,234878440,234875480,false,2960,0
aa86a71ea4a9a86fec63c2afd5378bc6af4dc593d5d6e9571b502c5682c9347e,988239,2020-09-28 19:12:35 UTC,18435284509,18435274509,false,10000,0
4a1c8aa80b657983352f855a61568d4fdbde9c2e36943be34be9cbf9362783e9,988239,2020-09-28 19:12:35 UTC,10000,,false,10000,0
d6a6684ae150db10a2d8caacefb321a293b0a28e02b8628ffa00380e11d69a69,988239,2020-09-28 19:12:35 UTC,500078360,500068360,false,10000,0
ca065e67ed2ff4a0b0803a6b352f67016e9200569cb112be1dfaae482be765a3,988239,2020-09-28 19:12:35 UTC,3485798168,3485788168,false,10000,0
5ed6363dbaa6ed38c17af2982c09cdff54f70ea253b4991db8cafc822617ff83,988239,2020-09-28 19:12:35 UTC,194217074339,194217071955,false,2384,988199
ce4b2f0c3409cd565dba7b1516700dd45ecb77e5fa259785ac24e64c4d3b486d,988238,2020-09-28 19:11:38 UTC,4388757818,4388755725,false,2093,988224
e9a74b6b5903dadb98da6269d89ae854a6a6f4d446312d842328b751738efd87,988235,2020-09-28 19:11:06 UTC,497267747,497257747,false,10000,0
e1a2aab42d3b86b5cba92d4969f34b0d59cd13603a345712a46df324d5c29347,988235,2020-09-28 19:11:06 UTC,180021572,180016016,false,5556,0
4fe55a50f4b4a8c5f3195248be433b728584cdd18be0cbecbc2f264cf75301b0,988234,2020-09-28 19:10:22 UTC,30494109,30471388,false,22721,988221
ee81de8977f4422a87b32526323795d375d0403eb67034bc0eca8848ff41169c,988231,2020-09-28 19:08:07 UTC,207217911,207214951,false,2960,0
6e93246763f0b450b5f64f78b25423509766122318f5f7bd2a48d28f23742802,988231,2020-09-28 19:08:07 UTC,63149020,63146590,false,2430,0
c3ee037c9b14b3d17459ba014871fb10a95600a4656aa75af8f5463d625edc2f,988231,2020-09-28 19:08:07 UTC,500053220,500043220,false,10000,0
ad3f5c53a25c6694cdb5dae33dae8fe60fd0246586961aac7687d80093f45867,988231,2020-09-28 19:08:07 UTC,713821797,713753437,false,68360,0
3d1328bf3f991fe44a769542deb817571129a1626cf8a5c9e0a768d1ea8d2932,988230,2020-09-28 19:05:51 UTC,10000,,false,10000,0
27f0629046b7e022a474d5edcee34b26df5d5cdb4c1b5ab1a1e632dba9884cee,988230,2020-09-28 19:05:51 UTC,435258437,435248437,false,10000,0
e9754ffa0446b71dcaeac8da6a021be68c533199f3012018604980cb0967bff7,988230,2020-09-28 19:05:51 UTC,100000000,99997570,false,2430,0
e448b9af830fb481903a9d7b28a1df5d399dac9e904e6499e5f7d43e5af5e5aa,988230,2020-09-28 19:05:51 UTC,1000577127,1000567127,false,10000,0
41f21f64c56891568ac09f5b51c35d826a09dc5bdeaee3641558f6eb8e20284a,988229,2020-09-28 19:05:08 UTC,3485808168,3485798168,false,10000,0
e66be700df7c8ffd70fb532c693703dc37514738beee56cc78dcb02eec78282e,988229,2020-09-28 19:05:08 UTC,10000,,false,10000,0
df012e5524b3581b16031687eef21effe88a8bc5d55c859c50bc74a251b2c65e,988229,2020-09-28 19:05:08 UTC,358932455,358881695,false,50760,0
081a1ce399989bd5788a7272069c354ba6587ec93585ca57e97d11fd3788bec0,988229,2020-09-28 19:05:08 UTC,335071225,335064525,false,6700,0
f059e465ba805e209c7818f01bcb1b9fabe00b1e18a544c702e8de6b3b0cd811,988228,2020-09-28 19:04:42 UTC,2000162966,2000152966,false,10000,0
93f53fa320120bcdcd5be9905c36a2a7f16da68b59b40f34fff502767e15d2b8,988227,2020-09-28 19:04:34 UTC,2000399198,2000389198,false,10000,0
53a15569b037d68ec5ac02569ac0054713b7635028534d3355349c06be76d097,988227,2020-09-28 19:04:34 UTC,31810,21810,false,10000,0
5ff0a9ee26684a0bd5c5dcf5f78d51b23b9b7b5b997ddf2cb7266dedd92e8e0d,988227,2020-09-28 19:04:34 UTC,234481394036,234481384036,false,10000,0
1f83b2b64233326a5a1b979e531b77d1f0e12d8019c4fa059cfd96b60041b28f,988227,2020-09-28 19:04:34 UTC,10000,,false,10000,0
772a525b54dfaf15b559acf22f95ce7822de01064d8e8678343da563684317e0,988227,2020-09-28 19:04:34 UTC,195740850405,195740848039,false,2366,988216
55c33b1acb83dd0064914dc27e8e5a31b0ace19892e56760a662370977ed9693,988225,2020-09-28 19:03:16 UTC,80224294,80215749,false,8545,0
1e104b3a7969ccf3fcf3cacc2a8d49243b7c0ad3f1ebad57acf7b20be07fcfe1,988225,2020-09-28 19:03:16 UTC,10000,,false,10000,0
0c87ebe41e4bb6dc51bb13601fc5b52eec101f33954e537648f40d1a7c245ba7,988225,2020-09-28 19:03:16 UTC,106514,96514,false,10000,0
cb72f504db2b088e7b162087daf3faac0266b6a49d25d49097692cdeed034d50,988225,2020-09-28 19:03:16 UTC,193154895,193152811,false,2084,988214
465ea78b7ba18d3ab9b602864974383ee4e1b7fc058d986e065766700e58e58b,988224,2020-09-28 19:01:20 UTC,154500000000,154490000000,false,10000000,0
e514f052e9a899bbbf87504307b4d31e70d76b77f2bfde71ad79003deb145a7e,988224,2020-09-28 19:01:20 UTC,438434841,438431483,false,3358,988213
d89383dd87aa493065f23bd63b00463bb9e3c5e40d88cdc0983a46f9d0040fc8,988224,2020-09-28 19:01:20 UTC,500000000,499990000,false,10000,0
c69f512cd79fdfa1cc9754b0a683ac8175995793e20e6db1dcf667f2b7fbfb64,988224,2020-09-28 19:01:20 UTC,59651919355,59651903775,false,15580,0
bfc1c5f7604abdadda6bacd8aa00e9f744ef7a0b6186dc2afb8a1ba800b0cfde,988224,2020-09-28 19:01:20 UTC,10000,,false,10000,0
1e78f7a913d14c581389d427b81c20dd71b05d528771a23a3a7e9d2f29a3c2d6,988224,2020-09-28 19:01:20 UTC,225846431,225842885,false,3546,988213
830826194384adcc94306a7f61eb5bc00053a359e56aa4d0db9b4f4494d33cef,988224,2020-09-28 19:01:20 UTC,6500266542,6500263005,false,3537,988213
833e7754e36617908f27ed1cf6b4b9615d51b02d1f357aa7512d81834189dd8a,988224,2020-09-28 19:01:20 UTC,32318283,32297887,false,20396,988213
3e656cb0d7ccb56385a6a2780058089a226728ed70449cca554bf4277323f932,988224,2020-09-28 19:01:20 UTC,4645708,4642748,false,2960,0
62ae3df45e0b9a3d7d6685d7062e06a5fb433024e020c68750dd4072b6d153f7,988220,2020-09-28 18:59:29 UTC,80404938,80396393,false,8545,0
3fd1f7f1fe1fa34f755f54c66910072a2c82e638cb789002c0dc500ee9b0012a,988220,2020-09-28 18:59:29 UTC,665579205,665577112,false,2093,988208
823e8f230d483ba2d7f4a06f933b24da9e02c9a5346125ff5e6298ccd0faff4a,988220,2020-09-28 18:59:29 UTC,80290886,80282341,false,8545,0
4cf40937ec711649ec5aa36d538cc392fc3e05602b1a3512c1da5eb4a30af77d,988220,2020-09-28 18:59:29 UTC,80342196,80333651,false,8545,0
ccd762ca55b5bd3e79d09731f0b6f6f377532c45bf6c083811ce63f439d8dd38,988219,2020-09-28 18:58:44 UTC,210784169,210781209,false,2960,0
94c0368fa6f0c3afaf72197e73d1732cee49a549f3ab4e6ea9bca625e713f0d8,988219,2020-09-28 18:58:44 UTC,6725065677,6725063227,false,2450,0
a66285929d2dff57b9692ae7975a7c16b78a1205eb0e2942722e34f1e169aee3,988219,2020-09-28 18:58:44 UTC,4800000000,4799997550,false,2450,0
e2116ae56b07d2dff5af99a55097acb0c415495a1e82ce5c1a01b2de336e08cc,988219,2020-09-28 18:58:44 UTC,235043046,235040086,false,2960,0
0df0ed93fc4057825bed109a46061b01e37311bff78e493beccd82c9bb1c5a26,988219,2020-09-28 18:58:44 UTC,80446293,80437748,false,8545,0
d513a564049438e0102acbd19784a40224fe0465a029d72181e386502a96040d,988219,2020-09-28 18:58:44 UTC,30010900,30009754,false,1146,0
b502b9b0eb1a0eff4645e0efe59f7856ee056762ec6e0f8c78230154ea8649d3,988219,2020-09-28 18:58:44 UTC,207368064,207365104,false,2960,0
d28e84337e1b5985781104cee55959cf8434f03af835f4cd93c00e5bda2e4b02,988219,2020-09-28 18:58:44 UTC,212413923,212411839,false,2084,988208
346c6accf900eb451389400e40ad40a47714593bbac1c549c0d7da8b90baa128,988219,2020-09-28 18:58:44 UTC,408508013,408500878,false,7135,988208
001793b3a325660dca06d1c70c2b3d361f03c9611415d99f77daaa8c45fcaeb3,988219,2020-09-28 18:58:44 UTC,97614371,97611921,false,2450,0
9a175ec793a042217c209c1e1dee98fda4d6d08846fbae7ba22fc163782fbcf0,988219,2020-09-28 18:58:44 UTC,1045418898,1045412898,false,6000,0
571447840f72f21c768b1510d588147c44097762d1872f04c9fa3b6ab5351b86,988219,2020-09-28 18:58:44 UTC,80722941,80714396,false,8545,0
3fb8d565f1627a4766bda109f51bce5ab00b94a09b6b42192085e011ffcf5956,988219,2020-09-28 18:58:44 UTC,80675492,80666947,false,8545,0
49ec941dcfecc48062c2abd03cc5c1c4b8ca1728407ec3903640ff1c26628874,988218,2020-09-28 18:51:25 UTC,4978874,4975914,false,2960,0
5b438746b807f1c056a4252cc52224826b449f93d5dd3449abed0bed468562b2,988218,2020-09-28 18:51:25 UTC,4042631117,4042628857,false,2260,0
36514ea93a8b949e90170a44910d2d8a963da1668f0e1ae7d9f864aba32a7e42,988217,2020-09-28 18:51:18 UTC,500000000,499990000,false,10000,0
0b9c109222848ee0141a49d52b59e51bb7fcc846dd045d96edc372c8ff1680f1,988217,2020-09-28 18:51:18 UTC,21500816,21467816,false,33000,0
04504ee3d83be4806543a48e8a9b6db6d4643bdb6e9918d89075224411e34bd4,988217,2020-09-28 18:51:18 UTC,33471279,33445072,false,26207,988206
736774a89059886172fb42ebfe3a133589e4f35f86d57b070f62fa59e24188a0,988216,2020-09-28 18:49:34 UTC,1022197068,1022128708,false,68360,0
ad5733b93fb881219bea7d5512f423444fb1e684b89905c0f8d185e8aa140091,988216,2020-09-28 18:49:34 UTC,170150,143070,false,27080,0
bccfa8299e816c4a461bbb57a069f091d865c81f1f2f50785ad38d4ebeac3f89,988216,2020-09-28 18:49:34 UTC,30459446,30379046,false,80400,988215
b0f8850daae4929d5aeadd1dec5cab6f7821f55a30d61c20c8791aad5f4dba9e,988216,2020-09-28 18:49:34 UTC,207628140,207622584,false,5556,0
e0f3577d026414821802227309cb4f3e75f3083b481965a96afc4a672bd9a56a,988216,2020-09-28 18:49:34 UTC,108504,98504,false,10000,0
752dd64be9751e3dc68b118f0b56fb828311f424e1382f5400aa4378d77ad371,988216,2020-09-28 18:49:34 UTC,207516547,207513587,false,2960,0
c5b157c70cc61538752bfd23dc75dc9c08f99d81bda087dd94b0cffa9c0e9284,988216,2020-09-28 18:49:34 UTC,75992667,75903427,false,89240,0
989ccdcd47408c9c7637d2923c7a6bb6c786573fe77c7061a4c37cbfe4fb26ed,988215,2020-09-28 18:45:15 UTC,995239932,995229932,false,10000,0
73ba5228921b617ce30ef489bb93ad9037696c4de487085f60e2eaf40c290573,988215,2020-09-28 18:45:15 UTC,34260,24260,false,10000,0
3de4cdc8a7116dafd40a4ac69a7affe7c5c708387eb921210b98d91a3943c936,988214,2020-09-28 18:44:04 UTC,8960,7040,false,1920,0
82cd6df26c55b2ef60221eea40c8218624cad15246e8b4859959750a0a17dd89,988214,2020-09-28 18:44:04 UTC,210932029,210929069,false,2960,0
1b38e8e5445160402e334868bf6a90cfc4596b8e3d3818ffb8f08c53c36ae55a,988213,2020-09-28 18:43:41 UTC,80793902,80785357,false,8545,0
11812573f1208200447fbeb38b8e4debe1c91e4739b1473e9bb250502831cb6b,988213,2020-09-28 18:43:41 UTC,938160,893320,false,44840,0
b697112becb9f2259c6e665f2e0ccc9585d6d3f1dcaa4c9cd79f8b7ca7132bee,988213,2020-09-28 18:43:41 UTC,62804098305,62804005765,false,92540,0
03510c2cf15155304a0987e74151287a95494c6ea2c68d192b0a6429c1e28a0a,988213,2020-09-28 18:43:41 UTC,34611178,34584390,false,26788,988201
91855661e73e7d21d783d06f6bc5a007ecd322d3c47afb8e1921d5c7de6ccfd1,988213,2020-09-28 18:43:41 UTC,2844491,2841133,false,3358,988202
3d82dc7a45d87951b5203d23b6c7172297726ff152a61069c268787bec092c11,988212,2020-09-28 18:39:38 UTC,375000000,374997062,false,2938,0
1ab61bec9bda9348a7b3e6995c73c24fe63a789584c5248a9ec0ca300c381a12,988212,2020-09-28 18:39:38 UTC,3966195927,3966186267,false,9660,0
73bf78d470457436d1bf16b2730e717e28c28ecff206226498f41e13b1d70238,988211,2020-09-28 18:39:21 UTC,573229797,573161437,false,68360,0
0d760cdb85fbddd5523d77452826823e723dd59192fa03b1eb08e934f493d807,988211,2020-09-28 18:39:21 UTC,3997185,3995101,false,2084,988200
fdacabcdbf113436586cca3cb96fbd957aa6612b65379836f0c21d48bb19988a,988211,2020-09-28 18:39:21 UTC,198350133498,198350131405,false,2093,988116
36f519a2c862ff9535977a0366fe0050acdc80543639806311d63c639103c351,988211,2020-09-28 18:39:21 UTC,137373144,137363779,false,9365,988133
286266be68f78b7dd9e9d28250a266eec5e152d11243b054754dab9bcbb72337,988211,2020-09-28 18:39:21 UTC,2539338795,2539330955,false,7840,0
f18761f5bdf9b4dc8a5fcd4880b2a45b363d3e1a6d72b725158b07cbe8a11047,988211,2020-09-28 18:39:21 UTC,235223712,235220752,false,2960,0
854c892565c35d8b95747822caf930e58f191bee9ca6e26b6a93edd814ad3c11,988211,2020-09-28 18:39:21 UTC,6691699878,6691689878,false,10000,0
b90d15d9542b418ad2ecc3dcd4479ace343f81a7dfafb69a27e621131e989f70,988211,2020-09-28 18:39:21 UTC,17973664000,17973654000,false,10000,0
92842d92bd06d5ac5905d749b157a7ca2b8f51698be1a3afcf9cc4cbdedf2fec,988211,2020-09-28 18:39:21 UTC,3890390689,3890388429,false,2260,0
9ee76e472803780fb10b4adbe49d2abd692889ebcd4104e290a85097ecb1889b,988211,2020-09-28 18:39:21 UTC,49840,43480,false,6360,0
050334c0082f6a368c081aa357fdf195fd2a6df59b4fceb23db212348ebbb6d3,988211,2020-09-28 18:39:21 UTC,81023284,81014739,false,8545,0
b8d89a42d6ca8c2e653db8a20b8261a6224768de7646f8097bcbd136c680039a,988211,2020-09-28 18:39:21 UTC,1342813,1339464,false,3349,988200
65cc81348c8eed9178cdd26ced5f9e4036eacc557b47572ba24935d7143d4031,988211,2020-09-28 18:39:21 UTC,50251697,50178397,false,73300,0
4bacc46c625f9489d498900d431f9b6d7815443628ad467e5dc642cbb83f946a,988211,2020-09-28 18:39:21 UTC,399456,291456,false,108000,0
1e0f571d375ecb0cdcf5ce57cc3f523f70e16df8e957daa1411cb14db983181e,988211,2020-09-28 18:39:21 UTC,9173728,9163728,false,10000,0
e903f37a63c663122b9b8247ae2a31193462073afc3526fd1bc58f3a11590696,988211,2020-09-28 18:39:21 UTC,125226802,125164219,false,62583,988200
ba69db7d8abfae09aec77bec7d3c33ce872f651972dfec06a11024225d08f5a7,988210,2020-09-28 18:31:34 UTC,5134456,5131496,false,2960,0
d1d1738edb87f2ae09c4125b1c95cca60d5ecbd32869b3b39dc7c14542d063f7,988210,2020-09-28 18:31:34 UTC,968922437,968920344,false,2093,988199
978097fc8fb24945322f4665024b2f4be84d966023b5a7200289dc9211bc2feb,988209,2020-09-28 18:30:42 UTC,112710997279,112710994929,false,2350,0
01b027dda4643b2dd93bcd581f15092200fa23597d25ae9c5276b0b745c29598,988209,2020-09-28 18:30:42 UTC,15520830,15516216,false,4614,988198
07a1dbe94bbd44dcb24fe2cf0254f5bacd799ec47abe5a1de2044c4610cc3d24,988209,2020-09-28 18:30:42 UTC,35589963,35564064,false,25899,988197
c8f4c92779e13693c490b3935369d281cb9e0df66a65f3fb313ea77941b4befb,988209,2020-09-28 18:30:42 UTC,435276437,435266437,false,10000,0
a9e90921ae8837c2d400fabdfee78da2cbd200efcc86469ceb82c08debb694a5,988209,2020-09-28 18:30:42 UTC,394408805,394398805,false,10000,0
d49c9a76f624b18021bae325a32c2589d523dd35e3d89af6305bebd98c13c607,988207,2020-09-28 18:29:49 UTC,18435294509,18435284509,false,10000,0
7bd99fa221beba23e48824a1dc3041b082989ded6e06f176192da9468ae1a60c,988207,2020-09-28 18:29:49 UTC,1099961700,1099955700,false,6000,0
12fe4923ebca643eba0344f66a84334c03b2715b30b85a96f774ef9956e8bd77,988207,2020-09-28 18:29:49 UTC,34516939,34514846,false,2093,988196
b21f33cfa2a16df87b1907ccff467a500171b6bb8a0b4ae1b0486df2929444ca,988207,2020-09-28 18:29:49 UTC,1000102450,1000092450,false,10000,0
ea75109da7b0cc7eafc5f0fff63fc9c18744ed0f681698b31a0ba8d687dd66f3,988206,2020-09-28 18:28:49 UTC,83158001,83156465,false,1536,0
8253c30975c48d127da988fd1d9c8ab1b8810ad33858e6c2bf21552c79e84dd1,988205,2020-09-28 18:28:43 UTC,198468460971,198468458878,false,2093,988193
2ccd1311dfca295f3f272d34b56a742dd1708b274db7368245fa36a04827fd84,988205,2020-09-28 18:28:43 UTC,19164854806,19164844806,false,10000,0
5669cc8a005ea03931ab4a0c965b4a3ffd65e77964d6d3038f69157b85c523fb,988204,2020-09-28 18:28:08 UTC,3330592370,3330586760,false,5610,0
7ba1c919271109dfb9373ab9ad06c6b3de623eb73feccbbc95ee96709fa50b2a,988203,2020-09-28 18:27:16 UTC,13941621771,13941619937,false,1834,988192
8ce7a46926f758ce01d2cb8ac90504d798f0d5e9c8bc0c0919c694b244d322f7,988203,2020-09-28 18:27:16 UTC,207681861,207678901,false,2960,0
78bf99e1ec91ba99369bdb49001f82f04d51833584d384e6834966367e843fa3,988203,2020-09-28 18:27:16 UTC,1099967700,1099961700,false,6000,0
dc0970edc3c6fb4465d0bf0742fa8d48735507eb478117a509988d17fcf94bf7,988203,2020-09-28 18:27:16 UTC,10838159630,10838129630,false,30000,0
49d5d76e4a333b110f77ce3874ccef700bb86155b463f5e5075356985ff602a7,988203,2020-09-28 18:27:16 UTC,81409898,81401353,false,8545,0
adad8accfedc083a52396e5f11a983e9fc76063a92408af2e7f14e3ed109dfcb,988203,2020-09-28 18:27:16 UTC,2543252179,2543249919,false,2260,0
a3eb7191affffa06c028aca7ff13ffe2beba2156a148984b307295d220c430fd,988203,2020-09-28 18:27:16 UTC,10000,,false,10000,0
148cecb548079f7648bd41444b8dcdc5e8842601dce6fba54b72db5e558d3867,988203,2020-09-28 18:27:16 UTC,50930514,50855734,false,74780,0
7ed7e04e15f048880041e5d2a9a0a836dd131ef10dc4bf3e2366e0af10ec4166,988200,2020-09-28 18:22:18 UTC,211208381,211205114,false,3267,0
0ea78140a28366ad89bbd7ddddc056b4d45fcc6192fd9edcbfeaa31337ca33c5,988200,2020-09-28 18:22:18 UTC,100000000,99997550,false,2450,0
f44f0b02a4dc9f206d14d96cb8f3353601f6cdb2b33187e2dd118c0c91cbc10c,988200,2020-09-28 18:22:18 UTC,220870890942,220870887977,false,2965,988189
4b8475e7462b218d5b28ff4c1a2ca5d4638832e87caa9cad159c15901f8b6c58,988197,2020-09-28 18:20:28 UTC,499990000,499980000,false,10000,0
93f47cd10f02213e34a13cc39ff96a42eaf559a86fd912381285c4da53da3dde,988197,2020-09-28 18:20:28 UTC,253236056,253203355,false,32701,0
bf50671d8378ab713a4140c00545be5a99b6db49a274ffd3eafb2226e7c183ee,988197,2020-09-28 18:20:28 UTC,36420322,36394431,false,25891,988183
378fb69f09b31f5ebf5f884d6fef1cf96df07baf7ce678644d124ed9a6309167,988196,2020-09-28 18:19:56 UTC,10000,,false,10000,0
265e6797ccb38cc87f608556f420d8ae6c8d6c723decd0ba02ae242d30462397,988196,2020-09-28 18:19:56 UTC,2468500000,2468487625,false,12375,0
a1187b3875e260ac6b7862b6342b23b22eccb780183106bb211371a697edecd6,988196,2020-09-28 18:19:56 UTC,10052954,10046954,false,6000,0
34ebafe1f17473b9287b8b3fcf3e55a9215a77fb09ecca10fdb1dcf930734766,988194,2020-09-28 18:18:35 UTC,1199993554,1199991470,false,2084,988182
21781fc3a45a36846db696979cecb9a0435be9f06cf4d4adf6b163e12622f04f,988194,2020-09-28 18:18:35 UTC,500000000,499990000,false,10000,0
75157cc16ea639662e42f2ebb01ccf2d51cc4e6115d45e6bed2191868cb26840,988194,2020-09-28 18:18:35 UTC,223339393035,223339390942,false,2093,988182
e4aa57f6d8e15803eb2c67911dd7625af2bb65c2c388a667f745b6cdc0fadc5e,988194,2020-09-28 18:18:35 UTC,201184983,201181634,false,3349,988182
1fe95e71ebba315941f033f0973237b4dc70c4c7a7bcfd8803aeaa8478788d16,988194,2020-09-28 18:18:35 UTC,6099995647,6099993554,false,2093,988182
fc518a7ded8f7048b7f58b7ea3576542af9f6d7b2878219c65cc90ef903d5995,988194,2020-09-28 18:18:35 UTC,30499997740,30499995647,false,2093,988182
5e97ea30d36b355fea4e7ccb521f801c3670951a60f1b20cb3ed99f9d37a3659,988192,2020-09-28 18:17:25 UTC,18664884806,18664874806,false,10000,0
0191bb140fd44ed57b6a0d09eb21406d34ffc8986d52d9f8ec18dd84bc2fff8b,988192,2020-09-28 18:17:25 UTC,250620423,250618048,false,2375,988181
e3a9b2472d3610265fcc2a924d4a36b60cc0eaeccd998617b4674745d00b448d,988192,2020-09-28 18:17:25 UTC,235428021,235425061,false,2960,0
d0fffa1363c470ae87148285bb90d6c6ac3f2fa6cde6f6aca9c4d1c099bcf050,988192,2020-09-28 18:17:25 UTC,2023746343,2023723223,false,23120,0
7aa6d9167f4e4d69743d5952d51d28fd4cb5cc556e8c87f775a9e1a6d1e47565,988192,2020-09-28 18:17:25 UTC,4147314938,4147302227,false,12711,0
dc191cfd5160facf9a7ab140bc7fc845df97aafc35c93c93dd41c7c842454cee,988192,2020-09-28 18:17:25 UTC,5300612,5297652,false,2960,0
c6c57071932738881d57109a080198a8c810ec3169cd95a2e1f51ea4a8c5b41a,988191,2020-09-28 18:16:01 UTC,81485390,81476845,false,8545,0
ddd04f53b8bdd614a28a404a54f49011f228c1b5ed0a6119bbff60a5f36f59dd,988191,2020-09-28 18:16:01 UTC,1105079,1103159,false,1920,0
11d13449a2065343fef2284dab42c3d5792144102230d91f1794a0b53882b476,988191,2020-09-28 18:16:01 UTC,19359336044,19359326044,false,10000,0
8419995dcdd51336edb47df50a39e64b549a9f81536d4b30ce36c4fb737b17f8,988191,2020-09-28 18:16:01 UTC,84037,74037,false,10000,0
12674949815becfae46deb9bd9b0739a0610e9ac741eba0b0c2249ba577bd266,988191,2020-09-28 18:16:01 UTC,1012670223,1012667773,false,2450,0
511080344e06f46f2ea6850023a7d66233f9c5b400ea980ae501e46d70afca29,988190,2020-09-28 18:14:12 UTC,881588427,881520067,false,68360,0
01397cb97f451758677a176b94a7dd855c22f6c671dcedd6ded9cc82cfd98e0f,988190,2020-09-28 18:14:12 UTC,20231598,20229505,false,2093,988178
362badd015fc311ca836812b9044db30f6f38e1761c0eae290d5f1e9ca7ae285,988190,2020-09-28 18:14:12 UTC,207966191,207963231,false,2960,0
a6506ad3476c2e5c8c661eaca2ce29a42e3bbc6bb434ce4a0c004e955bc05176,988188,2020-09-28 18:13:36 UTC,140576935,140566935,false,10000,0
16eec1b0bf10862b00e074ecf73ce183eab43b260da55f88e401e431007b2df5,988185,2020-09-28 18:12:46 UTC,50230717,50220717,false,10000,0
5197ccc6381caabdbcfcdbc0f58a144b3931d8cd96e4054bcf3be6e031c977f8,988185,2020-09-28 18:12:46 UTC,223438895128,223438893035,false,2093,988150
15ea1d786c84e5354b3d2925ddc1fc8085d245f0f1b77b7730ac906bdb6aab30,988185,2020-09-28 18:12:46 UTC,790010000,790000000,false,10000,0
8ed4a80afd6ae1120fd5697ee58f28717a2225d2048eded1d0e7f415a28e80bb,988185,2020-09-28 18:12:46 UTC,211395897,211392630,false,3267,0
18b7fb76dc39ae851281c7f4968b9f8a63c1cd227f3980cad46a0c51dbf6fa07,988185,2020-09-28 18:12:46 UTC,221225998,221220442,false,5556,0
421c7cb4edfbc19d4b8f665b3ca8fb7eb162c2cdc78d3f156ea4ac4d9ff423df,988185,2020-09-28 18:12:46 UTC,81524454,81515909,false,8545,0
d17fc6213fdb0806ab9999bde57af8656f2230ef268ca51e3f5f0e58e419b540,988184,2020-09-28 18:10:52 UTC,4551990000,4551983000,false,7000,0
c5b5b3c38cc11999d2989f058e075fafdf3b3e3434cc7fbb60dba5f548ff2d96,988184,2020-09-28 18:10:52 UTC,7679500000,7679487625,false,12375,0
732409ccb148ea72e9f151f381e7a5c7898e445f3952651491d219faf5b75be9,988183,2020-09-28 18:10:12 UTC,251152485,251146929,false,5556,0
db12d9e536a79ed2a3ee3ecba1914d1b39f7a86765ac738e450fd2c29a977e5f,988183,2020-09-28 18:10:12 UTC,37250099,37225362,false,24737,988171
549098ef131287543215b383cf48f54fbfc36535f4b722e6edec18bdf66179ff,988183,2020-09-28 18:10:12 UTC,81620184,81611639,false,8545,0
f47869828b8fda58c82937fe4be89b27f02748197d1a4559a29c12fd09180dac,988183,2020-09-28 18:10:12 UTC,307309061,307303505,false,5556,0
a778303eac191756c9903bf0a299df000ccb9c46b7e0ac58f390d3d877652a25,988183,2020-09-28 18:10:12 UTC,248423676,248418120,false,5556,0
6783d1f87e26c53e53d401f90ec40d9ef89f75a0609cbe8a8c423e7cc43e40a2,988183,2020-09-28 18:10:12 UTC,231118397221,231118395128,false,2093,988171
e5ea55225879a2df12a373cc88b0305848d0a93bfb6412e58f5acab4c080805f,988182,2020-09-28 18:09:04 UTC,235594727,235591767,false,2960,0
109c7500b05c7e52183be55a2f84a6add4c2c7f55a7fba6e7576e50b53365ab6,988181,2020-09-28 18:07:28 UTC,34125068467,34125066017,false,2450,0
817319b2028f806f52d5f482a11b9b22665eb0f2d80f4ace47a33522d665df3a,988181,2020-09-28 18:07:28 UTC,231172309314,231172307221,false,2093,988170
93ceb6427b8f1b57803f839e57bf56a21254eca5f19f948bc4ba08fe89fd5736,988181,2020-09-28 18:07:28 UTC,18953904,18943904,false,10000,0
2212fdc3dd83d81706759121a05dd4fe34afe3a95838a32ac46326b2b58a5f01,988181,2020-09-28 18:07:28 UTC,233143623454,233143613454,false,10000,0
f80893ee335f9828942b7770953a7ddb88a42a228c5bd73be15080665502eb03,988181,2020-09-28 18:07:28 UTC,2053501602,2053491602,false,10000,0
4224b69ab08fa4a7052f45eab2b724ecd3ca07884dd956b70c31d8604605258e,988181,2020-09-28 18:07:28 UTC,2000281758,2000271758,false,10000,0
b663a4755d7f7a04257ec110f5a5b1305e111505103075fd9b9445c36cb03a72,988181,2020-09-28 18:07:28 UTC,500010000,500000000,false,10000,0
22683524bba35b817636a6216e8020b3f33d1a124485475256096d774937b33b,988181,2020-09-28 18:07:28 UTC,1525813500,1525801415,false,12085,0
053e7010152852a54ad9d8c4d07d9c3835c8d97687e6e8dab04c09ac92c7e7d8,988181,2020-09-28 18:07:28 UTC,2000067672,2000057672,false,10000,0
cfdd6119b395fbd14ca1c252706927f61ccf26b9f215c7e5b8261ef5eb99c5e8,988181,2020-09-28 18:07:28 UTC,772198451700,772198449350,false,2350,0
cf0d5d2beb6f47747d8dcf83a14c78a38f839382aea019518a135aaae2132661,988181,2020-09-28 18:07:28 UTC,5879120,5870575,false,8545,0
419d92f7e7fa74e2b0560abcdeff0386cc483cb1d1ec4dcc40f400adf60a0afa,988181,2020-09-28 18:07:28 UTC,5304172496,5304165495,false,7001,0
ec0e426da5f65a28075446b11ba6902f2399413a7e72e9e62a2023ac37c678c3,988181,2020-09-28 18:07:28 UTC,98136749,98118549,false,18200,0
c6f2b1e15bb653655b6cdeecc94dde21eb40cd6c8bf29c4a7a9ea2ef26a5b2e2,988181,2020-09-28 18:07:28 UTC,59576642226,59576642126,false,100,988170
b55ec9797023ce7bb527cc219de15e7dc6b583f2f2e642bf4ce78ccd7103cfc3,988181,2020-09-28 18:07:28 UTC,276210643,276208550,false,2093,988169
b88208727d7f1df69dce783227b70b99042651048dbc68fcb1c955451cec3625,988181,2020-09-28 18:07:28 UTC,2000172966,2000162966,false,10000,0
cdfcd1a6e014c1bc5e76ced313b6b472ac1c31606b2df59a991f5e8414673d96,988181,2020-09-28 18:07:28 UTC,4552000000,4551990000,false,10000,0
315e2293ead60d2ecb27ad4d13a48c932341a7db85066bc79f5ccc634e621292,988181,2020-09-28 18:07:28 UTC,318442582,318437026,false,5556,0
fc201b24d16b1cd9de3def6fa779d91ee877af5986380a3bd691238fff498a31,988180,2020-09-28 18:03:34 UTC,81670114,81661569,false,8545,0
8647a23e45f6d15a233aef7a0294b8292915ecf5db5487d2a1a786419d5a1047,988179,2020-09-28 18:02:06 UTC,60045542326,60045542226,false,100,988168
51d13470924bc44d0cea6a97a06f4c8ffe032ebeed1c5897e6d51299835b7cdc,988179,2020-09-28 18:02:06 UTC,4723010000,4723000000,false,10000,0
e93f6dba92b1e260a7e05ee108205f81ad371456a6e5e4b8cafc8aa6c4d0f628,988179,2020-09-28 18:02:06 UTC,260315149,260312765,false,2384,988168
0f9460385e76f3350f4881ebb0192fa72f52fe381734fb175846c0b2069779c4,988179,2020-09-28 18:02:06 UTC,10000,,false,10000,0
0ceb79c7177bef1aa8cfc388953b1eacacb36d88d2bea7ab2aea8e232b763694,988179,2020-09-28 18:02:06 UTC,572306,520066,false,52240,0
3503d397f1eb69d91b7e143184fe1fa8d03e5b3a493c415226c54f348fa127af,988178,2020-09-28 18:00:33 UTC,500008544,499998544,false,10000,0
3799af1cd11934def8a930e315b7918dfa1fbc55486b27d54737924e78e71d23,988178,2020-09-28 18:00:33 UTC,38007035,37978247,false,28788,988167
8142efb1a86c2f893daba4873696d538f91da5db18d38c08772dcfe7d38d4f96,988178,2020-09-28 18:00:33 UTC,48452351,48442351,false,10000,0
845fe404705616275d7916741e46d1a2c52c656aa504fed880042ab67c042355,988178,2020-09-28 18:00:33 UTC,80200000,80190000,false,10000,0
7a3b9709142ef9e23a2cd0ae4f6ed1776736d40d6f8d3b2af68d1bd72a0996e4,988178,2020-09-28 18:00:33 UTC,410131170,410121170,false,10000,0
dbead8f79252d1aebe69e127975d8f4368aa8e25f4676c9b15d61b4853d87d9e,988178,2020-09-28 18:00:33 UTC,2990007694,2990004439,false,3255,988167
37c16ca70ee77d0e62bd2c92ee4d3a5a8ebb4ce516685d6306e7f7a33fa1bba8,988178,2020-09-28 18:00:33 UTC,5754194216,5754189812,false,4404,0
67076a0dc121393dbf789a0b41be254a90e64feaa2ef94215bb2174d043b3687,988178,2020-09-28 18:00:33 UTC,5456342,5453382,false,2960,0
bb5555746ebfe8a0f342ef234b3083ba1874277228027a8adf786d4dc2c78b7c,988178,2020-09-28 18:00:33 UTC,9108610910,9108601310,false,9600,0
6262a52ab0b88578ad77972f6fc4add1b05bc0eee18402f3ba53ad616395aa99,988178,2020-09-28 18:00:33 UTC,81708964,81700419,false,8545,0
ba134f9d6608d52a5f7c19db96fa67e4b9224ebc40967f6681e2c7c5c6d63f94,988178,2020-09-28 18:00:33 UTC,2148903,2074451,false,74452,988167
fb6dd10242b9077c6babe7373b24bc11c67fc11d7dd0e7359ad872bc2924aff8,988178,2020-09-28 18:00:33 UTC,488307512,488297512,false,10000,0
9d6372b76fd3aa1c9599cab73dc13a5075d45a4f065c5f6ecc16e41e6b94d045,988176,2020-09-28 17:57:46 UTC,208144475,208141515,false,2960,0
7bfae9f96931601e9a045688b71f8c4abb6ddcc482d9f90654763f67246dec51,988176,2020-09-28 17:57:46 UTC,824644798,824639242,false,5556,0
f5d9ab74f27a887e26e7af991608176ae1b5d9de225c4785a18b0510917cec07,988176,2020-09-28 17:57:46 UTC,500018544,500008544,false,10000,0
9bfaeeca1fd524532411234abb27a6bb31a7e0e4323f6fd6ab37445c74fdfded,988176,2020-09-28 17:57:46 UTC,424958302,424889942,false,68360,0
64150170311312fab4a5239399788851047ae87115131a710c8a5ee0e28a9130,988176,2020-09-28 17:57:46 UTC,866538857,866533301,false,5556,0
d45087753138fccae19af2840265eda92be0ce6991c1041a3d092328e75c6fc9,988176,2020-09-28 17:57:46 UTC,343754497,343748941,false,5556,0
5041351a130a3a3c1f291637871dce28689f26ac55cea55ec0319e7b674a7904,988176,2020-09-28 17:57:46 UTC,862029311,862023755,false,5556,0
5833b2dcc3e4659e7aeaa188e0b1dea4a5a64a7f14f4c0a1d47e6e9748fb5606,988176,2020-09-28 17:57:46 UTC,396765332,396755332,false,10000,0
f8e6670a12c2a0e52e65b26785966712318e81986b7bcd79498949c392ea126b,988176,2020-09-28 17:57:46 UTC,211720647,211717687,false,2960,0
31d1a9103ab8d6a20adc44fc276dd8bd54735f5bdd4e30e645f029ec7a4e1452,988176,2020-09-28 17:57:46 UTC,60085442426,60085442326,false,100,988165
74ac4ae5c770a79d589c7e1438ad22cd8f9da854306df213ecaec8a74bba4e21,988176,2020-09-28 17:57:46 UTC,38078,28078,false,10000,0
6433c2aca992197178f2c67bdc19546c0f08c525054bd382da997ca839659bb1,988176,2020-09-28 17:57:46 UTC,313178905,313176645,false,2260,0
afdf292c663887b4f133980fff03f1143d726c3c89c80dcc31228cd6b937c8a0,988174,2020-09-28 17:51:29 UTC,59948586,59946858,false,1728,0
7db5b9f7be61054e631ffda2502392b3bc0933b5a614c940b57abbcab4a4cf9e,988174,2020-09-28 17:51:29 UTC,233789871407,233789869314,false,2093,988163
b49c9ca1323c75087f6562a7e7cf2dd87884b1069b5e15058e08586462fb8b2d,988174,2020-09-28 17:51:29 UTC,1710558596,1710549276,false,9320,0
acd88dd9ce6943b3297879714d5e6b479e0b019b793b8b8fc07c7ae81c031860,988173,2020-09-28 17:50:47 UTC,2053010000,2053000000,false,10000,0
b4292296039347f987fa2ea79340953db7407dc61ca4c5556ac4e0bc8e26abc3,988173,2020-09-28 17:50:47 UTC,175445500,175436148,false,9352,0
5f6d6d7dd0b665fb29b155461f95ad7a0a956ada238f0f0ff81a25b2395b984f,988173,2020-09-28 17:50:47 UTC,38504113,38484605,false,19508,988160
82d0a27fcf267e5fe39df5dbea9298cd956b7a29b73735cb279c5da1b9f5ee0d,988173,2020-09-28 17:50:47 UTC,3785291,3710933,false,74358,988160
fc76057237267a589633c4a8cbc670ad18c3b779dbd8459916d90a34373a8947,988170,2020-09-28 17:49:24 UTC,1250548120537,1250548118453,false,2084,988158
1767ee0f38b9f0046b01069e5db76dc35a29b74e57a41a0e7a0619f2085921a2,988170,2020-09-28 17:49:24 UTC,81746389,81737844,false,8545,0
ec3e074ba87f17be06f301cd1f927ac1de189df0e06a1b8c505b68c4061016da,988170,2020-09-28 17:49:24 UTC,235752086,235749126,false,2960,0
16eb3e99dc0c8d3e1ec0e4faefec9ff0383a1119c20d0272477fd0433424e036,988169,2020-09-28 17:48:46 UTC,234092873500,234092871407,false,2093,988158
74685fd472e190d59dd4233280ca540baad0653edc51772d5235b3d20de337c6,988169,2020-09-28 17:48:46 UTC,396797500,396787500,false,10000,0
57097cf6dbb384ef4328223cf983530b9b76aec7b7a0063a79c2629c40b81b17,988169,2020-09-28 17:48:46 UTC,5612662,5609702,false,2960,0
55b7bb50c2dd6cd41d67ce856c1bc430a89c553661594a07817a809e1074c8df,988168,2020-09-28 17:45:56 UTC,9952913,9949555,false,3358,988157
b57a33577d86e013c378ee000ac6fea21af7a1c65f22a7da714f27a3c2525423,988167,2020-09-28 17:45:07 UTC,396797500,396787500,false,10000,0
3fed1c0d48712c6705b98fd9513e11b65d30113906fac264b37fe55f3b0a9782,988166,2020-09-28 17:44:48 UTC,124226471,124216471,false,10000,0
5d4d645beb39125e2ea50aec5f3a7d0211993fb4add14d1d7f48f04d132928f3,988164,2020-09-28 17:43:24 UTC,60661941403,60661941303,false,100,988153
e373228458800e2cc438200808d4b66180dd31ec487acade3f8378ea66a017c5,988163,2020-09-28 17:41:56 UTC,239185900784,239185898700,false,2084,988151
58fe95cf232700e87f0ece191564bc8889343d96c95e11e25d78b470c7f6a6dc,988163,2020-09-28 17:41:56 UTC,1126235561,1126185023,false,50538,0
9c7dd5aa3578438f65ddb075c0d0d9cd711126eb031bc813d079c686a0664209,988163,2020-09-28 17:41:56 UTC,2155888212,2155888141,false,71,0
7fb9a96b497eac3da1f0cadda6ae2e51b8435657fdc72c81085d711de6b6e206,988163,2020-09-28 17:41:56 UTC,39194263,39168962,false,25301,988150
df800d5d4510a19aaa35903c4221e56dc146994d84953da3dfe63a89de8c2e50,988163,2020-09-28 17:41:56 UTC,208306881,208303921,false,2960,0
f29d927a97a1772d3f236e19af7f5e1a3441dc932bfcd384046dab8bba224a2a,988163,2020-09-28 17:41:56 UTC,396797500,396787500,false,10000,0
29e2eba450788451ba35e024552fbbba6f3ae50a2978b3387189e155271866d8,988162,2020-09-28 17:40:22 UTC,5382827,5308503,false,74324,988102
554223aaf78e716e045ac8b71c59cb3e6d0e0fa1bd34970bdfd5a85ef40fdbb2,988161,2020-09-28 17:39:49 UTC,42582297365,42582287365,false,10000,0
f3c7cc8bf61e9cbfda7d3a419cc654afd37bc1e66164d2c48a90c4409b2e6501,988160,2020-09-28 17:39:33 UTC,78897807,78896677,false,1130,0
3d5f1e81c3d112f996b9167b4e8ca941bb2147c486dacbb4442faf7382219eb0,988160,2020-09-28 17:39:33 UTC,740953841,740885481,false,68360,0
2e19d489c09e267bdabf3d389e55666d2cfda7ec5f907db4e32088072c0f658f,988160,2020-09-28 17:39:33 UTC,211885735,211882775,false,2960,0
f414caa31ed470c859f75ab872af18d4089dd5b9637ddb4e5fb5c9b3357be377,988160,2020-09-28 17:39:33 UTC,34424540,34418540,false,6000,0
89e6958060d92ea66cf29ad21b1dc777bee186c7353da647c389bb29ee94da7f,988160,2020-09-28 17:39:33 UTC,241792402877,241792400784,false,2093,988087
f5d28499361c9007d5d6125bd6ac986814f65829c9155af55b97d0108e97fb00,988159,2020-09-28 17:37:34 UTC,235955550,235952283,false,3267,0
8158dc2e91054156366021269f34b148b917a9612193d1d885452acd8e1b8890,988159,2020-09-28 17:37:34 UTC,10000,,false,10000,0
88c8fee0fd3f5f449372365952eaea1ec6f9ab6d1515b4be1ed69e97552e9b79,988159,2020-09-28 17:37:34 UTC,14804973,14798973,false,6000,0
8442913ce379f04a3751b420d18f0323d926e4a4c6ee22a66eb36e670d6cde36,988159,2020-09-28 17:37:34 UTC,305586555,305584471,false,2084,988148
27777b54c88131ef56b80685c1805036d189dfc4c1f5fe9990f3bccb172107c7,988159,2020-09-28 17:37:34 UTC,18859347500,18859337500,false,10000,0
fddd0d15bafc2b0df46dd93ca9aaa9ed430707adee139fbfb5378cfe3fc8c120,988159,2020-09-28 17:37:34 UTC,82102792,82094247,false,8545,0
08c2334b4a48894f7e25d62ce11a0fa11e278d807343757e8895b8717285b0f5,988158,2020-09-28 17:34:30 UTC,82205074,82196529,false,8545,0
072db7ce4594887d5eb0a8c9ee7c8eeefe3a8e9bb1819b67937418ba499d6662,988158,2020-09-28 17:34:30 UTC,19061890993,19061880993,false,10000,0
2a70ce55f5e595bebe3ec3139263362cca8381382e8ea7ccebe4543b6e5e1d9b,988158,2020-09-28 17:34:30 UTC,82176543,82167998,false,8545,0
2f33365a4ba98cd03ca52f1c82aa179b8fde6800610bc4bfeb727be735633795,988158,2020-09-28 17:34:30 UTC,149500000,149498080,false,1920,0
42c69bdb87b8138fbe14498b10dce9e9589a60b42f51e0589388a8aa85a568e8,988158,2020-09-28 17:34:30 UTC,82141005,82132460,false,8545,0
1727f3e76c75fd3034184b75d28fda97a68661aad078d1b4cf5ca2fc7232989d,988158,2020-09-28 17:34:30 UTC,9465207,9189207,false,276000,0
67e3fc1167f4c56b3591039b16a0539b631454688cc84efbf8d24a3868dedf3b,988157,2020-09-28 17:33:22 UTC,5769588,5766628,false,2960,0
b5b61a9f797c86d2120231b6f391d3633e91d04e9223a32ab926aee93a8f6f70,988157,2020-09-28 17:33:22 UTC,3668511900,3668507020,false,4880,0
f078fad2701a63011bb6ccbeffb268ed87b401665ea85d1be4ee69b9b3b0d5f4,988155,2020-09-28 17:31:03 UTC,20045157769,20045147769,false,10000,0
097ef8e61c6c4c5b7de269959a943ca9cc7c46bd00b825cd7b56acbc690923fc,988155,2020-09-28 17:31:03 UTC,39924041,39898142,false,25899,988144
46f01365e929c68c1c21ad00672c24886650137fa57610409b1f1f3f303aeb75,988155,2020-09-28 17:31:03 UTC,2624097590,2624092370,false,5220,0
bfa44130c44429b95e89031f4a1dbcfc630772437b8baf2bdfcf32049fba460c,988155,2020-09-28 17:31:03 UTC,418508156,418486023,false,22133,0
1a8243a6e308fb86851e4cbbc7dfdf28ecf0d71b9198943bd61d82826b4f10b1,988155,2020-09-28 17:31:03 UTC,7044171,6969736,false,74435,988144
9483c911768fef8debf6cee15f9699c0c38bba6f7e64057951537292b3eac2bd,988154,2020-09-28 17:28:47 UTC,416569843,416559843,false,10000,0
385d55be168aa11fed08c0b11970f415e22e6535ae1e28683935c151dd0a8faf,988154,2020-09-28 17:28:47 UTC,208530086,208526819,false,3267,0
cdff645c12fe9c1fff4c091daadbc667368561a1b78a2eb5c5937c592880592c,988153,2020-09-28 17:27:04 UTC,514840696,514830696,false,10000,0
8a001671f92ec40ddcec762d87ecebffccbf01e7bca459c99f33416a94e4f6e9,988151,2020-09-28 17:25:33 UTC,417643511,417569845,false,73666,988140
f26aa3f43f08d08318bdb7d8d5bc0a8be590164ae0a3ffeea0aff15e130a1c8f,988148,2020-09-28 17:23:18 UTC,284308694,284240334,false,68360,0
0b7561146b01b68f7e401fba90542ee702f190d878942378d7b33269dd32f3dd,988148,2020-09-28 17:23:18 UTC,212040203,212037243,false,2960,0
0b9ced59a4e01ab1d83fcaba58f7787c7437ffcff10001828860f7a2cd9fc2ea,988148,2020-09-28 17:23:18 UTC,40695747,40666370,false,29377,988137
d8d13e831ef07f1c1a0b9fccfa662db568242d5f8f124dff418603adb6d35bf4,988148,2020-09-28 17:23:18 UTC,236172143,236168876,false,3267,0
4e28694596a017c72cde7b487a8d5dc5f173edff3b55ea72a86f29ae73135c92,988148,2020-09-28 17:23:18 UTC,8384659,8310292,false,74367,988137
604c311713c2c896eca7371f7c431303c989e7a6b03d19cb4cba2662ca9e8b6a,988148,2020-09-28 17:23:18 UTC,63356,60906,false,2450,0
58c83b4b25ade19c3d056cff3af6f9f80cee3bfc6d44c3214f4b6837a1d2df99,988148,2020-09-28 17:23:18 UTC,2898083021834,2898083016674,false,5160,0
d15d397f58a38ed10a1e14d143f34fb5599148a79dd52a4e9a748526b9190c5c,988148,2020-09-28 17:23:18 UTC,327700123,327698030,false,2093,988137
c6c83e9cf0f71985ba05159d081ce9d03ff382ca13db3ed9f167e8869b0a5129,988146,2020-09-28 17:19:29 UTC,1769599876,1769594876,false,5000,0
cf6e91e7ad1102eba4918c82be300b077e8a97cfa20d93fef461c68243ee56af,988146,2020-09-28 17:19:29 UTC,6029286,6025713,false,3573,0
0808e74932e3e333fdf164d1bfbf699756c00f2397044174ef3e1dd55e64c306,988146,2020-09-28 17:19:29 UTC,242106904970,242106902877,false,2093,988135
64ddd4e9fd7dc202eb615c2462bdb41309023f6163982315e3edfefd3ec8c00f,988145,2020-09-28 17:17:46 UTC,74119693,74108363,false,11330,0
6a96950dc5bc7a1046ec5bace0bd940adec0fdac5cf65020bff9dc778f703a6e,988141,2020-09-28 17:16:26 UTC,500000000,499990000,false,10000,0
84e0f1ade8703f8c61e59b1dd07c61e3ec2c900ae10d30e1d365ec5bdf13c1e0,988141,2020-09-28 17:16:26 UTC,9913760,9839342,false,74418,988129
b737461a8835891709fc3299140cfa972aa91f3ca948381fa5341582ba14e3f7,988141,2020-09-28 17:16:26 UTC,82238617,82230072,false,8545,0
92612cf39dae849985cca271b87000257084335fbdd4bb429d1074136e191b8c,988141,2020-09-28 17:16:26 UTC,4149000,4139000,false,10000,0
7032af764bd264f4c91ffcd54ae7c1e78bb159f6c1e0b53c0745b06b87aa6c7b,988141,2020-09-28 17:16:26 UTC,208698271,208695311,false,2960,0
a48a5b47390e3c5a45a1f40054774c13438549ff5f34f93c1983ac21c32921ee,988141,2020-09-28 17:16:26 UTC,41053744,41034809,false,18935,988129
e2290142e7c1a7ad33a1badd21dc67bca3e73fc9a9623edaec82a83e86f5aaf4,988141,2020-09-28 17:16:26 UTC,236398377,236395417,false,2960,0
d0aedeaf0a0be9404088c4f8b41681adb0b47c5671f76eb82b9e42b3b88f21c9,988141,2020-09-28 17:16:26 UTC,82318922,82310377,false,8545,0
a95eb4cdbe81fb780f868251dc59b9b98e6d292aa1d9669beb85f633dbc74aef,988141,2020-09-28 17:16:26 UTC,375139698,375104154,false,35544,0
05d1126ff799acda7abe8d052ca80c104c7863ebe37f8d95915c6982d4d0e2e4,988141,2020-09-28 17:16:26 UTC,10000,,false,10000,0
2e497502cdc361305a993f5dd3c2e86c16d1fa80c18eb50de5e27573804716a3,988141,2020-09-28 17:16:26 UTC,212456423,212452238,false,4185,0
a688743920be4d9edcb92b77a8bfc6ef0facf22eda44c5eb485f519a58b85761,988140,2020-09-28 17:10:00 UTC,93887,83887,false,10000,0
7175da42a50baf510cf6ca695e8bc1694d057cdf07f60f2cf5b5bd49e25ebfaa,988140,2020-09-28 17:10:00 UTC,614740000,614730000,false,10000,0
ac4e963110555a94e7dcec5629722f8d03d865ba17b609d8b820a9c3954b0bf1,988139,2020-09-28 17:09:19 UTC,316732336,316687576,false,44760,988138
a5e3c3e8474d981a2fba73ab14d2d950478d52b8c22cc016c942a111f23a5b48,988139,2020-09-28 17:09:19 UTC,243851407063,243851404970,false,2093,988127
ea25afc63adbbfedcdc1cc1a420f3b914b964f41dead40bbb29075cb4b57b0c8,988137,2020-09-28 17:07:36 UTC,82399141,82390596,false,8545,0
da886ebc4dc7b6aa5c05a21ed8cf64acc5fc1b0340dae1a80744b3507b5d0a7d,988137,2020-09-28 17:07:36 UTC,23054499792,23054484212,false,15580,0
8a33dbb6adc5fcabc7534ea1b292597b103b5fac457c6ce53a223b753b94b8a8,988137,2020-09-28 17:07:36 UTC,6178115,6175155,false,2960,0
55c6f5c113ab240074c071448c2a09d4e6d81c2de88d77e621039aa9785a13e1,988136,2020-09-28 17:06:43 UTC,34125068467,34125065337,false,3130,0
e08d21c4790dad0876e96bbe702a5b9fa08832a9e9dac26522a35ce569c874e2,988136,2020-09-28 17:06:43 UTC,500016384,500006384,false,10000,0
9223f7de96c78d8dd5536fec6ffed2321a18b2cf3f73db712639f12bf6a21632,988135,2020-09-28 17:06:07 UTC,500154279,500144279,false,10000,0
eb7007f62dad93cc3abda25ddcfd22a6e65ab84f9e94b7c402db15bdbd609657,988134,2020-09-28 17:05:39 UTC,212615936,212612976,false,2960,0
b494f0b9e0f95273c6c1e7541f17455cd0aa6dbfbda916bc29b0e83032acea3a,988134,2020-09-28 17:05:39 UTC,7161000000,7160994136,false,5864,0
d274b17f4e1cbaac0b81e5d55dda828896faa0c65ac15490d38192cfa7cd5ac1,988134,2020-09-28 17:05:39 UTC,1000000000,999995500,false,4500,0
e07fcc17fbcb647933234184709b92f9950d7f3e06ba7124eab07e65f54e38bc,988134,2020-09-28 17:05:39 UTC,2000291758,2000281758,false,10000,0
793af853328b639b3aa8eebb5534bd7eddf3e1a57490dc4de32cbd31e5ee9114,988134,2020-09-28 17:05:39 UTC,3500233785,3500223785,false,10000,0
8683541eb86666f95fe820f94b9e3d8da71fe7cdab77cbabfd03dc7c2d571683,988134,2020-09-28 17:05:39 UTC,230134503165,230134493165,false,10000,0
eb2ffef5800e2e0e3fdfc1d4b94d59d5a46a9be41769dd7a790cde4693eeafa1,988133,2020-09-28 17:04:12 UTC,593097043,593028683,false,68360,0
18476091ecdffcf8061df9eef722a7f959b5c5018169684c513bc02085b1ba6a,988133,2020-09-28 17:04:12 UTC,1018464,1008464,false,10000,0
fe11c0ce6a044fde04e6a92679ed73f43c52f50b33581a62dc756f942b206b73,988132,2020-09-28 17:03:52 UTC,837031636,836931636,false,100000,0
d89b53548b82371d22843d7f5d315866f4ba1bc3725d643dda8c5ef4084749b7,988132,2020-09-28 17:03:52 UTC,236554011,236551051,false,2960,0
04dde78c1adb54ee73dd590b3de9ea42335e3ac6817ec307fdaa97e23966c56c,988132,2020-09-28 17:03:52 UTC,12032189630,12032159630,false,30000,0
9de4b049af1c3ac21ef227a13862d37defc3d0d62ffedd920fd46e6919db0bae,988131,2020-09-28 17:02:14 UTC,208863402,208860442,false,2960,0
ce5f3edf579d41abe79d7466e732a1d061a197b273b8335dcee11b1ab4188ead,988130,2020-09-28 17:01:43 UTC,28114428,28110788,false,3640,988119
8ad24cb0f6269a985b94822bcb5a53d3530252e81b47ee55c65b37ed1ef8b620,988130,2020-09-28 17:01:43 UTC,100000000,99997550,false,2450,0
0dc66ad0ad144c6c1d832f468ed877a3645722e756335d46bfbf7d14895d96c3,988130,2020-09-28 17:01:43 UTC,316228773,316225808,false,2965,988119
42ee0d63cc8b6c249b99e08d321ef370721c2abd4607ac44030e4b0bf78b5f62,988130,2020-09-28 17:01:43 UTC,1540697498,1540695405,false,2093,988119
9684124751405786e14a6c8a9fe029f945c22e6524cd6e08cf15cca207fbbe70,988130,2020-09-28 17:01:43 UTC,100000000,99997550,false,2450,0
44ba6b52410ed68c33ec8d61868a5e5f86b23749d7eb02a795efb00522b913e8,988130,2020-09-28 17:01:43 UTC,143118360,143095139,false,23221,0
cefebc9916241c73d6a22827035073e70ed2b3b47c963f83f92fd44885ff3301,988130,2020-09-28 17:01:43 UTC,41586167,41562293,false,23874,988119
d97836f0a2a3cb3833889d5c6d4e68664166e868718f06b7f5ef1c55addfb998,988130,2020-09-28 17:01:43 UTC,100000000,99997550,false,2450,0
173db3824ad44b65c5ebdc542f2f4f72f7fb72c413fb82418d6e9f0e9dbef27e,988130,2020-09-28 17:01:43 UTC,10907125,10862102,false,45023,988119
c1e4fe782cd841b7dae976ab12a3e026886aadaf4192e3d07472ced031bf5492,988130,2020-09-28 17:01:43 UTC,9987740,9985480,false,2260,0
836689971c05c9341a74c183993fbaa0ce0fb301389e7c8d712de102138062d2,988130,2020-09-28 17:01:43 UTC,361310900,361308807,false,2093,988119
7779628533178a1555f9bd1e05319cc067a0908eef5804a0d77062019b0a1225,988129,2020-09-28 16:58:47 UTC,263850909139,263850907063,false,2076,988116
1ae24072a40e2f60be65584f71177a03bbaf3d1f0ceeb77fccbcb904685f1505,988129,2020-09-28 16:58:47 UTC,82456800,82448255,false,8545,0
e764637131f1548781a115541c5ed4173fb44ad61b04491532ab0a5b76ba5e5a,988127,2020-09-28 16:57:24 UTC,6342051,6339091,false,2960,0
768bad7284f5daaa45217e8b2b0b90d429812e52ddff9bb8b1594e15f1c1ae48,988127,2020-09-28 16:57:24 UTC,696646549,696644456,false,2093,988116
14e64b3c005f5098aac8c538e61176a4b7851f3d896c99454d874d9e83e5e989,988127,2020-09-28 16:57:24 UTC,10642937,10636937,false,6000,0
fbcc3a57ebef15a3169fdc9d0b19e1685fa97e2e6d7e72a11054dca432ff2902,988126,2020-09-28 16:55:56 UTC,212767113,212764153,false,2960,0
59cf3148008542fed2adbeea4e5ca912d7bd66302035746005f2f6928b615ac7,988126,2020-09-28 16:55:56 UTC,263876471232,263876469139,false,2093,988114
7d12d9caf1498015a8f2f39966206ff02cc50788af216001a9ebd9fb7ee9b6e9,988126,2020-09-28 16:55:56 UTC,61366924,61279164,false,87760,0
1e3e7d6d4eaa6405b4f4983494d531ca48bf1c516a82a349e5723cea29a2e7bc,988126,2020-09-28 16:55:56 UTC,82492602,82484057,false,8545,0
8c6d1aec2ec800231b8c399eb14e24b3755c38e7745d8d1a2b592866d027048c,988126,2020-09-28 16:55:56 UTC,2203217388,2203214030,false,3358,988115
27ae09ec381729846d7bf94209999094faeb3b80bad1334a11870786dd41fe3e,988125,2020-09-28 16:52:52 UTC,436379497,436377122,false,2375,988113
b275941bfc42dfa90f003065189eb03f2af8947890480a67c3d19997289da2e9,988124,2020-09-28 16:52:14 UTC,2598750,2591970,false,6780,0
a3cc2f0408e66f047830d14ee4aac69eb12ddd3ed04c16149c0cbc9fd980916e,988124,2020-09-28 16:52:14 UTC,236701134,236698174,false,2960,0
277d497de89ea01609aefdea2b24bd24a0b9616eaf4ce547898e61c274ddcadc,988121,2020-09-28 16:50:39 UTC,42344026,42316076,false,27950,988109
c49c3b709c8750a926832f4a7e4dc65501acde534acc97423f6e6705d89f016d,988121,2020-09-28 16:50:39 UTC,1552052986,1552050536,false,2450,0
88a5d0039626ad5a469d04ff98e656c37e84958f6b8797bd8e108e18ff3297c9,988120,2020-09-28 16:50:06 UTC,11265454,11243613,false,21841,988109
83d9bc8d90ef4355521678547ad790ee3bab3c46bd3133bceb97a6bf1d0db5bf,988120,2020-09-28 16:50:06 UTC,1252294080409,1252294078316,false,2093,988109
95767c77effdff5b25d9593340ac7a713ecf8a0581543e26d50df8eae3fd7822,988120,2020-09-28 16:50:06 UTC,143640585,143572225,false,68360,0
1c0d131f667346521d1cb6e3bf208a6540b0f42cc87f6f4cd091115d1477c8b8,988120,2020-09-28 16:50:06 UTC,264738073325,264738071232,false,2093,988108
814c5f81934342c0203ed0ab03da33f52e9f7fe5b3f9098e113dc135209b4c89,988119,2020-09-28 16:47:01 UTC,493887535,493885953,false,1582,0
dde100d49a4afc751a690dc94f499c2e1278e5ea8738f88059167746be5a4079,988118,2020-09-28 16:46:22 UTC,1466824956,1466822863,false,2093,988105
1f77679992d32cad067fdeaaec1eea225afb7f175115658cbf1696229e676d60,988118,2020-09-28 16:46:22 UTC,209016678,209013718,false,2960,0
24514cbb4ef64209c2a8ca670363df782f6632f589c0a5fcc964b6d93a42c870,988118,2020-09-28 16:46:22 UTC,101437491,101434142,false,3349,988107
01b383e1ea7297d657fc04b76a2d30d7c96a1b30a9932d9915c9ee717b6f1ec7,988118,2020-09-28 16:46:22 UTC,91655187619,91655185269,false,2350,0
f875f7027fe57fc84dca7574caba8dc15441aa8ee18fa88852cbc960f0a9ddc0,988118,2020-09-28 16:46:22 UTC,648804356,648802096,false,2260,0
000e59b69c92c020059d11ace30dc83ad1b6136084563df9c2c809fa90460870,988118,2020-09-28 16:46:22 UTC,4561788074678,4561788069517,false,5161,0
bc35d82ee6558be1efd9b1759b6b2706be4de6ec06f409534a9eb9660abc656c,988115,2020-09-28 16:44:45 UTC,20045177769,20045167769,false,10000,0
5cc7bef92125e7eb2206c996fe77c9e01bd6d6060d97c45492fc3d43b67c9455,988115,2020-09-28 16:44:45 UTC,72322025,72312025,false,10000,0
884cb1199ff7dba1cb79feb4d8f5f923ea33faad2bd429ac9327c18401a1a5e1,988115,2020-09-28 16:44:45 UTC,1713674,1711581,false,2093,988104
9e50852a0a5563dc0a9c0857b4600bf11806c66b2d4f509ba1586e7b70af3322,988115,2020-09-28 16:44:45 UTC,82708752,82700207,false,8545,0
c1c0677651590cd751759e81b0cc827c72c52c91f29ccff586d7ec781c7b4a09,988114,2020-09-28 16:42:02 UTC,2617741112,2617740436,false,676,0
e86e34fdee6d64ba5b682722ec5cb06984cb1435ed56ad929425a105c0e9f999,988114,2020-09-28 16:42:02 UTC,212943045,212940085,false,2960,0
eaf1b6885e3a21272cd3aa89ac0e89919a0c188e5b62dc7b046bce0931193368,988114,2020-09-28 16:42:02 UTC,2202192062,2202190142,false,1920,0
b34f9a8c2308bd34a6456abefa97dd856e8f0ab31e3c3cafded956903bd85bcc,988114,2020-09-28 16:42:02 UTC,6150846,6142301,false,8545,0
a139679151b6deaf01882c98157cb2932611d5c4cf146724b946949106f23437,988114,2020-09-28 16:42:02 UTC,43104804,43076016,false,28788,988103
2286eaddaaa6923b1141e647aa9be5cc96afbfac3ffb7bd4d2bfa8941f463eeb,988114,2020-09-28 16:42:02 UTC,1533098953,1533076313,false,22640,0
2c34fd07300fab603b8a8ff4b46657a0b9e02acc63f51837c38737c65fe56647,988114,2020-09-28 16:42:02 UTC,6492971,6490011,false,2960,0
7c219704be3d83abb7bcdad3f31592f816554226480567e28cf94e9e43e838c8,988114,2020-09-28 16:42:02 UTC,1533076313,1533073776,false,2537,0
dacb662d8074e518a1d42eb2890229d9b510bb3e4f05cc953e2f0fa1a41082b8,988114,2020-09-28 16:42:02 UTC,54362335105,54362235105,false,100000,988103
d2a6efbc398b24be03f3cc1cbf6ee003f11f63241efc6d764d5dc8f05e017415,988114,2020-09-28 16:42:02 UTC,309000000,308997972,false,2028,0
22d66ab3f5984385efea93e3cc6221d540d7c9150ae9241428b9d2b1fa453110,988113,2020-09-28 16:38:37 UTC,469393992,469391899,false,2093,988102
6ffcf29eb9bf53c1e79692b6a0fe7994c9ca9ce59dbc4477cba5b14a048b69a5,988113,2020-09-28 16:38:37 UTC,82891278,82882733,false,8545,0
6ab3b5fb9fea7634beb29bd0b522e710ba4b66aa5c96b2887cf82b4487be7ebd,988113,2020-09-28 16:38:37 UTC,620480,556400,false,64080,0
698886b70534e38cb89189b61a12140428e7a810a2f9f174056ce106880b97eb,988113,2020-09-28 16:38:37 UTC,82862605,82854060,false,8545,0
bbd4d41cdef1e7803cb1318ec782e6b2ddcada01004e78af60993415f50e0ef7,988113,2020-09-28 16:38:37 UTC,2207207985299,2207207977889,false,7410,0
c14150b65beb532120a5e64043be2a279edb2190af99b2fb44a2e12dcf0d02af,988113,2020-09-28 16:38:37 UTC,3503805249,3503802989,false,2260,0
d06b2280a97c6b5783867e1ee99732b6442fbd79a275a118208f63ae9ca42a9e,988113,2020-09-28 16:38:37 UTC,6073240,6068336,false,4904,988102
f47ddb4c6b2420d3ce6a995cda70aa8a9b08826bcf1286d8f4cbaef629a42a51,988113,2020-09-28 16:38:37 UTC,1083241,1025715,false,57526,0
a5bc91db77dc645f68920c0aa1ba24775f5b0fc903662ad89d1375c6264b826b,988113,2020-09-28 16:38:37 UTC,65806049161,65806046543,false,2618,0
3e9ff8e85193440e4063152b5a7deeead49a0b3b0f1fb4471f9d0bb1b0518ecd,988113,2020-09-28 16:38:37 UTC,238473837,238470877,false,2960,0
2dc66cabaa08083f1d483e86ee6396af3051814ac38097a1d42b85deb951e917,988113,2020-09-28 16:38:37 UTC,19061900993,19061890993,false,10000,0
6e1c41ba86c7c79e52fe619957bf24a11426ac0c7925ed653dd541ac159a3b98,988112,2020-09-28 16:34:47 UTC,499986000,499976000,false,10000,0
f5a52f80ea05eee53edf06f73a6e1a5fcaf206cd2325537de820279a03b7d07f,988112,2020-09-28 16:34:47 UTC,3696984173,3696974173,false,10000,0
25bdf46e049cf3d8fe47719c8cb726707bf67ddb41bea3fd0f8905e5c0a7198f,988112,2020-09-28 16:34:47 UTC,209184514,209181554,false,2960,0
43901ee13931bebf2807a13f201da55ff1071cf2e0a4d4bdad74263da689d9f3,988111,2020-09-28 16:32:37 UTC,6643727,6640767,false,2960,0
807b82916deb237ea997fb9da5a232a00d2c8c5db4b424bd05e3665bb4c0bdf9,988110,2020-09-28 16:31:26 UTC,26547395,26542773,false,4622,988098
c6165b203f5e963d9e0455564c2e26c739b53bb9efcc8d9e9e19a15c241f8a65,988110,2020-09-28 16:31:26 UTC,92958129671,92958127321,false,2350,0
7f46f72a0cef0cd92f79dc0dff9e6d62f381a27e4087f7ada05e1746b7b59f23,988110,2020-09-28 16:31:26 UTC,267459622,267449622,false,10000,0
09598b00a62e5bec0f848ea88c646a0c13fd1086026214e364d5ec83bf858327,988110,2020-09-28 16:31:26 UTC,4416423494,4416294432,false,129062,0
5c189d109e16c18dad9d7135f58f65cb25fb6b67fb5f5dc0596579bc5cb158ae,988110,2020-09-28 16:31:26 UTC,11559427,11541936,false,17491,988099
9ebc9e69d4848e75b1e487c92d38886b28652df0108f18ce098c332ade8c5e11,988110,2020-09-28 16:31:26 UTC,452412665,452344305,false,68360,0
ec39ebb4cd8dcb7e5486546c1d9ae5c023d3482187c77acde91498b116522663,988110,2020-09-28 16:31:26 UTC,43946486,43915109,false,31377,988099
afc06dd8244a32bd1c271111cf363f36f654ab58fe37202885dd057950fad1ad,988110,2020-09-28 16:31:26 UTC,213153978,212943045,false,210933,0
5cccc6021b0a3d8282a2a7dde051d0f427784fc5bc3678e1d6e6a764751b67c1,988110,2020-09-28 16:31:26 UTC,82944233,82935688,false,8545,0
7dcc3cda0f543415fa1542b36075b59b8980d5ec19a57fc3422a41e1829e5819,988109,2020-09-28 16:29:46 UTC,274834521365,274834519272,false,2093,988098
3b9b60d6ca56707fe70ab19de36b59e357fc76c13282cf90c78b422d1291a292,988109,2020-09-28 16:29:46 UTC,334600000,334599548,false,452,0
c2e39c33ab5629519befe011c4d97b22ad291a86efa1bb594f1d6379fa440c28,988109,2020-09-28 16:29:46 UTC,238698372,238695412,false,2960,0
1ccece7a68257d5b54c28f97effadebe3b75b5675c418cfd3682f4998225fa0d,988109,2020-09-28 16:29:46 UTC,247695210,247692780,false,2430,0
44370eee75788be9fd5598b3f9ab94d6009f30a9893d98df374be39481ded01d,988109,2020-09-28 16:29:46 UTC,394652,384652,false,10000,0
78bd8ff0a163508a3636be7b93c54176e25fa698dc2d3428250a49f936ece0ae,988108,2020-09-28 16:27:44 UTC,2300094840,2300091100,false,3740,0
15af742dc6673f1e62f262f3e8e5ef3a7e2aaa34f3bde1bc136a80b271713213,988108,2020-09-28 16:27:44 UTC,364073461,364068961,false,4500,0
e9c98d787172f60316798e05e21f87966c6f56cd62ef318d67b7ced995ae780e,988106,2020-09-28 16:25:43 UTC,209344302,209341342,false,2960,0
8dc8f76e792144ce7b89277099ce6aa6bd3f4d8000fccd0a478240addbb9ed50,988105,2020-09-28 16:24:31 UTC,100000000,99990000,false,10000,0
862483543d1ca46fd920a22a3fd4b9541ec515457ccb8e4e1b97187fe3fe5acd,988104,2020-09-28 16:24:04 UTC,499996000,499986000,false,10000,0
7e1920bb39a151761dabab4c4ddde2e4a9c8de2200b3747fc90f73b452fa2682,988102,2020-09-28 16:23:26 UTC,6825477,6822517,false,2960,0
fee96bbf98a06ccef57451434786931159bb04e3b1b6d201a58e1aec81ebf0e3,988102,2020-09-28 16:23:26 UTC,125549,68529,false,57020,0
2f796e98e9968fbe844733f1b0c5e3efe381e239bed9b6873e95aefeb1a79818,988101,2020-09-28 16:22:25 UTC,174368350,174365900,false,2450,0
44b3a0f9c0c0706758d61376a675b1adb5a334042d881200e5ca6767dc88a191,988101,2020-09-28 16:22:25 UTC,44667159,44642405,false,24754,988089
534da59bbb83bc544a2b7ab94e22c60470a2be1d70726cf5895895134939e1de,988101,2020-09-28 16:22:25 UTC,12706420,12664268,false,42152,988089
ef34396b46023db953b4df08a260ce6507078923fbcfd48493b88e650f46ab0c,988101,2020-09-28 16:22:25 UTC,238847202,238844242,false,2960,0
fc45319a32db0439cee2745fb6c030be5c069b733d12d0f37e391c650b123151,988101,2020-09-28 16:22:25 UTC,500006000,499996000,false,10000,0
c4b5836b9dcf3e965033213ee447b15bdd24174e0d20050cbe366e2910fd9c5a,988100,2020-09-28 16:19:53 UTC,500013740,500003740,false,10000,0
9e68928efb9a24d1ccb67058d1a84d752eb0ed2c48f1937a29b58e885f1f9bd7,988099,2020-09-28 16:18:09 UTC,277134523458,277134521365,false,2093,988087
358f331dfee0886b31cb30b5090d3f7408af24844cdec80652aecd728177672e,988098,2020-09-28 16:17:46 UTC,83235151,83226606,false,8545,0
5291c7379af540a42f96813807e188c914f419e7f49bf34b93fe365b5d020446,988098,2020-09-28 16:17:46 UTC,709045290,708996035,false,49255,0
0f337c23246f96560d717045a04e1e77b38b197c41bf291266eeca9fe7a4ef5f,988098,2020-09-28 16:17:46 UTC,119731917,119725479,false,6438,0
3e08dd8e02771ca35e2c2e7b2bc4d8059702e46b6e8cc94a51e545060fd412a2,988097,2020-09-28 16:16:18 UTC,1234584302,1234582042,false,2260,0
f28d6d3dbf673c38f62ceaf4e444af1cd1cac55f710ffcc96db830d87053d1e6,988097,2020-09-28 16:16:18 UTC,209496635,209493675,false,2960,0
566aa0d281c26a2a44f797d8953dd066dc047cdf2b7c9d7f30f1ca177469e89a,988097,2020-09-28 16:16:18 UTC,52206857,52158857,false,48000,0
c2b60cbd03d742b10bedb15e4d9c72490afbc9c8751ea6f622b771e50f6ca001,988096,2020-09-28 16:14:38 UTC,14079763,14021307,false,58456,988014
c58aa416527f52541a8fb813f4acd0ba19c14bdbf65e4d68e171dbce7ece4106,988096,2020-09-28 16:14:38 UTC,369775219,369772959,false,2260,0
9b687cf200775eee44635ce2f1a716ba4443ce03e827ac1fc59c1db016ac989d,988096,2020-09-28 16:14:38 UTC,14716340,14710462,false,5878,988085
4beaf9b80c946cea9e0c822c1609a40cd2642be1c722c42176a53de32de1210c,988096,2020-09-28 16:14:38 UTC,1199932762,1199864402,false,68360,0
2634fb196328ca5878f6bc2c084bf5cf4c75a55677f1678b46f8c7bc066274a9,988096,2020-09-28 16:14:38 UTC,411542011,411501383,false,40628,0
5c786c783c54c405fb37890162d04212dfc70933910a887db4950b4d30a8a3b7,988096,2020-09-28 16:14:38 UTC,3078697,3075297,false,3400,0
d680c23f367617b2bb1fc006842325efae316a68869efbd3cff3bda8c699dda9,988096,2020-09-28 16:14:38 UTC,340470220,340467960,false,2260,0
e2461347148b29c7cd3d30af5366903e92537110108d8c83c4d235512625c07e,988096,2020-09-28 16:14:38 UTC,83285137,83276592,false,8545,0
08ea6e3a63c85df308267ddbcc07cb32bfae65e23e2a339aa6db1fea43b21ef5,988096,2020-09-28 16:14:38 UTC,60715041503,60715041403,false,100,988085
b40db401ff0b6e3e370aa84af1bc54a6318a9b3131a5fa36f2c0a65c855019ac,988096,2020-09-28 16:14:38 UTC,7042237,7039277,false,2960,0
da551fe07f62442fe90dbe3bba87d46ca0fcc408db0f382d15e6582a62acb7e7,988096,2020-09-28 16:14:38 UTC,45438546,45411467,false,27079,987991
5fdabeba655a6547edb6a8664a45701dd92a6f537d844c38fb2ba7c4cf3dd471,988095,2020-09-28 16:09:38 UTC,1985059611,1985049611,false,10000,0
42de13e38fd00e8ffc5cf839efb2528f56ade77be1ad9f76133cc5d8fbfdc5a1,988095,2020-09-28 16:09:38 UTC,239042673,239039713,false,2960,0
3b17df38a838e3d0ed1200a59b5f2eb367705e17111b18cab9ace76afe3bd283,988095,2020-09-28 16:09:38 UTC,277262917484,277262915100,false,2384,988084
ff6e1f53311a1aea89a80a69fb05a4c1b5f462b5535e1a638b128499f21b22b4,988094,2020-09-28 16:08:32 UTC,18865349807,18865339807,false,10000,0
4131ed1e8342bff1323c9bba48620f5a9f803ef82dfa189a474086e9aaeea98c,988094,2020-09-28 16:08:32 UTC,10000,,false,10000,0
da6ba234e96478d853298391398bf01eb3b694ab14d3e24a749f79d4f6cc583c,988094,2020-09-28 16:08:32 UTC,502727498,502717498,false,10000,0
9019d7f872677a4ab669507b42cbc2260893d8c8a3b2ae5ae5a1c1bad4d892db,988094,2020-09-28 16:08:32 UTC,4424100000,4424093000,false,7000,0
f521edfb4a7a3085f8bb8244a08cb678974f4f2c9a3619d7c1ed931683027427,988094,2020-09-28 16:08:32 UTC,2000286767,2000276767,false,10000,0
64792add1f5ebf438b8d74d814796bdbd4505c3067589ab87051c86df667a59e,988094,2020-09-28 16:08:32 UTC,6500276542,6500266542,false,10000,0
6592337a5e8fd6a3e45796b5ef87435ead6cce6d033c88829e8ffe7e02f6e2da,988094,2020-09-28 16:08:32 UTC,209664203,209661243,false,2960,0
1f518a0c08ef47196827423dda5b07424e79dc89602efeb4c23049b16e5f3853,988093,2020-09-28 16:05:11 UTC,1500772945,1500762945,false,10000,0
fe86d80023b4f7b413bb1520dd13d79d8812bca5e7820bd19394d7ca8a231681,988093,2020-09-28 16:05:11 UTC,19212715061,19212705061,false,10000,0
b1a6ca1e9b68ed7fca60f50dfd50c4d29f785dff216a8abb0e948ef19ba4396e,988093,2020-09-28 16:05:11 UTC,7195622,7192662,false,2960,0
2e5e4e932831b6c468f30a19ced206bc382c500efa9586ec9e97aa380e7db814,988093,2020-09-28 16:05:11 UTC,3500243785,3500233785,false,10000,0
1c8a254a11ce32a0cc507a47e4ccaf5ed76279878e3fa9040a0d2294ce0dbe3a,988093,2020-09-28 16:05:11 UTC,34849604960,34849602867,false,2093,988081
9742ff0944705ff8232e2a68c7861e0abe80b65dda1ad54cdc5772c0e2b1035d,988093,2020-09-28 16:05:11 UTC,325706862,325702362,false,4500,0
36cc927219657601a9036aa1ea607774a3fb48a471d1c787c33b87fe194b46c4,988093,2020-09-28 16:05:11 UTC,229851891407,229851881407,false,10000,0
e23d226b097d4c751141cbcf7c45b97d84b75c516a455fb0cef7bcebc37d0095,988091,2020-09-28 16:03:40 UTC,96182678,96168918,false,13760,0
2681700bf5642f59bb5723b42b1c8d4d0c0477c14efd41539f4ad030b888ef2b,988091,2020-09-28 16:03:40 UTC,10000,,false,10000,0
e96fe793ff06558164fe1f314740a7255d670a34e8d5fe11c8438f644f07e9ae,988091,2020-09-28 16:03:40 UTC,83401223,83392679,false,8544,0
4a6247c178922b932c425d535fc89d09700f2ccfc898a66de81d8ada2f507dd3,988090,2020-09-28 16:02:30 UTC,112400692976,112400000000,false,692976,0
c871b4764ea54be43e6b0344de66e537f9aeadbdb47eeb01fc645a1c08e64638,988090,2020-09-28 16:02:30 UTC,310000000,309999548,false,452,0
fc3a4d4be0c8f2fe795e8ec52a86944449ef1e9e42f283a76c728f854596a47f,988090,2020-09-28 16:02:30 UTC,125068279070,125068263320,false,15750,0
ada94d51c7ff2d0d0f90e618116e4e026a73dc0f0904d118bbd2822a82659518,988090,2020-09-28 16:02:30 UTC,500023740,500013740,false,10000,0
5765970f375f960b3d51739bf821be9733b8404c2f7f35884c102b46b3f318dd,988090,2020-09-28 16:02:30 UTC,847149636,847049636,false,100000,0
cfac4d3ca9de2be1fa0bd78f20dc7586d977f8aee00b81dbd47002c53f0fa7c9,988089,2020-09-28 16:01:22 UTC,607020353,606509293,false,511060,0
92a702632cfd604464ceda5c5b5ed5bef4052c04de0d46d9ed87ecbdf2268270,988089,2020-09-28 16:01:22 UTC,404808059,404804223,false,3836,988077
3bf9c33684409584f959b60e7651422cf1f3408529c42a92611ad66652aba911,988089,2020-09-28 16:01:22 UTC,239279508,239275935,false,3573,0
d16e9189b74a0281cc3ee030dd964f9ba4b74f88fac7590457b7f85b489bdcd6,988088,2020-09-28 16:00:53 UTC,83622342,83613798,false,8544,0
abb5d168f73c3288bae5ee1f6cb7cf03ef7cacc3c1070213fe4fa08818112936,988088,2020-09-28 16:00:53 UTC,46127259,46105156,false,22103,988076
7706994bcbed747ceb731a06ad057bc06b8ee12e7d374bbf0670dbb6fc33212b,988088,2020-09-28 16:00:53 UTC,866341673,866241673,false,100000,0
25598b7aedd4e9559d17289a54ed1aca46810b825c9bbfd190cba14346d59585,988088,2020-09-28 16:00:53 UTC,431492437,431482437,false,10000,0
384e0a52da480a218398f5c1702d784c6bb25af2eeb1fc6742640c22b1019850,988088,2020-09-28 16:00:53 UTC,500000000,499990000,false,10000,0
2a5d99622b9c9093c0ba0606b1f693aa6e95cfe472a429d3bfb956b3a44c8856,988088,2020-09-28 16:00:53 UTC,4424110000,4424100000,false,10000,0
f274b08b52705bb4ec58f0793998afb80988aaa368885800e55ab733ef960948,988088,2020-09-28 16:00:53 UTC,300541924680,300541922305,false,2375,988076
f811f9b56439691099ebc59d5a1aee46c4143402fbe558fd337ca6d0cf517810,988088,2020-09-28 16:00:53 UTC,14813891,14776699,false,37192,988076
b1e065e5fd8f48ef79f39c6f40a3bc5b593e358d43be414fafd3b172e7c7fe3d,988088,2020-09-28 16:00:53 UTC,1727761426,1727757881,false,3545,988076
20aea92d6c4474cedc21b9cf29bc8611e9f99873aa6fe9e2cec662ab5c9d37f6,988088,2020-09-28 16:00:53 UTC,83434804,83426260,false,8544,0
358f2dfd074889c797e0a85ef9ce5126d487176f5d35cc6594ea3019aedb21a5,988088,2020-09-28 16:00:53 UTC,10000,,false,10000,0
34201bf1460ceddb05b3ff554a03f80e285eb0f885d130e5e9e79051470ed66e,988088,2020-09-28 16:00:53 UTC,209820504,209817544,false,2960,0
6fd22297a4e5a3588abdc5bf83744797772359ed67848938e644f54646d83a74,988088,2020-09-28 16:00:53 UTC,19212725061,19212715061,false,10000,0
2ccbdbeacc7b65a643ec679d4f6f3002328090949524fa67cf4fb0492ce1b2fc,988088,2020-09-28 16:00:53 UTC,1131178874,1131169220,false,9654,988076
e41a720a0a44bc4716709347a793609011acf69609f1666988683a5fd488e511,988087,2020-09-28 15:57:55 UTC,51019892,51017442,false,2450,0
13d77accb60f868b2c12073058863ec8b20b0539c9e8f68fc49ba18819d0298f,988087,2020-09-28 15:57:55 UTC,856249636,856149636,false,100000,0
046568460cdcd7480ef1015f123e888b474aa92185a0181c32a265b6fe7f22a5,988086,2020-09-28 15:57:40 UTC,1458126819,1458058467,false,68352,0
7d5cf3522abac832a70b0e43ab2d02961725a1aad190736319e8f5352b315557,988086,2020-09-28 15:57:40 UTC,343277,340827,false,2450,0
16c7cbe5cbc7984623baf56a7236188654418a6228da7f9f307938a40a7fb1b0,988086,2020-09-28 15:57:40 UTC,499980000,499970000,false,10000,0
102d8ea3c6e2547978c8f81dc5e1f34512cacc181138fa58c8b9696007500dae,988086,2020-09-28 15:57:40 UTC,868205906,868203813,false,2093,988074
1f8d4a67e6269069b3564088f233998e006642af218a2161215b24fc4ca0b868,988086,2020-09-28 15:57:40 UTC,83753991,83745447,false,8544,0
fcc255b4f070617ac8b97fdab7ce751d2c6278201496a2abd0abef4ebc668b1e,988086,2020-09-28 15:57:40 UTC,7402700,7399433,false,3267,0
791b82d86a871eefe4d6de9b5fc2f6e38e45cc673943dbed63bca26fc283ff70,988086,2020-09-28 15:57:40 UTC,968932437,968922437,false,10000,0
66e7f567b0c5382a86f079c470b4eaeae7d0fc6c22b3fbd7a4c39bbe59bbf2b9,988085,2020-09-28 15:53:59 UTC,2000070314,2000060314,false,10000,0
1236c3a59f3df13864808f573be8f23bbbe7c0bf6af8a907c77be74a07865c71,988085,2020-09-28 15:53:59 UTC,500200899,500190899,false,10000,0
75f90163e348cbe704e6281a6ad0e5172addebbbc6c920e3352acfb2fc158f42,988084,2020-09-28 15:53:10 UTC,330074,123574,false,206500,0
dd9d64023ff9eddc7877e9cef819d7a0dc3c6103000756a4c56cbdd718b8cf48,988084,2020-09-28 15:53:10 UTC,239508062,239504489,false,3573,0
9ce39359531908ff9da258e450aa785f496f18eb77d142ea412b44b7d2dd1c53,988083,2020-09-28 15:53:01 UTC,83860951,83852407,false,8544,0
d4705ec2491a4c28452308597d5281ca33fde30db01e69f8abb7aa07de2975c7,988083,2020-09-28 15:53:01 UTC,2900892000,2900886000,false,6000,0
4386fe23f58b3f74fa6d75e364d05aa92f45163ca362e33d45cc4476dcbf0ee0,988083,2020-09-28 15:53:01 UTC,83785169,83776625,false,8544,0
22f96b7aae9586a8e66df910fcf9e74d24ef663476c8fa248c22284500039671,988081,2020-09-28 15:51:39 UTC,500210899,500200899,false,10000,0
97972d738d90184dc969eaddfd9d4bf794790d7262ea3d43c54b5ec34e28cea5,988080,2020-09-28 15:50:45 UTC,20226850,20218469,false,8381,988068
d728297c02cf33919afdbe1e7a1b20ede9ae25c405b94a9c5d3b486811453747,988080,2020-09-28 15:50:45 UTC,856511863,856411863,false,100000,0
9e28c5a492a4ea7a0483302f65dcdc0ebff44cf59bf4729bc91ce1fa56281197,988079,2020-09-28 15:50:17 UTC,84101886,84093342,false,8544,0
fe1a42e35198e902d01d3d4af702d2a459711bfc9f07d9b22acae51748db1c97,988079,2020-09-28 15:50:17 UTC,15793670,15754710,false,38960,988015
7b407f1c2f7fa5276a76fd27ed9d432394ee2debcbfba6119d4ae3d8451383dc,988079,2020-09-28 15:50:17 UTC,46943652,46920661,false,22991,988068
2c95d38a7a3ee4975b7066a94f10bfb242afef2ed272a29c8fb567a9f119b01f,988079,2020-09-28 15:50:17 UTC,69188069,69178069,false,10000,0
5daf628a015f3dd77ddf027ac6c5a2e2112287aae7cd2573ce47da7fc01f4be8,988079,2020-09-28 15:50:17 UTC,209976982,209974022,false,2960,0
3a68722988e8e5dfde18866883a258667c2526172c904e053496b2d5795603f4,988079,2020-09-28 15:50:17 UTC,141974,42754,false,99220,0
07f0f0d94fad4947ba454d9090e313fea2b54221159592f769002205cf571c5c,988079,2020-09-28 15:50:17 UTC,84023926,84015382,false,8544,0
ce7ed6bb21dae657c64205c6c6fd3f08958d55fb2dedf2fe7943010b080d80ce,988079,2020-09-28 15:50:17 UTC,83991550,83983006,false,8544,0
3cb1f08e02a1b49455d674ad2553696cdfbcac7c80ae4da97caaa799a9efbad8,988079,2020-09-28 15:50:17 UTC,52000284745,52000264285,false,20460,0
fc22d511eb3432bc7dd4745a3c3b010b0e54f82705e6b313d450a12646b0b016,988078,2020-09-28 15:48:03 UTC,12237656874,12237654614,false,2260,0
e0d8fe6fa87b9cfcb1f20172781694f0a70566b6c1e4636d253d8c1e3115decb,988078,2020-09-28 15:48:03 UTC,499990000,499980000,false,10000,0
77b8a8debdd89bda07bffeacea364589a7faf383faa7cb1d1a297429aa307cc2,988074,2020-09-28 15:45:40 UTC,84139161,84130617,false,8544,0
8dada388a328865f9726ad0c88569db4787ee604bff1392cd8a4e3170a6f2bff,988074,2020-09-28 15:45:40 UTC,10000,,false,10000,0
02088b389b54aaee55168986d292c47659e9d70e8517b2d7549c5c06e3bd152b,988073,2020-09-28 15:45:10 UTC,51010000,51000000,false,10000,0
570498dd0c1790d327610b93c983937d0b23690e94e74db7aa7580ea842353c3,988073,2020-09-28 15:45:10 UTC,500000000,499990000,false,10000,0
42504fdfcb83b4172cf84ade8ba300ad3bac9ef4f203deba321891c86e25c0eb,988073,2020-09-28 15:45:10 UTC,7597961,7595001,false,2960,0
c225d93d4f8f2c0e295dd0cfd07c79626ee0d7773c6f35452516a13ef727ad3a,988073,2020-09-28 15:45:10 UTC,2602648757,2602648305,false,452,0
9d134a344577ad47c1f3ac196cc2e755e2f8870325fb7635b09ba65a82335177,988073,2020-09-28 15:45:10 UTC,2227204665374,2227204657964,false,7410,0
d9537fbbef8376bd443372536fbcd1827f8ea34a6215feef1c17c055533366b9,988073,2020-09-28 15:45:10 UTC,84170691,84162147,false,8544,0
c7439e6180f9f8268c9c62329f6e232c1acb0811222eb4c000abd604f25867b6,988071,2020-09-28 15:43:00 UTC,84295617,84287073,false,8544,0
3a4348fc76bc28283d084a089e98ca7730adbd0b8d62573e2a181e1a9fd8e7f3,988070,2020-09-28 15:42:28 UTC,84647438,84638894,false,8544,0
390d2a9b93b71004ae454d35b0a9ef353a183b15a2d04ef9c5cd9984aa1970e8,988070,2020-09-28 15:42:28 UTC,300671097137,300671095044,false,2093,988059
6224047bee927f4ecfd0542e40094573a752fe452fde0edd5e5fe869e9ca15a4,988070,2020-09-28 15:42:28 UTC,100004964,100000000,false,4964,0
30fd297238b3f97d2b335e787bc8c9db5fbddd1bfa66de33fabdb4dda8731eb5,988069,2020-09-28 15:41:22 UTC,12687348,12677382,false,9966,0
52a25741b04d782a189c2c08e7c960499fa423c625b9cd27d82af1bbb3c06277,988068,2020-09-28 15:41:06 UTC,239877387,239874427,false,2960,0
8a1db837de08803405176a551cb20bfe9673364e8b768369a52e96ff5cb43352,988067,2020-09-28 15:41:02 UTC,10011584,10005584,false,6000,0
1200066f63982ba9851495f76a0b771a7a08aa0c5103ae3ef981e939c9e68bc8,988067,2020-09-28 15:41:02 UTC,119990000,119987939,false,2061,0
ba3a5a99ea8ee50f9a5baa5412570f7fcdf9c3ecb7f57526094a92b0e35aa7fc,988067,2020-09-28 15:41:02 UTC,16842253,16793698,false,48555,988054
d7aa9d1906e62df174553ed86b3d3eb402c2e30b7559826e93b9595e267ff911,988067,2020-09-28 15:41:02 UTC,47770744,47745121,false,25623,988056
38d75f21eac159158a78419f61be3d99cb263393058904ab90be1c921f0da257,988067,2020-09-28 15:41:02 UTC,1323598000,1323588000,false,10000,0
d64a6199936a532dfc26c1e0ba6247529e1a71cf23cf1b05c46101cd12cf06ac,988067,2020-09-28 15:41:02 UTC,13380422932,13380392932,false,30000,0
c61ce655e27e91a0017d0542a070c61927a706552e1376ce269b34b68e511c4a,988066,2020-09-28 15:39:17 UTC,2000061979,2000051979,false,10000,0
891d896f937959250eaf12565ec003a6b3c596e3dc4c75a8757e59e5ca877326,988066,2020-09-28 15:39:17 UTC,566287885,566187885,false,100000,0
56efe794ae9431e6e236ac64a15132ea087c1cc75796b50bdf506fc824dd00c1,988066,2020-09-28 15:39:17 UTC,143714139,143645787,false,68352,0
68bc6121acd87a1b9bca55d13955961344ad903c582967a438a064a7607a6001,988066,2020-09-28 15:39:17 UTC,675178566,675176306,false,2260,0
14e7e1e13f44ca24537e4037d2cba73612426def537aeec2ecbcfc69b107735d,988066,2020-09-28 15:39:17 UTC,6151200000,6151197916,false,2084,988055
c60f0a605e4fa76f2a283f1349cd1ba02846e72f4c0b9a5efa12570d1a217e0d,988066,2020-09-28 15:39:17 UTC,4384618089,4384610783,false,7306,0
e38125d9d9eb2c6f9cc906976722e0a76fe00390d8e376fb1f1ac37e7b7cbd8e,988066,2020-09-28 15:39:17 UTC,210159931,210156971,false,2960,0
3ec9ac0b1a45a1d94384230c05f14abf5a2a6349fd2401c2a56eaf89ef961fcb,988066,2020-09-28 15:39:17 UTC,7762965,7760005,false,2960,0
c74881613101894ccf3ddf298c210282a4103ec56177145a3786b4f119d912d5,988066,2020-09-28 15:39:17 UTC,499988544,499986451,false,2093,988055
4404982f44430bfb2baec5251134b31023a434bb60b3f0e2531e8031f7ac7c05,988066,2020-09-28 15:39:17 UTC,934172788,934170673,false,2115,0
64792a78f83d4c94e9a208087ef9ac02ebaddd599f2e4b8a9c2d26c30da787b5,988065,2020-09-28 15:35:38 UTC,18421904556,18421894556,false,10000,0
601eee6b7839458b3c407fdf570f7ea50456401cedfdcde3976f608b34b32d43,988065,2020-09-28 15:35:38 UTC,2200000000,2199999929,false,71,0
79b536b6961a5c035418e086592e6e1a513720cc47a1a05bc0a0627a5b77b3b6,988064,2020-09-28 15:33:00 UTC,18702830316,18702820316,false,10000,0
168b6030316dbfa8096ab6bbb15d74cfaddc0a98036271b5ad12174a99c933c1,988064,2020-09-28 15:33:00 UTC,210306830,210303870,false,2960,0
d10438e8874fb593bbbb31a52e0bbec8dd89f053e2138cfe59b25ed942f656dc,988064,2020-09-28 15:33:00 UTC,15527027,15522422,false,4605,988053
a1bf02a55242cbb4c719bc8452323f96af66a0913a8739af2c7c09871abc60b4,988064,2020-09-28 15:33:00 UTC,48599221,48571881,false,27340,988052
b998b22c0c1fd20871524e3b756119574517292025efbe82a57fe252c2cf046e,988064,2020-09-28 15:33:00 UTC,18341651,18281459,false,60192,988051
62944b8740038733c66f008a4fe8605fdabbbf3771d8b0062477f18a889bf393,988064,2020-09-28 15:33:00 UTC,240236039,240233079,false,2960,0
8faefff4a50861546403bc940f8a6c7ef54538ff7ba99bc60d968cb71543fd11,988063,2020-09-28 15:29:50 UTC,25348947,25343727,false,5220,0
c285e1907073ac1b83d4f573ba9f22277473041d647529b98c46701ee5dba071,988063,2020-09-28 15:29:50 UTC,300845596170,300845594077,false,2093,988052
92852113471c9f8970c97a591a07b061658a6ecebccf2ec3eab32e58ead3a75c,988063,2020-09-28 15:29:50 UTC,1725736805,1725729805,false,7000,0
a2de476c172d28c32c8e948447ebebd799f874785e8d334ce7f81df5bc3ec219,988063,2020-09-28 15:29:50 UTC,84772513,84763969,false,8544,0
173eaf463b43b61087a2198c9477f18e48b7a8c44a4fa206b87caa96d193c8e8,988061,2020-09-28 15:27:42 UTC,302423405563,302423403470,false,2093,988049
383f2d590b30971ba4f11fb0bb79d51d245252c9307804ca1ed2424d78902bbd,988060,2020-09-28 15:27:26 UTC,495929371,495927278,false,2093,988049
82b2182938dde7e8e02810a9270790eb2905791951d31ec14412311b96c942c3,988060,2020-09-28 15:27:26 UTC,7906146,7903186,false,2960,0
833b04d91384ad494f04e75aa388855c8f37c1574b71431319a6f08c6623874e,988060,2020-09-28 15:27:26 UTC,866511863,866411863,false,100000,0
2d8d5dd613bd86023ca64af95a7bd04cffa648faa93232228cf7e9889093e10d,988060,2020-09-28 15:27:26 UTC,800000000,799998854,false,1146,0
7595c84bf7a4078e8d7042ecc941901ca3be18ff68f52df1d6d22cc8b2a7e684,988059,2020-09-28 15:26:22 UTC,270010000,270000000,false,10000,0
2fb94198f435f007b45a6bc9d5488521b4d1e38d0003d094bf49bddbb2230a3f,988059,2020-09-28 15:26:22 UTC,877005863,876905863,false,100000,0
57e0ac71fbf31d9023832e8335f37ce5e6b6118d5b35262da92c8570a82ba57f,988059,2020-09-28 15:26:22 UTC,2531731728,2531731191,false,537,0
595a5059419770c69db6a092d2439ae79affcaf16b39547ec41a8b2e7be3a38f,988059,2020-09-28 15:26:22 UTC,1726526700,1726516700,false,10000,0
543d4c403ab126de5597db4937b312df241e54c91f124eafb443b6ca5908a362,988058,2020-09-28 15:24:58 UTC,18702840316,18702830316,false,10000,0
9e087012945eb4d095572344b94c575af9e447a352428493dac455147f2d197a,988058,2020-09-28 15:24:58 UTC,33000,30972,false,2028,0
93c51774b478643947732a39c42dbaaccefec706c406f50f2a66ea7c9ceae46d,988057,2020-09-28 15:23:11 UTC,10000,,false,10000,0
771331cdb9e8d1a315c8c60ab22287e105ac265fc98cb61e8383acb4da196f97,988057,2020-09-28 15:23:11 UTC,84817017,84808473,false,8544,0
cefe469330b3f1c61372fe945f4f9b52311babb0fca7511f0f87e16f93bef58f,988057,2020-09-28 15:23:11 UTC,501525902,501515902,false,10000,0
385d19a0627df9028b6c7e6ce0ed5b73254a2e0f9709b4fe3d6434566c66caee,988057,2020-09-28 15:23:11 UTC,210538606,210535339,false,3267,0
85c0ce3ce9b7429bc4ca61cd953424f7eb918017f94a1639bd33662ae6cf977d,988057,2020-09-28 15:23:11 UTC,18383598283,18383588283,false,10000,0
f8f63a73c32b0f3573afea6694d712726f32170ccb3983956616a2e01669a904,988056,2020-09-28 15:21:31 UTC,7373251365,7373235785,false,15580,0
366bfa6b64fa61bc3512ca3e4188c9877588f0438ad90cfd8aec4a30856ac937,988056,2020-09-28 15:21:31 UTC,19675825,19611344,false,64481,988043
fd1ccc98937d8542cd6408317ddf9dd9af36b88cd58d30a6a0aa29af7a27426a,988056,2020-09-28 15:21:31 UTC,49231129,49207283,false,23846,988043
3c136344d388f2e95805fb4847639864e2fa255f4d0a019582773e4bd9b77287,988056,2020-09-28 15:21:31 UTC,3774555421,3774552821,false,2600,0
b343f50c66fc0ebe04900b757370e8b6ba91c5bdf18623de8fbcc9d89dca7a3d,988056,2020-09-28 15:21:31 UTC,151851438,151841438,false,10000,0
bbbee8aec347b72c7311d8169d9e58f0100bbee45676323157bf4c5b87d779bb,988056,2020-09-28 15:21:31 UTC,11887011,11882398,false,4613,988044
8b01b3d7982bc9941b0e56bf7aa50b1c3a1905a1a61c1d167494a4d4f91b06aa,988056,2020-09-28 15:21:31 UTC,17176598,17171985,false,4613,988043
d9a0eb4a083e4c28a6dd0ebcee8dcc6947ce522fa65bf9036c960335dd19fea9,988056,2020-09-28 15:21:31 UTC,41105592,41103499,false,2093,987969
e177916ed9f2f7e0054350d14e109af5395e91473aa06fc2b336dc19e8908a8a,988056,2020-09-28 15:21:31 UTC,815640400,815572048,false,68352,0
59c44e36a213f4a75a803fb170e136636d6d4d3ff514e21f90ef660d4c159ac9,988056,2020-09-28 15:21:31 UTC,18383608283,18383598283,false,10000,0
69ecb55663293876848cc3b604678d1aa554c2ae67bed87f6aafe55296791ba1,988054,2020-09-28 15:19:58 UTC,363273210670,363273208287,false,2383,988042
bb8e61e65a4be6d882e0af06599bacad98e03dd3ed06a17440ec392308b464b0,988054,2020-09-28 15:19:58 UTC,501535902,501525902,false,10000,0
697a3115e495ade87804709fc3c82eba0ab54e464436c73ba46a631a5dbd695b,988053,2020-09-28 15:19:00 UTC,31600000,31596660,false,3340,988042
44a9fe46cd7f05bc6decbf6628ca3533efd2008bf08bcca281ded62b5deae7cc,988053,2020-09-28 15:19:00 UTC,77438,67438,false,10000,0
932a8578b14c6c5d029861256097dded22ae0ab5107dec70e4cc32b141df7c08,988053,2020-09-28 15:19:00 UTC,18892137372,18892127372,false,10000,0
fb323895bb4691ca65cbcb5e9dc9c869454b0b615bd6ff51d24c73fa9b8d973a,988053,2020-09-28 15:19:00 UTC,102321804,102318064,false,3740,0
cd3df1a0cac3b603c3d8343b52e473be40766dcbc0ca0abc295ba9f4c9defa0c,988052,2020-09-28 15:17:05 UTC,363322712763,363322710670,false,2093,988041
c17ad6ab1093e7a40f0d098c422c3e13004fee5b2503292c8b422e5e0b79f7ff,988052,2020-09-28 15:17:05 UTC,435316437,435306437,false,10000,0
ff09cf2717e43148ad7a3c1ba258ce281476fa34aa5e9e69a62813f2808895df,988051,2020-09-28 15:16:14 UTC,7262651,7253005,false,9646,988040
5f52b8077b051ebc20de31eda6dd5146807852787e49114005538cada6ad3740,988051,2020-09-28 15:16:14 UTC,500000000,499990000,false,10000,0
fd49ecaebeb90c7d24d70250d73c06f69ba274c915b0b1b5fe96804f0c40df5f,988051,2020-09-28 15:16:14 UTC,363343208856,363343206763,false,2093,988040
e5b59ac8bb86768fd3144be6b00b59644e6b99b3210654d6740814464a00301b,988051,2020-09-28 15:16:14 UTC,2193049169,2193049098,false,71,0
6b24c602e1da426f65cee46bc56ce60790db4b2fd595e27fc22163902375cca1,988050,2020-09-28 15:14:42 UTC,10000,,false,10000,0
edf692c0a60e4a073ac934bff8a825b011c3fd6eaae57b43ddf465c602ab7f25,988049,2020-09-28 15:14:12 UTC,242753510,242747795,false,5715,0
800c30455f5425a1940fb350e47720bfb3eea37a53c4b43ab6e409cbc91827d7,988048,2020-09-28 15:13:58 UTC,18392157372,18392147372,false,10000,0
496538815efe06645d1ba499bfafa26026b04eca1eb764a7381e84816d59135c,988047,2020-09-28 15:13:14 UTC,295275700,295273672,false,2028,0
89c4e610d9ef5bcef272784c5332d70251e4567a404590e0ec61eeb80168d8a6,988047,2020-09-28 15:13:14 UTC,408399,348759,false,59640,0
8e7ee9531e45afa0c9b95585eff9448e9bff82ae2a5aff81883ac6151ea1c3cb,988047,2020-09-28 15:13:14 UTC,2247191971363,2247191963953,false,7410,0
c9432cc0f2d0bd95909c8fe48a7b3b341bd5bf6484741f890e12412ebfddf4c3,988046,2020-09-28 15:12:26 UTC,8050101,8047141,false,2960,0
0e42f3eaf99af78dd198479b6c1b0e0a86686936d8e810688308a95c8bf866ea,988046,2020-09-28 15:12:26 UTC,500010000,500000000,false,10000,0
a59dbb272257a44542a7138cfe88a3dbc473335862bea1ec48f4d487f047b38b,988046,2020-09-28 15:12:26 UTC,499980000,499970000,false,10000,0
817fd81936d0733482f36a5b7aa23b39059afa5d03e511b9548a56649198295a,988046,2020-09-28 15:12:26 UTC,1012661,1005881,false,6780,0
ff1daac97120422c4df42775d52ea5ec74f23cc729e7e1bff2973cca1f19be05,988046,2020-09-28 15:12:26 UTC,2891001,2887644,false,3357,0
93cdbfa27cbe0fa3b338afa9cd7c7d5fefe67eb1131fb6e7b4bb5018bf68458f,988046,2020-09-28 15:12:26 UTC,85163852,85155308,false,8544,0
2a7e25f5eaab3f44abca993f4152c7dba5f76469c2de5fd2f82330d729f514c0,988044,2020-09-28 15:11:12 UTC,10000,,false,10000,0
6892cc0f1df381eea835f4409f6b1700aaa8132aeac2cdb57a8ccbf816554d0a,988043,2020-09-28 15:11:04 UTC,127713210,127688590,false,24620,0
a0511f6e0d310e7608ef3287089f1efe8c45972dc39c2441a36211353728ece0,988043,2020-09-28 15:11:04 UTC,500079228,500069228,false,10000,0
e554f1c9bb2096df6f473a2fdb7be7ce25485fa9967d30a47290c1867322d1a7,988043,2020-09-28 15:11:04 UTC,49723047,49700346,false,22701,988032
ee82c042a8c7565e1bd179bdf2e13829bcd498a9e2e9bd4c877c19606879cacc,988043,2020-09-28 15:11:04 UTC,20744768,20683448,false,61320,988032
fcfd13103968261c012e8866237d4514b21f67e3a64d843041b68a74b64645bb,988042,2020-09-28 15:09:24 UTC,332034723,332024723,false,10000,988027
bc1b5b87330807026b28b0d404bf1df6039e9fbc22a8109edfee1029d2975e26,988042,2020-09-28 15:09:24 UTC,3340355,3330355,false,10000,0
8dac3e9276e9a52ce1d48964827a0fc0c47e88929600994d8704b2fea52c4efb,988041,2020-09-28 15:08:26 UTC,2893094,2891001,false,2093,0
8351952a0cb37acaab993991d74b85ecfb4e469e1967e9592ca8c9c0ef91c627,988040,2020-09-28 15:08:16 UTC,500089228,500079228,false,10000,0
781fee6ea0945b647bf6c6a326c746dedb1ebc164079515cdf4b90df2397861d,988040,2020-09-28 15:08:16 UTC,456865151,456859151,false,6000,0
cc92e8acdc159458cd12e2da36bae843d746d8b361277408db8e2cc5f06568e2,988040,2020-09-28 15:08:16 UTC,60720168957,60720168857,false,100,988029
4f6db0d83ca97bfdbec1255f6b52a76903fa8e32b4d9572ee0f76273ef5507b1,988040,2020-09-28 15:08:16 UTC,309702635,309657875,false,44760,988037
6151286dc692b374651363a3b4c585e14e13298b265a4070a963309b278a6bba,988039,2020-09-28 15:06:08 UTC,1500021150,1500011150,false,10000,0
2918bb3fdd8d938f5a94222a11e4e3ff0c3080eb8c395593552dfe9b6ee9e11b,988039,2020-09-28 15:06:08 UTC,210684293,210681333,false,2960,0
957735fb78d1e9dafd34bf555f8891d0366e718fbdb94817ae88c397e5bcea4b,988038,2020-09-28 15:05:52 UTC,969632951,969630858,false,2093,988026
11d0740684742a2f6c34b95bb4ddd1d6a4faef89ab42efb5b554594c4323cee3,988038,2020-09-28 15:05:52 UTC,726524730,726523148,false,1582,0
29a97ff6859204b65e2bce28555656846ca33b8823e10408f97b9b5ac473b172,988038,2020-09-28 15:05:52 UTC,137268430,137251430,false,17000,0
aa0da8a4494da5654c5b91f97209f4571c25155cf7d7bae72e79c70e883a40bb,988037,2020-09-28 15:04:47 UTC,1500026074,1500016074,false,10000,0
fdf98d0a7e20cdb4256c14e87fd33394ebe9c728925c94b922f335d4f9fe33c7,988037,2020-09-28 15:04:47 UTC,1500782945,1500772945,false,10000,0
5fb0803d92ddf3a90539855e79514aa092918a59f3f8db38f6e43d2c67b831e4,988037,2020-09-28 15:04:47 UTC,238799839608,238799829608,false,10000,0
30b32cb4507f410c6edf691da7e43573e99901f893bc91ba665ca90435e9aa28,988036,2020-09-28 15:04:12 UTC,76315076710,76315074092,false,2618,0
09ebe8a95dec91fd52f7b96513daf6d5fc50ea366d127eb72c22c9801e2cec75,988035,2020-09-28 15:03:59 UTC,39005874,38999874,false,6000,0
412d80d43cca0567dd483f1f8f4599839781c0951105be24eecbe12498b55cc1,988035,2020-09-28 15:03:59 UTC,566356237,566287885,false,68352,0
0a0a93fdaf0f841f52db501a11f53967a01f39c4d8ec1652db2fe2684dd68df9,988034,2020-09-28 15:01:45 UTC,1024850912,1024847948,false,2964,988023
e997ad99997bccba34017d964809932a0067d32aada475dc8faa1bdeca8c4d00,988034,2020-09-28 15:01:45 UTC,22230367,22160683,false,69684,988022
323ce4238e825927cd818f279cfd897b3608744e57b928634ed9694845c3caac,988034,2020-09-28 15:01:45 UTC,242947445,242944485,false,2960,0
140d5f5a0ecea562a6ece81faaba3e9023719bf1a2d683e420c403145695b554,988034,2020-09-28 15:01:45 UTC,12060460,12059314,false,1146,0
aa9e02ba58f5cb456077f488066bd54e30d6eb6cd37ea633fff06fd840ad60b0,988034,2020-09-28 15:01:45 UTC,499990000,499980000,false,10000,0
8503747baaed519c9aa1716e371679cc1424bb6090b2ecd7172da78a0ac74c97,988034,2020-09-28 15:01:45 UTC,50361391,50335785,false,25606,988022
38b9e8d0b75d59a5663fd26a16ddebd2512b6ba2e0b93cca5d8e6aa688b1b7b9,988034,2020-09-28 15:01:45 UTC,17650320309,17650310309,false,10000,0
30f5ede86765065a4d5f677d0ad7c9e8d3da01187e1b4a09668fe3968b87a48e,988034,2020-09-28 15:01:45 UTC,4510,2720,false,1790,0
a5c6829160e1c48902582c8539b4b40f9f08f95f2164437cef70ddce136cb5c3,988034,2020-09-28 15:01:45 UTC,15565982,15561360,false,4622,988022
bf593fa2313eebe4a6a6e7042138974aff92f61f03af6d86a529235c2cdb165e,988034,2020-09-28 15:01:45 UTC,72794618,72792235,false,2383,988022
39f139f9e5018586ac32d77a0a11750ca6d1915178c24ed09f38ffd6ab661e5f,988033,2020-09-28 15:00:00 UTC,101012473,101000290,false,12183,988021
056de6f21e42d8cb5e83877c7a50c5107622fae07593cd6c54a335ad009ad655,988033,2020-09-28 15:00:00 UTC,9851026820,9851014445,false,12375,0
02b23c64376dc5721f9ccc0552e6eb56877ce22a8c01e8ede428e6a33a8792b2,988033,2020-09-28 15:00:00 UTC,9999900000,9999895500,false,4500,0
bf7484e56ab55a8221e4fe779cabe53819de5f2241d0ad925b09eb2a0f358d04,988033,2020-09-28 15:00:00 UTC,500000000,499990000,false,10000,0
6b341e24a590a99288fb8b807a2ccb7da415169a4c6903cc15ca8c7087f22de2,988033,2020-09-28 15:00:00 UTC,383388388718,383388386625,false,2093,988022
832b3e69d8f7a5c200749c9c4ca64b4a278229bd5ad50c1702f5a91a8798fa99,988032,2020-09-28 14:59:04 UTC,393239417631,393239415538,false,2093,988019
eebb707232063336cf8def5547d68df2624a57f94fb239f79bbb89ca03ff8fde,988032,2020-09-28 14:59:04 UTC,17651632648,17651622648,false,10000,0
b2db16a8e8ffb6622f2d248e3544f5e9dda8f523bd6ef370ed3aa0ccac874100,988030,2020-09-28 14:57:24 UTC,96955240,96910720,false,44520,988028
a4f0b3891ed29b02e3ff3ea387c1638ef6f1cafd7ca1c5f93a5240a3253e7d08,988029,2020-09-28 14:56:46 UTC,17651642648,17651632648,false,10000,0
e98548e734f14e2d28ec2f0c0ded7ad5bdd2bf9033e3d50e55bb517505ae4df8,988029,2020-09-28 14:56:46 UTC,1039419,1037326,false,2093,988018
1aaf0d52b6f77f5ca023f1e9ea27e3bef7b04db7ec0847c21c4c8c0d643121e4,988029,2020-09-28 14:56:46 UTC,16837327,16835234,false,2093,988018
9ae62c419f5768e26e3e13045bb0d9228cdef99fb693b5d19c3aed18eb817411,988027,2020-09-28 14:55:51 UTC,393763972137,393763970053,false,2084,988016
7b62bdc17c54351094c0d3f1dd3bd0b459385ed94dc3e1d71eb3f20d0d24858e,988027,2020-09-28 14:55:51 UTC,18843539465,18843529465,false,10000,0
a2cd3ee540caec6162c78e3a1bfa5049250a526e0153800dc390c6d76dd2b6cc,988027,2020-09-28 14:55:51 UTC,731312498,731308758,false,3740,0
f29981997b9e4838fb58b9887730f753ab6ab47cc86de4ac3eb227d7f0164460,988027,2020-09-28 14:55:51 UTC,8239357,8236397,false,2960,0
8a44993a4ba7d2507d439aa29b2b30308b12a4c9c9342224fe3c989b66664192,988027,2020-09-28 14:55:51 UTC,710000000,709997740,false,2260,0
a0922feb9c98fcc7b4d2ae9798e4e3c3950f447a549eb1ec5bbec06c4c03596d,988025,2020-09-28 14:53:31 UTC,85214093,85205549,false,8544,0
23052b0175efccf18d3cca8c02c9aa5ce4ad962fc600fec5910f427100ef56e1,988025,2020-09-28 14:53:31 UTC,400574087775,400574085400,false,2375,988014
b94cb47e2a4bc662b96ddda7c65017fe46e14d53b50b685d2937d18286455901,988024,2020-09-28 14:52:25 UTC,23569596,23506807,false,62789,988012
eec670917215371347230686c2029b76e5f8df2d72bb871c53763f6071a0695f,988024,2020-09-28 14:52:25 UTC,210999217,210996257,false,2960,0
6efae5ae8a3dcac77ec58437c361e506f938e18b7ce75b19bddaff767105b142,988024,2020-09-28 14:52:25 UTC,12084460,12060460,false,24000,0
98bb6d2e5cf0a054f0c1c782a0154b695b600c8766a493d0e09e0add0908370e,988024,2020-09-28 14:52:25 UTC,85285020,85276476,false,8544,0
4d84fe75bfd57d77acf62c419f4051c7dcf8c723e9d237982ce22c0274255a35,988024,2020-09-28 14:52:25 UTC,420910590158,420910587775,false,2383,988013
d83d46560c7f82a04c575b55c32c9eeb0bb2d7168ee1d6650aa48824a28a7c4d,988024,2020-09-28 14:52:25 UTC,51161547,51132438,false,29109,988012
008b5fa0785c6d71150a636add676959f51c5920b312444e7d7c78087e6ebc4d,988024,2020-09-28 14:52:25 UTC,2252336915,2252312421,false,24494,0
d106ef499adbb32e1b5909233a6259edc956590f6f874a22fc1a1aa9abcc0684,988023,2020-09-28 14:50:03 UTC,73628,65788,false,7840,0
2e16486ea497f3cb8e96922275d916cbe772396592b292c57f6d655ea03f5de1,988023,2020-09-28 14:50:03 UTC,85343663,85335119,false,8544,0
a7e9d2e6c13f2e43731d6aec29c5857db70815fb4ea8fabe6d07177241901e3e,988022,2020-09-28 14:49:02 UTC,243104606,243101646,false,2960,0
0c3c9bd75cfaf15f0b007c74491a093ef381761aceca3f8fa4f5268344363f05,988022,2020-09-28 14:49:02 UTC,18843549465,18843539465,false,10000,0
b868ae3057d9e90ef0dd9f498ffef4fa8ca7607750af5b3f7beea60a962a5bb6,988022,2020-09-28 14:49:02 UTC,24300224,24270440,false,29784,988011
41f3fd0b2f08a4ff230023680226113cae11da8ae541b2a3e729a2c4e4fce110,988022,2020-09-28 14:49:02 UTC,85372835,85364291,false,8544,0
e666d25ab5f74dee843799ec6cc418ba766cea1f2cfdad59abaac74652653ad9,988022,2020-09-28 14:49:02 UTC,491125555698,491125553605,false,2093,988011
6cd7d49fefab5348751c76ac5eab2766baf9a4d04ecce6a663e910855d7dda9a,988022,2020-09-28 14:49:02 UTC,721791217,721788957,false,2260,0
8c8685a4667920925dc90e0f48f60cf6ab3c23e2cf6adca3ed0bbeb8777ecfa1,988021,2020-09-28 14:45:15 UTC,667698611,667630259,false,68352,0
c7ef2ea8e5562238859a7c975fcbfe7ccf27f369109ab5bb7290cbf355b82706,988021,2020-09-28 14:45:15 UTC,491524657791,491524655698,false,2093,988009
a2ec57d8838acbe982aaeb8191daa87a7af570dbf5b4fad1b36cf7479011a3bd,988020,2020-09-28 14:44:33 UTC,10848949893,10848932893,false,17000,0
f252642370c344e39f2ead8ac540fe20476ebcd0fbee6e17a51d5e72a3e01367,988020,2020-09-28 14:44:33 UTC,53653757935,53653757853,false,82,0
085ff38d575019aa18782f3134ca7949c85b897c531f8b0a5b63da16a9fc0cc4,988020,2020-09-28 14:44:33 UTC,499981146,499971146,false,10000,0
85006733724df8daff8954c8422e1653f126535dca0dad51d62f38c37cd4fc38,988019,2020-09-28 14:42:51 UTC,43524682,43522598,false,2084,988008
5cf64d0748ef7721f1e3ba5ffd0a79f7ee5b93498fd1295be66ed675af632be9,988019,2020-09-28 14:42:51 UTC,934460283,934360283,false,100000,0
40485dc376f2a3f152b36b0a1cda7529e06ee65d05461bf32a75cf3bdaf81c62,988017,2020-09-28 14:41:20 UTC,85556738,85548194,false,8544,0
4d37795dc77787f7f0ffd0d485df0c210e422d3e34e24144cabb0b72da9cc8ec,988017,2020-09-28 14:41:20 UTC,8488663,8485703,false,2960,0
551ff33bca3c6cc345eddddeb226ffcf4c4123cf69128ef5369d58f084bb8026,988017,2020-09-28 14:41:20 UTC,52023128,51997215,false,25913,988006
a3129bce6f9397dfcc46a72349099c0bfa31fd11f5fe032636be71bf2397aafc,988017,2020-09-28 14:41:20 UTC,2250000000,2249990000,false,10000,0
34f671911cdcb99a36358cf09300aa6e37110829c32e6a861927fa551ca9edd1,988017,2020-09-28 14:41:20 UTC,5730088593,5730076218,false,12375,0
20e4e5d9e16f48d932729b5bc0a3eeb1e64eba23b52bd8bd5dd60ad55f4619cd,988017,2020-09-28 14:41:20 UTC,25208755,25140455,false,68300,988006
9cd8be754b796b5743d829b4928841e94554ad41fbe34845322ed56d6b8ea917,988017,2020-09-28 14:41:20 UTC,108674493,108653603,false,20890,0
ffa8f4c566976aed8862251d1693b68c61b899ba94f25456d7a7fd6df48170e4,988017,2020-09-28 14:41:20 UTC,499991146,499981146,false,10000,0
4bd900dad02018e7a5667d8c4aae192f2030524d59314217daf36055ca0ba974,988017,2020-09-28 14:41:20 UTC,867603963,867538858,false,65105,988005
06784e65d82648f3aba466b3904147493696116d2729d2d6d03b66d3124486b8,988016,2020-09-28 14:39:02 UTC,15885182,15855182,false,30000,0
f2f5770428aa7f313fd53496996ee129e5cdc163e4dd343e295cb494296ff1d7,988016,2020-09-28 14:39:02 UTC,12501035005,12501028854,false,6151,988004
12edb0d4a50d8ac71ccce64b21bcd45b201be379968846a6dee6cc0148a9bd6d,988016,2020-09-28 14:39:02 UTC,2250010000,2250000000,false,10000,0
425ad254d1fce568499eea1ed0dbe98c89967576e247102294d54daec886b209,988016,2020-09-28 14:39:02 UTC,191345059,191342966,false,2093,988005
64a77494abee7baeeff15cd94e65be4c614e56b8e9c184bf70d0f08448d53ce3,988016,2020-09-28 14:39:02 UTC,500001146,499991146,false,10000,0
f8ea5260d4945ba36057f663a4e5ea5ba4c4dfed95a5294d825e0aed141c2d5a,988016,2020-09-28 14:39:02 UTC,2038154,2032154,false,6000,0
1c75136c99313128414ceb50ce25bc1a9b5b5cbbfe8fdcf1557ecf68bd7a0adb,988016,2020-09-28 14:39:02 UTC,85645644,85637100,false,8544,0
22a2404efc82570e48596dc75aaebbd3a0a0dc481ecf9444b5ae8b488ac08ea9,988012,2020-09-28 14:36:42 UTC,1500131864,1500121864,false,10000,0
dd664a1fe827f1bfe29d5fe72b331ef19088e64470b693bb9cc1266c7e3d3795,988012,2020-09-28 14:36:42 UTC,1253860247302,1253860245209,false,2093,988001
470d863c033db3f4b1f1172f489bd364b8cb1724007f5874961d6584423e163b,988012,2020-09-28 14:36:42 UTC,500152660,500142660,false,10000,0
2ec162fd676dc566708919614349d3ffcedaad5ee39580930b0ccfd95aa95fe9,988012,2020-09-28 14:36:42 UTC,54364473259,54364373259,false,100000,988001
e0a20738fad9a566effc1849f25e7272966f0ffa8b5da6d7ca580aed15a2257b,988012,2020-09-28 14:36:42 UTC,7274559501,7274555421,false,4080,0
c410b8b0335baa9613433de6ba1b02833086f42ad6990e4360b4b7bcc1ae8ed1,988012,2020-09-28 14:36:42 UTC,85687160,85678616,false,8544,0
82afafe4da40f30e269f6b83a97337dcb9eeab70309710cb87da6d8b2aa6154a,988012,2020-09-28 14:36:42 UTC,85924796,85916252,false,8544,0
f894c3bff7d949230d401082085695f18b8719634fcc4d4a38b1b09edc37663a,988012,2020-09-28 14:36:42 UTC,493482854997,493482852913,false,2084,988000
f814c624d5a8deecb8b284e78af74a1b59814b0bbef964080045c591fa11c512,988012,2020-09-28 14:36:42 UTC,243564073,243560806,false,3267,0
1ede45c51bd101d0a86cb7d071394189406d95f40c1e4a6b7fc7310f8ed74902,988012,2020-09-28 14:36:42 UTC,211165520,211162560,false,2960,0
04e414a45fc268d73d0fcf1f3b6ea7228e8fd496d10e47d719a164e165d55a7f,988012,2020-09-28 14:36:42 UTC,85962893,85954349,false,8544,0
2fef331b3415f126f019dc0af40a0881226db98f641a4e88971c6b9b368627a0,988011,2020-09-28 14:32:07 UTC,86011804,86003260,false,8544,0
c641f19e4b771e6c870d5ae47293016f72e7b33ba8ae46bd3e513fe371e7e006,988011,2020-09-28 14:32:07 UTC,423043727,423033727,false,10000,0
7b7bb6871b9d618d97976df837cabed6b4712a27965ce219dd5743f32174593f,988011,2020-09-28 14:32:07 UTC,8678484,8675217,false,3267,0
b13e003748f99b40d2eb16ccc72161e9b72ec907bfca22ccdd443eaddd787eed,988011,2020-09-28 14:32:07 UTC,918060408,918058488,false,1920,0
04e67e5efc0611ae166b110ae9d3705e26186e397ea3530b1f222983bd47b662,988011,2020-09-28 14:32:07 UTC,4523571235,4523560270,false,10965,0
d90bcfc46470943cf3a712237d80a9434dca5fb1cfd59a68c082d43b87a3d492,988011,2020-09-28 14:32:07 UTC,200051134,200047777,false,3357,988000
132d53f107bde140be03e099380dc9b963dd4867507e7eb2fc815b5e5ba8e6bd,988011,2020-09-28 14:32:07 UTC,131041784492,131041782232,false,2260,0
785e2069563b305ceaa61b41eb95a83705fab7529f8ba110cef2d1b5c9a1050f,988011,2020-09-28 14:32:07 UTC,1511371138,1511364138,false,7000,0
c1dd34e58b4bc8cc9b5150a69d753305022fefaaaf3e3955e08fe46f6b885cd0,988011,2020-09-28 14:32:07 UTC,768442416,768438676,false,3740,0
bab4fc36070e36badf83a9e0e3645724082fba0864d0a8550894070f3db3cb8a,988011,2020-09-28 14:32:07 UTC,500100000,500090000,false,10000,0
03251330313bd583c445104fe91e732677068a3e7bd8c0178b0d4600de8092d4,988011,2020-09-28 14:32:07 UTC,12807570,12805650,false,1920,0
b5efc054a14da665afc906cd8377ba55cbb03f4f9047d106d2c49a5db495236d,988011,2020-09-28 14:32:07 UTC,26746278,26683266,false,63012,988000
c15178f42ed38e6ddfda3028181715f5f7d1bebb819c5a543755c5a41b667a1b,988011,2020-09-28 14:32:07 UTC,5695707,5685707,false,10000,0
c9ee38d82210cce303933418e31c63c1066d59d45b81f4c35a70be222c3b7928,988011,2020-09-28 14:32:07 UTC,52595395,52570968,false,24427,988000
60d7402acef56237edde5d1da1f11c14027da9af1481c781e294e2394f592198,988009,2020-09-28 14:27:45 UTC,500110000,500100000,false,10000,0
9a836e76c6f47e18c20b8df61fc1aab2e14b789fd48053890a925f4d2a9fae1a,988009,2020-09-28 14:27:45 UTC,1163102823898,1163102816488,false,7410,0
1d66820530440e5440176d2e675ab654daa52f7cb3cb8da591f83f723b55c4df,988009,2020-09-28 14:27:45 UTC,9280580812,9280578276,false,2536,0
94f026646b3571cce5b1a0a3f4f0b4c777963a60fbfe9c22ee4528abaefc08ff,988009,2020-09-28 14:27:45 UTC,500000000,499990000,false,10000,0
eba7bfadc6fd9732cf31ad8e2dfabcba9ff57cff2681a6e28405c8617da3c9c6,988009,2020-09-28 14:27:45 UTC,425551090,425482738,false,68352,0
e6dfe9af9952adcc9f59dc60340bf2a48175e1f666cb1d8abb7c777bb163f9f9,988008,2020-09-28 14:25:32 UTC,9280590812,9280580812,false,10000,0
642ce7612d1e9492c6f4d049a8b5be67b40b8edeff60394da02274a06d586663,988008,2020-09-28 14:25:32 UTC,3224847290,3224845030,false,2260,0
16b8793999445f168eadf2f8d2a83b42e3172935c14e772e2d590aa8a9f3cc7b,988008,2020-09-28 14:25:32 UTC,339512254,339500169,false,12085,0
292786139ed5855d37ff5aa28b380449f0d3cf2860083663efb8bbcefca29b40,988008,2020-09-28 14:25:32 UTC,655083057,655081927,false,1130,0
1fe39a5bb297ea42c4c33e183efce8bf3c7fea4078c410a4fa3797fb213a3015,988008,2020-09-28 14:25:32 UTC,502032710,502018040,false,14670,987997
cf460658847fcb86153c4315aec44edcf435cfccb8f72b87b07aa902e2969a41,988008,2020-09-28 14:25:32 UTC,243748100,243744833,false,3267,0
ed01a3d955f034b6a212d4e3567ff03142cbf6d9ddd0be918b53ace4609b5de9,988007,2020-09-28 14:23:45 UTC,999989215,999987122,false,2093,987995
e9d3bc3a1f6b5e85721adefd53674ad9534dcf05ba546c935afe9ad3cba836af,988004,2020-09-28 14:22:29 UTC,999500000,999497907,false,2093,987992
b22703a5a47c930da2a88a662c2a2427cd5de3afd205c015dcf46e37c1d11e9a,988004,2020-09-28 14:22:29 UTC,5994013643,5993984743,false,28900,0
38414b53879542f6e0b5e0b3bb39dc4fb0fd6863ab3dc4affc2853975cc3bb76,988004,2020-09-28 14:22:29 UTC,14120145271,14120129691,false,15580,0
486ddf39730be8eee377582ca0e494532c8a874ea6e1410aba3b9d359f7927b0,988004,2020-09-28 14:22:29 UTC,278673928,278663928,false,10000,0
e21ef1114c6f3f02a3d00f93ec982607677cc98ed3cbff0764e1db962b610e4b,988004,2020-09-28 14:22:29 UTC,55588486,55549261,false,39225,987993
95423ebb40b9f563b9f0b82f1234ae49dd9e7061e2551489248b31932a607bff,988004,2020-09-28 14:22:29 UTC,14968851915,14968651915,false,200000,0
e02224cd7f5ef7314d9f426f1e424b09445dfa42ebf7be2a818d012d98e0d354,988004,2020-09-28 14:22:29 UTC,211495410,211491531,false,3879,0
fab502b9b82e6f9153d60440b107b646e2cc36d9cba9b11cb4f75ef383424fd7,988004,2020-09-28 14:22:29 UTC,3337465826,3337464824,false,1002,0
73dd2dee1d3826c44a9a8daf4bf548411be3fef7b8bf8c58d4b5fb88cd1b7c37,988004,2020-09-28 14:22:29 UTC,27841460,27781106,false,60354,987993
6d37a4f8a65c53d77180f65d9ee3b0a8d1b21a8a8287fe96c2f8895c3fa076f5,988004,2020-09-28 14:22:29 UTC,95760000,95712200,false,47800,0
7227ae056ad1bff0f75eba9047794f2d6e597dafde821b2bd01a1738efa634bf,988004,2020-09-28 14:22:29 UTC,18068968912,18068958912,false,10000,0
9fc791cbbe8171c0a4e7b8022d1df53ee3603256052bbb218eef668a3f6430d1,988004,2020-09-28 14:22:29 UTC,144323258,144318584,false,4674,0
4e41921e74c96cf350a3a4a0972cf9d1b7c1cecb868d45e5c635cf0f05eda3ba,988004,2020-09-28 14:22:29 UTC,390086863,390084603,false,2260,0
37e2f2d3fbe55d6182f78bd1947537120c35a4327b53d51ab880732b4271897d,988004,2020-09-28 14:22:29 UTC,9071773,9068506,false,3267,0
2548b0580b7f00caebd1cec4cac0d618714355e4b51f43e0fecc43113ef0557a,988003,2020-09-28 14:19:04 UTC,86194836,86186292,false,8544,0
2c7df9375c561f2118c6e05169f7f7627241de7d7130fdacec9ed1e5ccfe5b39,988003,2020-09-28 14:19:04 UTC,477433849,477431589,false,2260,0
6a6ab3985a2bf9dc1f6f68cf533a8032d087acd6fd5c2be78be40020a3461ea2,988003,2020-09-28 14:19:04 UTC,100000000,99997550,false,2450,0
8984bd0a83a421f21d4949351e3345f106ef3ee0f4ccb3b00b1c0db6b2088ab1,988003,2020-09-28 14:19:04 UTC,709884,627594,false,82290,0
60d8cbe8d55f0fe8f750ac56a4c9220fb3b4457ff962d46abbff1239eefd5890,988003,2020-09-28 14:19:04 UTC,102847800,102844443,false,3357,987992
da42b09c17a6b7afc8f8b7f858ee326842565683c4c2d516a977ac49735a541f,988003,2020-09-28 14:19:04 UTC,86046974,86038430,false,8544,0
ff519c360b2c474832d5a36da264cea68cbf3f77f79e10c5f1a8e1b22e9520d8,988003,2020-09-28 14:19:04 UTC,436812821,436810561,false,2260,0
85e4bab4bb0113625fabb8ad56421492030320f1a8e6f958f23269606d50bbb0,988003,2020-09-28 14:19:04 UTC,524213790,524211530,false,2260,0
80e5ed21f993259504c85eeeb77e1d5f5e57c811fcc3a569105ae7f838cdc92b,988003,2020-09-28 14:19:04 UTC,3717203785,3717201692,false,2093,987992
01fe905daec94463231d0dc3ad687d273d0fd7da176e34c45b1009ea56c83c2f,988003,2020-09-28 14:19:04 UTC,243935427,243932467,false,2960,0
f4c9fe9d22752445c0fb4073f3e0a290446f7b1047c22f828fb26ce4be8c877e,988003,2020-09-28 14:19:04 UTC,745498657,745491657,false,7000,0
e99b7578c66c9ae787ac1ae28e5b098df9a2d37ad0d4e8b58f8c81a67df4e8e0,988003,2020-09-28 14:19:04 UTC,173000000,172999548,false,452,0
2a1446ce574fd6c0067f82f4158bd180f983dcdc5da465b925d50a4d6261b0f0,988003,2020-09-28 14:19:04 UTC,211719463,211716196,false,3267,0
5a424f82f9da84637df4dc93df2b99e2024f1fd2812523864635e3d1fd24d7f9,988003,2020-09-28 14:19:04 UTC,411192004,411065049,false,126955,987992
86a70d121a00a6b3c946367a7ee951bb03723edeac5bc12b4360c7fbfb591305,988003,2020-09-28 14:19:04 UTC,18108774584,18108764584,false,10000,0
d9e011c09583c0d3a26152bce702d5e64011d56055f0ba83486edd9e7dda0461,988003,2020-09-28 14:19:04 UTC,73429748,73427655,false,2093,987992
0f1664fad8aa269f40c84dbee8042ca508db11f0d94ba24746192e73da4e4d2f,988003,2020-09-28 14:19:04 UTC,500000000000,499999997617,false,2383,987992
dd930bdeeb08ff07e702ecbcb143bf54b9d600b6832f9a75f5b7521a4d293bc8,988003,2020-09-28 14:19:04 UTC,717201692,717199599,false,2093,987992
58833f8da8c9e0f6404db6c1db69278bd3d7ca2cf3d759af4067808502870639,988002,2020-09-28 14:11:25 UTC,123939092,123921776,false,17316,0
e1688952e631602904b9d57c984f3d942d5f293d04d706201d5b2c50cdbc8244,988002,2020-09-28 14:11:25 UTC,29122093,29057065,false,65028,987990
4e96b418bed83000ddd39862641410ec941191e2f3bcbc0db2fc2d2cbd425f51,988002,2020-09-28 14:11:25 UTC,9263935,9260668,false,3267,0
926cfe3ce43b0b5b2caf17d1a3efdd0648b38cbba34c6c368cc95d15eb7fa8f5,988002,2020-09-28 14:11:25 UTC,499993267,499983267,false,10000,0
cbcf45d3d27229973c82ed0ccb6ce46acd0b699cebcff933bcdd253defb01baa,988002,2020-09-28 14:11:25 UTC,59593176,59548739,false,44437,987990
b82ac6505be7e11aae5e747e09147701656d95df2cfc74bc43d45d37082ad5cc,988001,2020-09-28 14:10:10 UTC,143798819,143730467,false,68352,0
b116d7634f7f50d055364ab4e96c08f5b8007dd6b3c4ce1340470916924f48ae,988001,2020-09-28 14:10:10 UTC,97401339,97391339,false,10000,0
a13550d8f1d7f56910d8c6e6b2918590ff6ca0aee0487cf399bcf348390ebe5d,988001,2020-09-28 14:10:10 UTC,60923167144,60923167044,false,100,987989
f3fe49b3e0eb6d2fc5869d79daf3e9ea3317eb54901674527dc83ca149faa490,988000,2020-09-28 14:08:23 UTC,825332029,825326029,false,6000,0
ab5fdbc6b9b4ba697ab91058257feed958a949c6c0b34a384ced897d40d2c0de,987999,2020-09-28 14:08:17 UTC,18108784584,18108774584,false,10000,0
d4e9b103e8a4b0963ecfd169733b47c2d4286b3c7b0bec2eea6125758fa0a625,987998,2020-09-28 14:07:25 UTC,109828077,109825984,false,2093,987987
6d03d8f0652013daa55475220932fe51e9276187d1b4e5ba4b933a693dce6ddb,987998,2020-09-28 14:07:25 UTC,18448630144,18448620144,false,10000,0
2cc3d6fc873fc2023b6e39e3241cd12276a3a030a2b73d6c9fa24e10cbf7fe61,987998,2020-09-28 14:07:25 UTC,48348987004,48348975094,false,11910,0
e5de340827658c75451be50723fd0e9a85a9c625980dbced4aaa8a1469d817d4,987998,2020-09-28 14:07:25 UTC,244100607,244097647,false,2960,0
917195dbdba854339f6ba005e0ba711f81645b0cc455b934ac30a84f9990788e,987998,2020-09-28 14:07:25 UTC,698590479,698580479,false,10000,0
ce489c65aaedfa0909bde71474bf86df4da71cccef1031f9e5c81661edd1a9eb,987997,2020-09-28 14:06:07 UTC,86225909,86217365,false,8544,0
9a08e0d5184661b617e800c1b49b2da03a85e41831acb76f537dc8f14ca78ed0,987997,2020-09-28 14:06:07 UTC,6086105382,6086093007,false,12375,0
27778c92270de9f59a87105c065b2550b3021c627c3d99ab5427ff4b860408a7,987997,2020-09-28 14:06:07 UTC,8933034924,8933033004,false,1920,0
80625e2c3a84126ef5570c7c1aa75dc1c86c55ed32305cf7aa864e203ed949ed,987997,2020-09-28 14:06:07 UTC,2000150080,2000140080,false,10000,0
60cea2f7da8229fc218f05455071fdfa65e67878431bd846dcfa8c8aa35c3047,987997,2020-09-28 14:06:07 UTC,2500537549,2500527549,false,10000,0
5906d3e56150af9308da8379f97c7a5094753b68426cf8f9acf1adf00a6995fa,987997,2020-09-28 14:06:07 UTC,500003267,499993267,false,10000,0
17f6e676a5cc71a0aac1d131a319215d52f4cb5797ca69a701804b9e0195400b,987997,2020-09-28 14:06:07 UTC,1500036074,1500026074,false,10000,0
e8d6a2c1f87c62553973c04926363dabfb6a50254f35c3e5402cc29338c0d5cc,987997,2020-09-28 14:06:07 UTC,18448640144,18448630144,false,10000,0
76467c8870998ac574eb758cbf38855ff63c4f623b4f8db1069960d26b039a2c,987996,2020-09-28 14:04:42 UTC,69186073,69183813,false,2260,0
7b7bf0b2b49bfaf3f834eb1aad9b67c5915d19554b305b846d7b25442359a036,987996,2020-09-28 14:04:42 UTC,236765878374,236765868374,false,10000,0
ad544b42cb35ccdf761e3ad26c6ad68ac87eda9695030c3c43ce8c0f433773d6,987995,2020-09-28 14:04:07 UTC,18701282375,18701272375,false,10000,0
475a477e7ecc833df302e9c48ba9226bf895db5881d05c6bf996abbc050fe197,987995,2020-09-28 14:04:07 UTC,212006946,212003067,false,3879,0
59de7faa9d1c975c573fef76b8b164ddfa89522d4dec8bc2befd42d13dad1ee0,987993,2020-09-28 14:02:20 UTC,115948188,115945928,false,2260,0
baa5ea06cb220a655aec4255f89b0ea69b1a787cf9963a7e925466336e60b893,987993,2020-09-28 14:02:20 UTC,499980000,499970000,false,10000,0
8fa7b6a3d358294042db1a489269e681a57f6453d4fbe32e83a3788a531cac9a,987993,2020-09-28 14:02:20 UTC,462463580,462461660,false,1920,0
43002b4a4fc7ed39c3cb3d4be3dd5d5620509e82d137076f987028c21c15c8af,987993,2020-09-28 14:02:20 UTC,10000,,false,10000,0
1672e544c389031c62e3bacbb8cb08469c2c5ee2e799b836a7c758fcc3036b8e,987993,2020-09-28 14:02:20 UTC,1484790000,1484780000,false,10000,0
04e8bb21e0d1b95d01dec141d071d67113a4ad733af01d3a63462545a5fbdcca,987993,2020-09-28 14:02:20 UTC,137342344,137339098,false,3246,987981
dd8e52075f001b36ad9cd968011abd1154c37a967286dd89c5e15c1aba8d6bee,987993,2020-09-28 14:02:20 UTC,500000088737,500000000000,false,88737,987979
2ee0c39bfce41962876288e1b4a070dbbc3e3322152711eefc96c0e47adf722b,987993,2020-09-28 14:02:20 UTC,18701292375,18701282375,false,10000,0
c4ab8637d39d04c4abdf0880812fb7c26d05d2e77b2c24033ed5872e52e2fe51,987992,2020-09-28 14:01:13 UTC,1267001556395,1267001554302,false,2093,987980
2f5dd80e79c078269a0cf23075eb1317fbef266a0f20257b4b5ab1d419511185,987992,2020-09-28 14:01:13 UTC,14958842,14951717,false,7125,987979
fd70d3a9667ddbeea6a2260a40b552a48fd2ea2a88488f3e06b02dfb124139bc,987992,2020-09-28 14:01:13 UTC,10213041715,10212976875,false,64840,987979
dcfd625517934a01f66ead49ac8f1332bc178e30f66b8c8eb104b70b066025a2,987991,2020-09-28 14:00:30 UTC,5947594081,5947590724,false,3357,987979
58fd5da42ecba5d8b989861a9b338b42e3d25c2e7ea6f09fc094320821b743d7,987990,2020-09-28 14:00:17 UTC,60341994,60316405,false,25589,987956
7fc5bb64376baaf5c7e0e813e8ff63b7c6045b13e1c9f54c50e8d0f42fe5de45,987990,2020-09-28 14:00:17 UTC,30955146,30880814,false,74332,987979
a21fa6e37e0e1b569a4231281bb4a9f072348f7fe2578e7f2b855ab6444fd4ba,987990,2020-09-28 14:00:17 UTC,19387504396,19387494396,false,10000,0
f1331907fa11ef3261730533cedd4610d5f2b1c8067e872e150a8cc45b597c72,987990,2020-09-28 14:00:17 UTC,9486786,9483519,false,3267,0
36d1c5d80b9a683797bd3b54432f317a016f863f69c142a5ef304e5222ddc8df,987990,2020-09-28 14:00:17 UTC,4198206400,4198196400,false,10000,987975
ad3ae11f66a112651fe12265d93ca4ed6950be55a6b4c92ccc98bd5a9e2fc6b4,987990,2020-09-28 14:00:17 UTC,499990000,499980000,false,10000,0
c9e6c075b709cae87a84fac03c05d277b13bdf416db98d0741840f9c871e97c1,987990,2020-09-28 14:00:17 UTC,1093479599,1093477339,false,2260,0
719a686cf8ca0fd776f901579de37b312bb23cfa8a989376c61c275d85ee34c8,987990,2020-09-28 14:00:17 UTC,244259037,244256077,false,2960,0
6c8bec21171b5b6eece739845f029e86c66df6a60a69e08dccb9dbee992d6b64,987990,2020-09-28 14:00:17 UTC,38146,36356,false,1790,0
05ac52ae95f54b1992b667668e7ce38e840974aacf09ef58c52a30f353728573,987990,2020-09-28 14:00:17 UTC,411325,369325,false,42000,0
3bc009192371ac7578ab96f73b91ee38a0aca75b4c647a16f0c8b5edb308401a,987990,2020-09-28 14:00:17 UTC,86277826,86269282,false,8544,0
a042691d6df22d41b050541f8e72e8ea031b48b6a11247a199adb151e05c3ba0,987990,2020-09-28 14:00:17 UTC,31643553,31274193,false,369360,987989
f4557f634c18b551c481ddb46c1a24b6887cc8e21b64321093dd4a36559928fb,987990,2020-09-28 14:00:17 UTC,7827905041,7827895686,false,9355,987979
1a7fc2aa623bcd41af780731c1f72d175e8c1d8ce34762f8d78a2c4b3121ba88,987989,2020-09-28 13:56:42 UTC,30967,29821,false,1146,0
de904fe3afd7ef95736de8c304e6327e9c0541563473ffe246b59008518c386e,987989,2020-09-28 13:56:42 UTC,1041911,1039827,false,2084,987978
71ab29816c2a4c9ff5a6d765bdd507682bb151ecb9b18f2f31f664e30d8dea3d,987986,2020-09-28 13:55:05 UTC,86312662,86304118,false,8544,0
f9e6f0fefeed8218113fcf0eee728a4d418718f68bcad727a496f41cdf0fea9b,987986,2020-09-28 13:55:05 UTC,500000000,499990000,false,10000,0
02a6d2a2e1e4701be50ce30a33e0b18190c668af6d474c035cbe51b30dc780ed,987986,2020-09-28 13:55:05 UTC,244411698,244408738,false,2960,0
54d2f8e6c633c926be071ce59bf09557d23720862f19133f32cb3a11eafde90c,987986,2020-09-28 13:55:05 UTC,212223821,212220554,false,3267,0
a49a26b786848e7c7e31b0625bc2db2e4cf619d5f65e4d821b376e82bc2ddaf7,987986,2020-09-28 13:55:05 UTC,4110700000,4110691901,false,8099,987975
7ea853df5c62b75e141e362bb10ec28978e90b9504900c432a91289362fde16e,987984,2020-09-28 13:52:12 UTC,2737696,2677696,false,60000,0
d60d0dc09f25ed7ed54429e9e0dd6d91b92690e5685e5b0d0714ab94ec056d66,987984,2020-09-28 13:52:12 UTC,54673751146,54673651146,false,100000,987973
56d4b1d56d5108445ab1906a9bf6247d11bd22062d99695e5f7daff25525de3d,987984,2020-09-28 13:52:12 UTC,4311623,4301623,false,10000,0
8f82dc16380921226b4c0fb278709a0063f4c523f5d60bc2a02ff23cae16c579,987984,2020-09-28 13:52:12 UTC,107200402,107100002,false,100400,987972
9386ba855fdbfdbe2a5cf904a8170f6d020380386dfde1be09d78c6516ada162,987983,2020-09-28 13:51:20 UTC,99999500000,99999486089,false,13911,0
414ba5fa03e1f738f47a398ba32072784f080a8622cf6dddf5d66289137f8e81,987983,2020-09-28 13:51:20 UTC,32551840,32481805,false,70035,987972
8c9a9a8e70a92a45b86c0e89311abee4ed86f5f72ee1bb418f85b7d6c8a1dab0,987983,2020-09-28 13:51:20 UTC,60816223,60792924,false,23299,987972
4e59f082446805b036e766cdbb96d6253f2a9f7a3a080b3b5639fcb4e0594461,987983,2020-09-28 13:51:20 UTC,500558891,500548891,false,10000,0
5694cd4b177c68dca75f2b5850b8731b8a12b81e31f337138a2183d6128dcc69,987983,2020-09-28 13:51:20 UTC,9720897,9717324,false,3573,0
8722f72aef35fd28d47634056d504972e0e4be71fd99a42a61dd783d57b5e597,987983,2020-09-28 13:51:20 UTC,1267169929488,1267169927395,false,2093,987971
305d81d932af56eaa0f8ffe8371680d692a81c9118998635b2a6742cc5161619,987983,2020-09-28 13:51:20 UTC,1997794997908,1997794995815,false,2093,987972
20e15d002d3bb14dc8eeb2dd89a366501c1bc772d48c9ef5196427fefe733040,987983,2020-09-28 13:51:20 UTC,20722260,20677896,false,44364,0
e19fb2272d697627fa5b61681448c7826c0806ec835a477108445e96d79242e3,987983,2020-09-28 13:51:20 UTC,162654580,162652320,false,2260,0
be620bf784cd2911b45689b43ea23e9b05f25884cca6e33223254160b84ff65e,987983,2020-09-28 13:51:20 UTC,209324852,209321112,false,3740,0
c4d2ce6f78417eecf6681774138bab9e075fb5bebd97653619d9c8bd2a2930bf,987983,2020-09-28 13:51:20 UTC,86540177,86531633,false,8544,0
c4538c7ae1f7c3ccc43ecfa7b22aa8b9a0e5d5bfa4fce9b200fe3e510a34e5e7,987983,2020-09-28 13:51:20 UTC,212492085,212488206,false,3879,0
2439b37b11c10b8f7e54156e11939ab94015e2fc237f53354fa8ed4db92bfa90,987983,2020-09-28 13:51:20 UTC,708647949,708547949,false,100000,0
fb6cab6e4478dc1fe1185c6e6ae8669ff0eb8d4a2aa6548885d53faac6007ae3,987983,2020-09-28 13:51:20 UTC,284714026,284645674,false,68352,0
b5f30b09abdcba8bcaf02e434ccf53184aae8cfbe71c2fbc81aa49c4e98d4874,987983,2020-09-28 13:51:20 UTC,65040000,65030000,false,10000,0
0ad07c6bb93a77a8aef91bff2cc8388e40e470db2755f7223c0bcb077498626e,987983,2020-09-28 13:51:20 UTC,135575468,135555044,false,20424,0
dcd550f87c81ef3431c3d81fcdd0db3c04a7bb64b30e2592bfa493838beb47c2,987983,2020-09-28 13:51:20 UTC,1465951708,1465945708,false,6000,0
6c22801748226eced2aeaeee46e78a35d05d2a7570f7dea2ca641a1da2f85fb7,987982,2020-09-28 13:45:30 UTC,8371862,8351862,false,20000,0
51a12c83a46d8b0be0525b79f29e04707670d862189fdba74ef2ded91f9b8470,987981,2020-09-28 13:45:01 UTC,1245442898,1245418898,false,24000,0
a162e0cb6166766bae37eb953172571aea91d8fe41eaa749cedcd77b2e0028d5,987981,2020-09-28 13:45:01 UTC,85277453683,85277451333,false,2350,0
db8b7af7ca4281b53940193248d3f6d191e435cd18dd19e9f4a7905a461f0529,987981,2020-09-28 13:45:01 UTC,244568258,244565298,false,2960,0
44fcf263513cc988759c0829ab6d408fab6194db23aa0b89eb306b423a252817,987981,2020-09-28 13:45:01 UTC,500568891,500558891,false,10000,0
276f26caf9407119cfd97041b7c6398414640a5e23a73749a0ca4ea31f31e074,987981,2020-09-28 13:45:01 UTC,1277070781581,1277070779488,false,2093,987969
aa1c26ee392b42b19340bc68f5d4705b84d1e162735b780319b65fe7ee27e164,987980,2020-09-28 13:43:47 UTC,1487267946,1487264206,false,3740,0
803f73cf148fbd6a459cd0cbd32541872deae8e4b8fe61a9fe38f9fb6a2cc577,987980,2020-09-28 13:43:47 UTC,18886965505,18886955505,false,10000,0
ef303f23beb32b8ce80ac3f79e45d2f2f829cfaaec312eeb51f9a13ac9bf7d7f,987980,2020-09-28 13:43:47 UTC,500021442,500011442,false,10000,0
16e2523d5b86c9e75cf8766af39726302c69cd5f8540a616d55d676ffa2a0799,987979,2020-09-28 13:42:08 UTC,250578758,250369943,false,208815,987967
ad96e9c34664da91da92b6fd8131fe91ffecd44d9a5e8c4c29dfb485ebd408ed,987979,2020-09-28 13:42:08 UTC,1278536235373,1278536233289,false,2084,987967
2cc97177a2baf1d1827fe371fa0a4d9895e8ed69cbe5d9460130e9c0f1d1107d,987978,2020-09-28 13:41:55 UTC,2514201914,2514164054,false,37860,0
3ef7802959ff773995884bdb130989c70e361ecf7551946bfdb8451eccf2f4ec,987978,2020-09-28 13:41:55 UTC,212812208,212808941,false,3267,0
527a54474cb85a35fadb807e85e56b82c0f2aa8dd6089f1cc808e0b0cb4cedef,987978,2020-09-28 13:41:55 UTC,500031442,500021442,false,10000,0
ede4bbd42989682ac252c603cdb5bda83d218608db0712db1840cd2198f4198c,987978,2020-09-28 13:41:55 UTC,10000,,false,10000,0
eadefe4c72d03b26cc7acad6ee021678853b013745689c3689cd6a5b5bbe7b94,987978,2020-09-28 13:41:55 UTC,96897497650,96897495300,false,2350,0
98e55f6c6af58c1a3a0eb780c45f707da5aa0a1186277d4893b2f3703a7eff7f,987977,2020-09-28 13:40:30 UTC,500041442,500031442,false,10000,0
5a4cc52f57be8609da7b89b7e7c057d1d44c5d36c37bd07c6ef34562111ffd1c,987977,2020-09-28 13:40:30 UTC,15506,9950,false,5556,0
6a2715829ee13d8fa7079d666db4c4b534c3d76114acc891fdcbe0f51a3309e3,987977,2020-09-28 13:40:30 UTC,33856884,33788327,false,68557,987966
798f1ef284993ea0331e7ab7375b2933a76b77c35211471a761666cea49dcd19,987977,2020-09-28 13:40:30 UTC,250,,false,250,0
7d9f254f828e4d514cfa4820eee1386fe5202aa391e20d8f3a9412f9fba8bae9,987977,2020-09-28 13:40:30 UTC,3400849550,3400847290,false,2260,0
263dee439e37881681222674c35d6ec266812d1c196c18ac7c4a3386cb8cc12a,987977,2020-09-28 13:40:30 UTC,4270179032,4270159601,false,19431,0
98436fac7f23a0f1ba7e096130b004a7f044ae98905ac54682db445fdd533234,987977,2020-09-28 13:40:30 UTC,61665263,61638222,false,27041,987966
62eedf9858e785e0ee13efbf81895b8da6e2809b233dc427430ffb077e683a84,987977,2020-09-28 13:40:30 UTC,18687366283,18687356283,false,10000,0
84706256a80a5b11c8ef945f66046e80b1aa62376b27b47b9242dcc3f07b3f4f,987977,2020-09-28 13:40:30 UTC,86569811,86561267,false,8544,0
bfcf5980bd89a08f6c4a8871ae4858d6bc9fb6c4b2de2295fb734e956aacc8b7,987976,2020-09-28 13:37:50 UTC,335392,322122,false,13270,0
53b53cbc71f90727281870f8f0d672fc8afb59d78f2663fe8e15d61b7b0b2b8b,987976,2020-09-28 13:37:50 UTC,30301196,29801196,false,500000,0
7fbb416e677d701ee45ee520de31db1fbab2a76a74be0a63ae18a88e923130c4,987976,2020-09-28 13:37:50 UTC,297774532,297772439,false,2093,987964
a499f78acb2b6f39ecbb8530aa5b2d8df135f32f478221a0db476bdfcd8a9b38,987976,2020-09-28 13:37:50 UTC,32676879,32675879,false,1000,0
f90ca5f8b65706aebb18972c1e11107bce074452e9c9d7686a5c30314324cec8,987976,2020-09-28 13:37:50 UTC,1500122699,1500112699,false,10000,0
b4b416da079397c1da2fa3c144011e2a9112757c74d7f91c880cfc20a1943dc7,987976,2020-09-28 13:37:50 UTC,18687376283,18687366283,false,10000,0
a92797217ab1545bfbfe1ad6ac35362ba0629a659f8a963a58bd026eb0ba9f02,987976,2020-09-28 13:37:50 UTC,1097776625,1097774532,false,2093,987964
efa65ab42468ba7217a6be7fe39c0e0c3cded250b3d7aee4a5942ea5c3a2927c,987976,2020-09-28 13:37:50 UTC,5397778718,5397776625,false,2093,987964
8d6398e14b8329842e22df31ddb06394c422a909bb9074d573376752729b16eb,987976,2020-09-28 13:37:50 UTC,9979190,9976230,false,2960,0
bd189a14a7e05106e58f95229adb0c4357078b620e41c6d3892b99b388816f53,987975,2020-09-28 13:35:57 UTC,651855594,651451660,false,403934,987960
6d0223962dead80524e3e1f8f1986994fcf606b965a928fe3856a98962afe7c9,987975,2020-09-28 13:35:57 UTC,121342,111342,false,10000,0
61b193ceec6a6e3bcc830e133fe87d5ef67dd4cabffecdbe2f8ff1925cf01a16,987975,2020-09-28 13:35:57 UTC,1305401057739,1305401055373,false,2366,987964
b34446765e57e5d71defbb2fa8effc59276bc1c9ddeacd346ee0a6f8a67f12d8,987973,2020-09-28 13:35:17 UTC,84000000,83999000,false,1000,0
9667f1ceb53b391f4c76c8c8edaba2d8f95a3ee34a43bfea329b3b74c8d26977,987973,2020-09-28 13:35:17 UTC,19374705791,19374695791,false,10000,0
d9d43e3a9c13937359ad429b5274b9c42ba05094236618f6b8dc9fba0ecf9218,987972,2020-09-28 13:35:08 UTC,499990005,499980005,false,10000,0
11f3e65a9dee7078d27d2764dc476b60dab8a15802bd55b41d355b9036d56ee4,987971,2020-09-28 13:34:41 UTC,86738609,86730065,false,8544,0
d5a1348d6ea54aa764cd2821414e6c5c74c1cf87b4898d329a48ec81a162e523,987971,2020-09-28 13:34:41 UTC,324204253,324188483,false,15770,0
a98ca8128f758e92347501c8f18d2d6e8d40becb9d818a12ee29417c0c501663,987969,2020-09-28 13:34:03 UTC,29230000,29220000,false,10000,0
972320bad13be1884f89feb771ec7eb20d8ebc6cfdb5a4e36264434be91c6578,987969,2020-09-28 13:34:03 UTC,97132912303,97132909613,false,2690,0
ed17201ca152a721c8b5976bb170f11a4bfc3322f45fe8da3916c830bf4a0e23,987969,2020-09-28 13:34:03 UTC,244728530,244725570,false,2960,0
5b61180514f6269506fb00751709ee60686ac35e9eda816157b0c9c9bc3063a6,987969,2020-09-28 13:34:03 UTC,18549645,18531645,false,18000,0
51f71d6291dade26aaa217e15a639755ec35701eeed23eefc6faeec2d8cabc5e,987969,2020-09-28 13:34:03 UTC,10000,,false,10000,0
8ebdbbc8536215d2dabbc834c5a4c3ca3227d43463ca1c61a0144ce5b7d06fa8,987968,2020-09-28 13:32:43 UTC,1603812133,1603770986,false,41147,987957
c8f6da7aea6c4a76c6a5664ebf3146e3b27d96bf6ad7383278142758ea5a3f32,987967,2020-09-28 13:31:55 UTC,35090506,35026889,false,63617,987955
407cf934a73ec58e5dea90cdf5efc690619cf5883cab707ece8caf64cc4c9526,987967,2020-09-28 13:31:55 UTC,62531536,62503620,false,27916,987955
a58a09144383cf0ec1ce787c00de057f22724f671731ccce68cb9f79c7bd708f,987967,2020-09-28 13:31:55 UTC,213018357,213015397,false,2960,0
5920971f27cc0b425f33e923c995fecb98897695b963fbd3e852f7342f73059d,987967,2020-09-28 13:31:55 UTC,44917263,44915229,false,2034,0
2610c458570dac816cedb9a1ede2b5fa1b561f3c693c99e1c79b67f38bc312fe,987967,2020-09-28 13:31:55 UTC,15560785,15556163,false,4622,987955
447318293ebc74b43f099309dac0ae409723567ddbe7ccca9c46cd01a05b4caa,987967,2020-09-28 13:31:55 UTC,1072053843,1071985483,false,68360,0
86161a413d53bf49d80a5fa4f375b8f4813ae4f566c78ae6076eba4dd020d62a,987966,2020-09-28 13:31:49 UTC,12250000,12244000,false,6000,0
73cf75ded511b1af6f2a20ae960f2a51f427c7af37f85c184de21f19b31c79e4,987966,2020-09-28 13:31:49 UTC,19374715791,19374705791,false,10000,0
85bf19380cbc14ee6c8c59040bc7daffea2ba712e35e35fb8ad26ba4f3379a27,987965,2020-09-28 13:27:26 UTC,53829362,53827102,false,2260,0
7a03f7f8db3a3004aa26703a470bf4c1de9534b5236945845430a6de24f1120b,987965,2020-09-28 13:27:26 UTC,544272643,544270383,false,2260,0
1e0fe923f1697e4889012d7ace7bf13f4b4ac1bb061f7ecae130f9c9fc75e23e,987965,2020-09-28 13:27:26 UTC,100000000,99997550,false,2450,0
67d55df0c399b17cdabc6f4445e32ac2ad3ce6e330b40a0220bb9598fa5eccd5,987965,2020-09-28 13:27:26 UTC,500126220,500116220,false,10000,0
f96089f033286e25a37e032ac0266d18b01ee0bfa0b796c426e2944a5fa62f45,987965,2020-09-28 13:27:26 UTC,10204725,10201765,false,2960,0
3816c128ceabca2970edae4aba71bba43d9d095259d5c6dcb1efdb7395998240,987963,2020-09-28 13:24:52 UTC,54873851146,54873751146,false,100000,987951
b54ac45f25e44ab4c2d6b2ebdd541b19643811854e45164732952196fc7a3b01,987963,2020-09-28 13:24:52 UTC,617262780,617252780,false,10000,0
0b4946186209227d91a7ce3ee089914827fcd8be45758e46c58716a1aefca6a2,987962,2020-09-28 13:24:43 UTC,1000000000,999990000,false,10000,0
2c8254c859751bde7e03262fd38beefd58ef4c6925acfe6e76ba229bc0f2893d,987962,2020-09-28 13:24:43 UTC,100021968,100019708,false,2260,0
98542e22ff0e0d9970110f5f43e79f3e0d8d37db7c64bbe152908bb44754a59f,987962,2020-09-28 13:24:43 UTC,32957,22957,false,10000,0
e65ccdd33cf313371ab1bcce14a0fae0af137c4ceb400f8982a938e220fd1687,987961,2020-09-28 13:23:41 UTC,84010000,84000000,false,10000,0
a20b58415ee974de78b94e76c4aa98d2bf495bc619d7d2eb1cd0f5181524d0bf,987961,2020-09-28 13:23:41 UTC,86783612,86775067,false,8545,0
37a7e0c8a0816eba4a34da6087f462d628164ab1eefb1a433a2809c87e32cf5c,987960,2020-09-28 13:23:08 UTC,796852986,796315497,false,537489,987949
20e8872e7f5242b4949fdd8882cf7bc7142b055c1722cd5896a8cd18e11775cd,987960,2020-09-28 13:23:08 UTC,36509664,36438801,false,70863,987852
ebe7e8edad66d2559c6ca2dd2adc9256e55bc01dc449b8aea15e716f1cbf1c5b,987960,2020-09-28 13:23:08 UTC,500010000,500000000,false,10000,0
f686ceea45f4a35e132916a3ab38cf481d90388314e5d142c24b3f95710b8e8f,987960,2020-09-28 13:23:08 UTC,86908685,86900140,false,8545,0
aedf75950bc25f55648072e87c7aa3d22d6b93c2a2a618bfe0d720c7179a73b0,987960,2020-09-28 13:23:08 UTC,100469489,100443781,false,25708,0
3c2511bccfd48f9997b783d820467fe52b22ff319c8108e1063bd40929aa0401,987960,2020-09-28 13:23:08 UTC,63139143,63110364,false,28779,987949
c358603b8a893e5668ff28883f180f239b012de9e5d06413859cf1eee46dd949,987960,2020-09-28 13:23:08 UTC,77181437,77171437,false,10000,0
7b03cbbd056dc0ce8209526f18a9c3aa21796739408dd3424497b6e935727c2f,987960,2020-09-28 13:23:08 UTC,100375380,100371640,false,3740,0
705da132847163dc86455e27936503d91d4801918be4468137ea27f150f5b4e3,987960,2020-09-28 13:23:08 UTC,149711830,149709570,false,2260,0
827682cf4e446ab1e5676543644b51a1d9d9c1a81b56764307984c1c6a07fc63,987960,2020-09-28 13:23:08 UTC,136952912,136950462,false,2450,0
023a081ff9b41fb59a3adbddee2aed03ecbe0803c26f4629e4c2b35d30b9ed8f,987960,2020-09-28 13:23:08 UTC,500010000,500000000,false,10000,0
036d99f20f1c45d56c8e2169756968e7cacfeddea107a166f18a1ab8f73d6a36,987960,2020-09-28 13:23:08 UTC,19900000,19897966,false,2034,0
9c132672e9e97347c37193a5abb9df786a1d6fbf6de083c617458bade73d8c76,987960,2020-09-28 13:23:08 UTC,244906229,244903269,false,2960,0
a04b36ac98af1de977f6bc84f20195503d92db37db1fe66b7346b18be6efce26,987959,2020-09-28 13:19:05 UTC,139683807,139681423,false,2384,987947
d29f03a6b3f2ae4a8ac284918aa93b860c5ffa056932f618f03e73ab039dd29e,987959,2020-09-28 13:19:05 UTC,118806143,117200000,false,1606143,987946
1a7f6f2cb5e4f7a2366212fb8fa9f3c6eee1c2d3890a469605b11e6438cdec30,987959,2020-09-28 13:19:05 UTC,87026454,87017909,false,8545,0
3ad0a2269993b2dd989d317bf09bb3862b6870a6b4d4ed501575e2e6d203c63c,987957,2020-09-28 13:18:11 UTC,500008976,500006892,false,2084,987946
4dfc4fb8ddb5f5a4bd42dd1cd47bd21c775672f2f722f322a92e48c652ce4dba,987957,2020-09-28 13:18:11 UTC,2755235980,2755215980,false,20000,0
3cabc5d856645999c6ad0f537cae169dcdb0c459a3b0548afa2e61f98a27a8db,987957,2020-09-28 13:18:11 UTC,103330000,103329755,false,245,987946
512663b4603ef98e107a8ec07ac5aa8c44040c85491581f54f2bd12da4648631,987957,2020-09-28 13:18:11 UTC,74010000,74000000,false,10000,0
0ff1f8f836af1cdff0dc4827efc04d08cf26384e8570e53e0d775ab1ae17efd8,987957,2020-09-28 13:18:11 UTC,515705,513255,false,2450,0
3446e98c0ed0a68e6001da6e21807c0826361746a0d402a748af717a10dd1ea4,987957,2020-09-28 13:18:11 UTC,213180601,213177641,false,2960,0
418bc020c2456c7de5446c87a9c47771abbda41992491b83dcfa3d8cdfde5225,987957,2020-09-28 13:18:11 UTC,96102,86782,false,9320,0
fd7c521ba432ae6f4d2ccf6862982608a1e31de04a7a76e739eb2a5f0dd0be91,987957,2020-09-28 13:18:11 UTC,5399000000,5398993139,false,6861,987946
7290bb0491e108870d5e9ca672fa8925d48489c8db40da45b58aa0029e917725,987956,2020-09-28 13:15:17 UTC,3953731888,3953728148,false,3740,0
317e7bb9b23d2577a5720b1255da20eb55ccb00353a7510e8d77e579551b3236,987956,2020-09-28 13:15:17 UTC,119303683,119301423,false,2260,0
e0a12f5696d321a3cd554c98173296666aad155f22dbd078c84108a48d89baf2,987956,2020-09-28 13:15:17 UTC,4241884,4237279,false,4605,987944
631a807ec2b24cf625e22b2fedc9a4450b227e9c1e6ff810b8a39bd5b5e01295,987955,2020-09-28 13:14:50 UTC,500136220,500126220,false,10000,0
03faba20680addb27a3c2bad86f2039f844c4f0b2a1153d5059f7d0d2fba723b,987955,2020-09-28 13:14:50 UTC,244758,229500,false,15258,0
cd0b2389845b409f9c376b276848f16606d7aa4cd14e151c7fc29b3e328f047c,987955,2020-09-28 13:14:50 UTC,103318116331,103318113981,false,2350,0
fc62b3c2b59f33d167fda5bc15d8328f5cd94844ba34b2f3e584d0a516ab5508,987955,2020-09-28 13:14:50 UTC,10347833,10344873,false,2960,0
a9093a129fa8e208fce95d16b19d8241620c5897365a576ea6887556c4af3e1a,987955,2020-09-28 13:14:50 UTC,143844765,143776405,false,68360,0
37fb99bc4bcbb059aed251a0a8a16ad1692a565541e20e84f41a42fcce3e1e7b,987955,2020-09-28 13:14:50 UTC,271182976,271180526,false,2450,0
101685a721e106fe4cd4598a3764f94609cd9b4ad77e25870f13c1509deaa8d3,987955,2020-09-28 13:14:50 UTC,223937354,223934818,false,2536,0
a5a201ab2d76374765536379b79f6b26c775e4e918f49fce34fd8291033c567f,987954,2020-09-28 13:13:06 UTC,111700469,111698376,false,2093,987942
560635d19c45fd19b3fe66747cead17bfbbc07bdc083b815e80cfa315e441600,987954,2020-09-28 13:13:06 UTC,583589722,583587462,false,2260,0
6ff244669b17c6c2188176fca992ec85b45445d5cd99c8f32b7718351e4daca5,987954,2020-09-28 13:13:06 UTC,500146220,500136220,false,10000,0
151518b4f2e66bdd2a6b16439973e9a1687a45c2a4d052530d1eaeada8df6083,987953,2020-09-28 13:12:21 UTC,1136668839,1136568839,false,100000,0
58cb7ca25a47211c4b594f4eaff9e8860d5f4a73cc3b2a9a2887616960941f2e,987953,2020-09-28 13:12:21 UTC,223967394,223937354,false,30040,0
42422d909051eebd419d6d0dc767c7f0577ca76f03a7354a7f30470e94de0237,987952,2020-09-28 13:10:51 UTC,177982401,177966821,false,15580,0
dcbe5e0c50dd87db54c371ba1af327ed926d2e93c142ed6555bf7657141b5370,987952,2020-09-28 13:10:51 UTC,149789145,149773565,false,15580,0
5a79393fbc493088c8de1079392168b637e35f85a8e7af19dca0b9d7f7e0e9cf,987952,2020-09-28 13:10:51 UTC,63874537,63846023,false,28514,987941
718aacf3116a23f02aee94bfedae73fe7183bad07e541a2ba704ed0833eae401,987952,2020-09-28 13:10:51 UTC,107917008,107901428,false,15580,0
b9dc20e6c16339dd3d1757c4a3f2402d4ea87258075ee9e888ace2bee7a68a6f,987952,2020-09-28 13:10:51 UTC,117287326,117271746,false,15580,0
856df26ced390dcf2621f13d9611c379c3f7b2c1b208ea926a14f485811cdabd,987952,2020-09-28 13:10:51 UTC,6681323418,6680047515,false,1275903,0
5db3273722783111e3684dfd19434c2870bdcd35d232fd0024fecd99fdb30991,987952,2020-09-28 13:10:51 UTC,85000000,84990000,false,10000,0
a6827d20dce5010cc9f53bc790fc1a0914d51bf7c645ff81ea651bbf94c2c670,987952,2020-09-28 13:10:51 UTC,165382517,165366937,false,15580,0
ab2de2b92d0a56d60e8603230c78634ca406b034204aec6d618d9410c635963d,987952,2020-09-28 13:10:51 UTC,202096407,202080827,false,15580,0
03677174aaa47e75136752de2a1d3f28d72b2fc65ef3a988f984fc4d124795a0,987952,2020-09-28 13:10:51 UTC,224459956,224444376,false,15580,0
8996aac89fb24da673fe59615cf9cd9c7d864a7926df089d946aee4bc5a3a437,987952,2020-09-28 13:10:51 UTC,112714279,112698699,false,15580,0
fe17f2f18c8297b17e3c9f3f92e7be0cf6c3c84275fb24557e19f1ce11c10838,987952,2020-09-28 13:10:51 UTC,37991822,37926137,false,65685,987941
1b3491bd04b793eec9453fcda3ad956f20881c2adeacf5775d34bdf01ff3a68a,987952,2020-09-28 13:10:51 UTC,128005473,127989893,false,15580,0
a9b7c578e5b1cc5c69350c79d0b9f314585f30e7248f591c64d0e8f9b3c0c4b6,987952,2020-09-28 13:10:51 UTC,136792633,136777053,false,15580,0
78ccd554acb51ceec309b66bd00a0ae57feaa59bd21f84282f067eed160ba5bf,987951,2020-09-28 13:08:44 UTC,2961375102,2961359522,false,15580,0
e57f544b9e83961d00eaf4f4505d175e1bb3eadce91f73067d1bd874f58018df,987951,2020-09-28 13:08:44 UTC,500018976,500008976,false,10000,0
0c1f0b76f72e67beeaae8535b1c4eeb63a7bc840e960f71e9c9abb9500906ea7,987951,2020-09-28 13:08:44 UTC,1424546208,1424530628,false,15580,0
c19279d5a5fa8a2555fa73b14f0afbbc3bf3ed4b33f72e16ae9e65d9beecd6ab,987951,2020-09-28 13:08:44 UTC,8130389612,8130374032,false,15580,0
df8412266fc5c5439f39063b094796b6852c2c54f7843ae69fac4c76698eaba7,987951,2020-09-28 13:08:44 UTC,4401647595,4401632015,false,15580,0
9a967a7920cd7d2b1b050e417f3ff2db63a3f6e9da16ab3621dcfbe62581cd12,987951,2020-09-28 13:08:44 UTC,743919502,743903922,false,15580,0
0468c13bf0ee40b274e1891d0aa0ceb6617c92b1c1c3f30216d46494cb89362f,987951,2020-09-28 13:08:44 UTC,1610738619,1610723039,false,15580,0
9390f95db5043b6af5d0748afa509c4e470c8543c9bfa0d5131be9454c899e1a,987951,2020-09-28 13:08:44 UTC,238359882,238344302,false,15580,0
ac71907aca41ac70476b95aca39b4febe10f817aa7887336e280ea5a9a7208a8,987951,2020-09-28 13:08:44 UTC,97885,95435,false,2450,0
c628ef7e8ca753bec9a8590eabbee2345c55959fd32605a3463462bedea4b55d,987951,2020-09-28 13:08:44 UTC,270941283,270925703,false,15580,0
212086db9e6dca5b28edd79aaf28efc48dd73f9871c7571efd71570f83e74c90,987951,2020-09-28 13:08:44 UTC,1000000000,999990000,false,10000,0
c470fd1b0af34bdc5d0bc819be7dcb053d03fbe338de9c6dfb1e06f245664f38,987951,2020-09-28 13:08:44 UTC,617208825,617193245,false,15580,0
1bb5c45ef87b59575a86ee95758abeb6dac25389fa36d9ca87b54b24f56cbb16,987951,2020-09-28 13:08:44 UTC,559780232,559764652,false,15580,0
942d32564df3267a83eccbded4387368e0cb32f3c1e9f366e3e9d1db83818fd8,987951,2020-09-28 13:08:44 UTC,464198067,464182487,false,15580,0
530e3cc1f64d662933c089b1a959425bc977a7ebc0cb52892dee8cc8ed67e507,987951,2020-09-28 13:08:44 UTC,311995591,311980011,false,15580,0
8ac9a1a6dd3be6f5de758ea9fd4ca6e94419b9141897a836fe0df6bac94cbc1e,987951,2020-09-28 13:08:44 UTC,2141096545,2141080965,false,15580,0
337410a41a56ee3ec8b17e2fcaf00e831e5596afd01529c891859b5b5e281b81,987951,2020-09-28 13:08:44 UTC,46078519648,46078504068,false,15580,0
6725671636d3654239cc4ece90a0f7d05b16b8273e7558d0a28c968dc1796ad1,987951,2020-09-28 13:08:44 UTC,889382506,889366926,false,15580,0
7d7b028eec0a439ede49b0dc4160198cfa73814b750b07ebf4f0787ab82b0e9b,987951,2020-09-28 13:08:44 UTC,27698274808,27698262898,false,11910,0
55d7e232a17acf6c92dc1d6b0f4ee05fbdce5e496bb592875175d2916dc93659,987951,2020-09-28 13:08:44 UTC,405107479,405091899,false,15580,0
6eaad5fcb46817c336e7027a8929f4118cc8a75a3d1316723a1c16d9127d005c,987951,2020-09-28 13:08:44 UTC,510255605,510240025,false,15580,0
73e87d22ad5a7601078bde6032f661732c72c89d09bec37e268063aab359c623,987951,2020-09-28 13:08:44 UTC,345681798,345666218,false,15580,0
a791d584e15522be0b1b12aa536e3af2589e91a2dd2cb2d3023bb3fb195b0435,987951,2020-09-28 13:08:44 UTC,365818381,365802801,false,15580,0
c66da50d5bfc2dca499c4f368dfe61ec0a0be681d4d688c4443f32d4cc55a31a,987951,2020-09-28 13:08:44 UTC,2250000000,2249990000,false,10000,0
4ac7d1a7a9c4cafb744482464ba1861eb2f1f1eff2f0e78d4581472a61c017f4,987951,2020-09-28 13:08:44 UTC,995275353,995259773,false,15580,0
35552bb7f909ffd61084cff9beb29fcb4e2f9f6e1fc93c4a10b847f18fd7fd2a,987951,2020-09-28 13:08:44 UTC,1247544254,1247528674,false,15580,0
6f33d80341b2fd2407fdf14a23014ae50614d038365c979ef81e79f243e98013,987951,2020-09-28 13:08:44 UTC,662742677,662737457,false,5220,0
4563ac62787798a0c6d84e89d19712c4c5b1ad8995ea4f3974b80c8def9f588e,987951,2020-09-28 13:08:44 UTC,87054727,87046182,false,8545,0
9830a227467bafbd151d4a479947c132255542c14882a053b36bef3a9d196dae,987951,2020-09-28 13:08:44 UTC,1086553971,1086538391,false,15580,0
7224d327d935d62c7fd4b2ccb884613876704c84075f9cbb8e49d4b3377e1ac7,987951,2020-09-28 13:08:44 UTC,33672745,33662745,false,10000,0
26398236aa599f4123cfac43c974ac7bfd0d0ef1489d88dfe0ced2fc4fe46496,987950,2020-09-28 13:04:50 UTC,235682283449,235682273449,false,10000,0
a367da8a86d91c0eeeb1df1724c4e9f32930dd10de6ff0b99ecb9d546a7733a3,987950,2020-09-28 13:04:50 UTC,2000004569,1999994569,false,10000,0
5f33f6dded0bc1ad42e92d72856c50b8d34a92ceba62bf7271b8dafc42d39fb8,987950,2020-09-28 13:04:50 UTC,2500547549,2500537549,false,10000,0
f98a6e36df7c916f8365ccf07d84bf1fbdc2d7ad16b2d552b74a367ffac52839,987949,2020-09-28 13:04:21 UTC,5216760543,5216744963,false,15580,0
20a3189a2b2b998ac5bd270b028f78d126ab49967db3debb06f5746e1bfbe563,987948,2020-09-28 13:04:06 UTC,245097958,245094691,false,3267,0
bc41d2b131b3e48fd36b7b1ce53555b0f4f0b92fd339ac423c92d7616036b0ac,987946,2020-09-28 13:03:36 UTC,1042061092,1041961092,false,100000,0
9905b0d7638d557d8e68574d52389f4d0f717b9980fa48b82461ca01f1c9a38f,987946,2020-09-28 13:03:36 UTC,18141283994,18141273994,false,10000,0
3837e99ee03c412d5c580a0af2f619811ef23226f0c1ecb7c7d6db20b049b6da,987946,2020-09-28 13:03:36 UTC,33674665,33672745,false,1920,0
36141cdb38ee2503f2638505483c6fb1682af4393b9db15e89ee16fc9b6fab66,987946,2020-09-28 13:03:36 UTC,1000060918,1000057663,false,3255,987934
50c15782c238d5614795ad5c4cd299756400965cf28113801b380e209c2b017e,987946,2020-09-28 13:03:36 UTC,6941044720,6940999960,false,44760,987944
df59f3f363efb5ed6be955fb12623382003c907a939b9d91dd2e0b91654c4fdc,987946,2020-09-28 13:03:36 UTC,64663783,64638157,false,25626,987934
e53b51ed58f3135efa3e0d40a0e3a2c8d67b040e5770151545d74c81711f1be8,987946,2020-09-28 13:03:36 UTC,1093665880,1093662625,false,3255,987935
ad882e454e41d483a6d236dc00b56bcad82b1fdab7bc943815706276f37ee05e,987946,2020-09-28 13:03:36 UTC,162076189,162074096,false,2093,987859
832e97c225f4a9e0219a527a8679b538e36b2925c19b5d845f8e0a54d95b6b57,987946,2020-09-28 13:03:36 UTC,454457,425969,false,28488,0
381e02e70d580b526ccc4abb854ef9992cf0163b3fe8801aee3ff3812bb879ac,987946,2020-09-28 13:03:36 UTC,39449996,39388669,false,61327,987934
f433c535704c004eee22839dce65284ba56bcb14f5be23ff017c5f82c45b6400,987945,2020-09-28 13:00:04 UTC,500028976,500018976,false,10000,0
f0e26e17f1f396b9d975384bad917205f38d22578dcff249f8bf4e148a701235,987945,2020-09-28 13:00:04 UTC,1305464207366,1305464205273,false,2093,987934
f1869b8191c82ecb85c5f6ecdfd42bb988fa72813f49d7e078b959dfe625ec78,987945,2020-09-28 13:00:04 UTC,18751865749,18751855749,false,10000,0
e8c940dce4bfc3e1a91bc3db64c24abada7328ef5e7786cdb4c25a4feb52b47d,987945,2020-09-28 13:00:04 UTC,461102868,461086148,false,16720,0
c4db0ddc1fa8a31af3df361b7277cc102c736fff72d9c5333f2a43089dc12a75,987945,2020-09-28 13:00:04 UTC,425765345,425696985,false,68360,0
46bca4e1146b8dae4de4c0a83c0dffcd0af28d937b3fc22b33606ee129b2aca3,987945,2020-09-28 13:00:04 UTC,106819978,106816238,false,3740,0
0ae910b240ca0a6ba697238782c314d4d4dfd02987ee15701f3741f808a00c1f,987945,2020-09-28 13:00:04 UTC,2102950151,2102939351,false,10800,0
076a21bf9f74fd639f0e37bae8b929b573336e43b960598277356f494d6bf7ce,987945,2020-09-28 13:00:04 UTC,213355733,213352773,false,2960,0
2da0a9d739af9eec7df140da8186ee79fc774a6c4c4b6918d108057eadeced74,987945,2020-09-28 13:00:04 UTC,3768794202,3768777792,false,16410,0
2f463da7ded9534716b39565d62c4c78064b2aaf75eecdd8aede999f8fb2b930,987943,2020-09-28 12:56:13 UTC,13425370195,13425340195,false,30000,0
4806775ea30c0682959d0abd4a02a26006603b203c83f116d4ba4a6ae66860b4,987943,2020-09-28 12:56:13 UTC,165748951,165746681,false,2270,0
b7ea201089c57bbb6a6897c78d29668871e66bf81898efebd5f33f78026343cc,987943,2020-09-28 12:56:13 UTC,77313549,77312549,false,1000,0
c1180acdad05fe6763d427d9cc23224f04506dbffb2c8ddd239cb58e039d079f,987943,2020-09-28 12:56:13 UTC,191694524,191692431,false,2093,987932
0d6eabd9294b78bf2c1ac6413da5e495b235900d014038c40bc1593685d8b0de,987943,2020-09-28 12:56:13 UTC,931247901,931245808,false,2093,987931
5b2b0e4d1074c4bd944390868e755fbba689929bcb4ba2a1f32a9a9d7bc9fa0d,987943,2020-09-28 12:56:13 UTC,6154849,6151449,false,3400,0
b31357cdef7d2e2f805641c639718dcc8bbc5c9e838fd7c261007aea7d1c031f,987943,2020-09-28 12:56:13 UTC,5059344872,5059021747,false,323125,0
816f7461002a3909bbe36f7604148e224943e1c0c15590876846d63ff32f8ddc,987943,2020-09-28 12:56:13 UTC,245254817,245251857,false,2960,0
8c6cb39e6e19951e51dbf84b0d39ca4f545785be7cab6e0d96c05548b4c6c37d,987943,2020-09-28 12:56:13 UTC,1220000,1214421,false,5579,987931
29e97a71c98da169d7b731f45d20390121e9f9c09d6e47330f351ec88eec801a,987943,2020-09-28 12:56:13 UTC,93043538,93041268,false,2270,0
95b1c38deb15a381864e595d45806934bc27e952f55ff99a277479d111849682,987943,2020-09-28 12:56:13 UTC,10495492,10492532,false,2960,0
b42d37f082a42dd51f17176fbb6a812435c3a69226eada6a0fdd76b1e1b1362b,987943,2020-09-28 12:56:13 UTC,102369054,102366604,false,2450,0
1cff5466714c02b97623416a44c0251aece295654464185b25b1c46630adcb8a,987942,2020-09-28 12:53:44 UTC,18751875749,18751865749,false,10000,0
97b9dfcb8f72432ef420ea3a43d774cf3874a3a781922b2f577f623157016e42,987941,2020-09-28 12:53:25 UTC,308110000,308100000,false,10000,0
c13cb93cf5f7377d7831674e16a1ae0fc571a31a0c6678d6149acb70f6fbd020,987941,2020-09-28 12:53:25 UTC,2546122740,2546119340,false,3400,0
5ae1ff9b448e07d9285c38b5e809e0ef520b6a542a2e67d33edf7c924f098d27,987940,2020-09-28 12:52:20 UTC,55273951146,55273851146,false,100000,987928
ae151e5523249d2ce58fe21cff67814d106bb58cc662f6c2fa4dd068c26b906b,987939,2020-09-28 12:52:08 UTC,854991252,854987903,false,3349,987928
2d9fcc982d18c9ba6d79fba2fe3ac11a908794361b1d72646de8dc64a236a52c,987939,2020-09-28 12:52:08 UTC,276186471,276156471,false,30000,0
cdaae4148bd5d04ee70b4eb977ae417ee45e7e7f7059d44e740943b6adffd399,987939,2020-09-28 12:52:08 UTC,519460000,519450000,false,10000,0
d5198e5eec96d54de718627c05d6b756e43e062e6917ac2b623d0d4958cd96e3,987939,2020-09-28 12:52:08 UTC,213723215,213719642,false,3573,0
eac823af81535c7eef838e1718e1221abd20605df287e9a55ba8de183b4b368b,987939,2020-09-28 12:52:08 UTC,2448672310,2448656730,false,15580,0
f2a23fd1eb4eb15dfdeb8c54a48058fc27c197bf2656ec0e7914fa0ec6daf029,987939,2020-09-28 12:52:08 UTC,633007345,632991765,false,15580,0
1f621a21247468c0d81eab91b09c321ad30906c3c69dac383b9652287121d3cb,987939,2020-09-28 12:52:08 UTC,499980000,499970000,false,10000,0
be43eecf375747ac1e3ae4e5902f7d5528a0fcf8103e03187bc38ba2baef3f80,987939,2020-09-28 12:52:08 UTC,310938,309792,false,1146,0
0b323845668d0178a2d3ff29cfd5588a7318db848b0975ce2cd0ca422a4c46aa,987938,2020-09-28 12:50:19 UTC,65309275,65287734,false,21541,987927
27545a34076cdc94f05b89f4a6d7c07ce5ccc4eced9b26fa2a0f21a1e58f4404,987938,2020-09-28 12:50:19 UTC,40896340,40830424,false,65916,987927
92fa63add14f7c29692cf26aba62353b74144f42269b2da336b5229f38a399f2,987938,2020-09-28 12:50:19 UTC,552698438,552696345,false,2093,987926
32f3fae882cbb37402069053303595847d50192bf28c8ca58b9c53b0aa22fc1f,987938,2020-09-28 12:50:19 UTC,22500,20050,false,2450,0
060adb69e32040f495cd23e9096ef7eefc5c1f5a05848f39dfb8d4b16620641e,987938,2020-09-28 12:50:19 UTC,68152800,68150716,false,2084,987927
d2d9cf36e02e91b59ae2bdf015ebf8dd2d73575f570927e297dbdc168222e8c4,987937,2020-09-28 12:49:20 UTC,499992260,499982260,false,10000,0
fe254280d5574c068fa86c802d12b00848cda82ad12ca6597735ee2ad7bcc5d6,987937,2020-09-28 12:49:20 UTC,245408504,245405544,false,2960,0
9d6170bfe09f10c679c45d12d06284950a55cdeee6083a5558ce75dc856cabe5,987936,2020-09-28 12:48:25 UTC,746548,678370,false,68178,0
fd7aee324db3d773231207a7d7b0e8a3b8c03e50be83ac35e6fb6a7fbec8fcc2,987936,2020-09-28 12:48:25 UTC,96029,86029,false,10000,0
e0fd310368b3301909ffad241e2f705fce8370a6e29a47eb6730361ed709fc9e,987936,2020-09-28 12:48:25 UTC,448257438,448247438,false,10000,0
fb197fb48eaa4b0a245501adb4abccbcaf7cac2beb5a74624ff50925e9b40438,987935,2020-09-28 12:47:29 UTC,87091364,87082819,false,8545,0
d21211bf587c0d672555683fae40d855af6ebc2451c650347c9fc3c76edd80d9,987935,2020-09-28 12:47:29 UTC,500002260,499992260,false,10000,0
4943d03d9e2d6742226b794bc44ddcaf049f33a47ce64c6c93a0350463c74d3f,987934,2020-09-28 12:46:57 UTC,196418236,196416143,false,2093,987923
4908e425c1444edbec813e127f3de1d1fdb9d420710acca9ee5d7e2eb64dcc6b,987933,2020-09-28 12:46:20 UTC,10665965,10663005,false,2960,0
f7850e2274168d4bac87516e84b0c7a4c05d69ca7c4407ba400e419c02f825e7,987932,2020-09-28 12:46:07 UTC,195917464,195915204,false,2260,0
ea1a9e9d62727f34be21c86ecbe16eea045b5126242d8d2f2d75c5e6fe4e534e,987932,2020-09-28 12:46:07 UTC,51743267,51736907,false,6360,0
2c603da428abf633959f8ee4f0b1810c252119a0e6ee84fdba72a2c65d9d387d,987930,2020-09-28 12:45:26 UTC,57670249,57660249,false,10000,0
5da25a4d52d6227a6659186a943794f3e3b20e74469ea2bb4e30aa5e0865809d,987930,2020-09-28 12:45:26 UTC,10000,,false,10000,0
d9b7bbde305a58bd9395753e295b87af09d5062b09369885bd1cb33cf6e9eda1,987930,2020-09-28 12:45:26 UTC,499990000,499980000,false,10000,0
d1c2cbb45910f1ebfdfa9b6ad9ce5222c434aa3ea06f8302d605dd13ffa8ed93,987929,2020-09-28 12:44:14 UTC,10000,,false,10000,0
964eddb25bda87bfaa8b86ef70ea80e42bc6519d1895ea0822f8e5681d7e572d,987928,2020-09-28 12:43:28 UTC,6000721380,6000715801,false,5579,987917
176d6d8fccd9b18510b5cca379759de045a2303906a3c527df748c882f52c8be,987928,2020-09-28 12:43:28 UTC,500000000,499990000,false,10000,0
cbbc157bffd0a8a1a9cb1f36c912749d485743e1c31c4b2d5bfaa5333426343b,987927,2020-09-28 12:42:21 UTC,3913724161,3913696541,false,27620,0
435c1adfbef4d1d1b6077c442758fab8083f0820027d8446460783cb4ee19c52,987925,2020-09-28 12:41:54 UTC,890566336,890550756,false,15580,0
fdd92a4c8ff7acf6f690d743caa3ac48652b1535ba77b154928f580fef25bf29,987925,2020-09-28 12:41:54 UTC,3322987506,3322971926,false,15580,0
78af4a82b2c12d6474570d77c05196980eafc49e4ebf895a60ae9228a65740cc,987925,2020-09-28 12:41:54 UTC,87451309,87442764,false,8545,0
8189dfaff1bac0637b43ff9eeb5de1be29eeb18ea48b72af2cff6ff263ac6f52,987925,2020-09-28 12:41:54 UTC,6011282528,6011266948,false,15580,0
a88a218ace1628075446cab07ca4be5f81807ad3fcc1fe23548658df41d57da9,987925,2020-09-28 12:41:54 UTC,4081740297,4081724717,false,15580,0
fe16f9aa094ef157aca5f52f7fe59bd374ad31eb16d49375f50f16ec23c06330,987925,2020-09-28 12:41:54 UTC,1704581542,1704513182,false,68360,0
502e18434b89a66e5cbaa61b6db5f2ef43d6357fc7c1d2d85e2d69059e8fad8d,987925,2020-09-28 12:41:54 UTC,431991456,431975876,false,15580,0
2d16a7d4dd9c10a2107fa302877583993b64da9fb42b4c131333bfd3ea2fcae7,987925,2020-09-28 12:41:54 UTC,386968409,386952829,false,15580,0
1a7ba9ea35360cfb7c04b9139df1814d5fd45f953782990eeb75399c4f0d57c2,987925,2020-09-28 12:41:54 UTC,1757678392,1757662812,false,15580,0
c972ecfccd1258db60cc1629bdd27d30514c00f01380e16f8d6d127468537824,987925,2020-09-28 12:41:54 UTC,1048230,1045780,false,2450,0
515296066091e9deee4ffcd0bab7895fd2601adfe448b374661f310146f6cf41,987925,2020-09-28 12:41:54 UTC,393510715,393508265,false,2450,0
9f74ebac099dfdc3b99954eb152454f877b8218514fb9f9639da27aad297ccbb,987925,2020-09-28 12:41:54 UTC,621527202,621511622,false,15580,0
5452d4b4634f05b0157025781e924701b62b9abf82299d38232caa6a6f9e8747,987925,2020-09-28 12:41:54 UTC,87248861,87240316,false,8545,0
66aba9fadbee75bcfc681b644fec2785a1fa7b72f33e8cd4eb349e1438723961,987925,2020-09-28 12:41:54 UTC,558563020,558547440,false,15580,0
f6f823ba30142aca3cd844b21708a691f110d29ed89b8a6a58beee4c6246d32c,987925,2020-09-28 12:41:54 UTC,42146209,42090436,false,55773,987903
b975abc48719fe618983b327113802aa416d4ab4c9eabc23d8acf8c102034f5c,987925,2020-09-28 12:41:54 UTC,2164801437,2164785857,false,15580,0
1a68c3968d65fd4b5aceb45efc51c07af901bca0bec008ed0280f5348bf90d84,987925,2020-09-28 12:41:54 UTC,960681815,960666235,false,15580,0
c0d27e03b72025468906b50a5383f37b2b7e69dcc82cb13454336fbc1fab1c99,987925,2020-09-28 12:41:54 UTC,87277156,87268611,false,8545,0
c03a3780fcaa3e2b7fe3366c02c4467f5881ef46f05d4290cef8be0b27363da9,987925,2020-09-28 12:41:54 UTC,165874329,165855770,false,18559,0
6b952cd81e49d0ee35ffd0ff76dafaa0674306250531f904710c0f733b912e58,987925,2020-09-28 12:41:54 UTC,724681247,724665667,false,15580,0
85c7e1bded280834fe739e4b9a129982d1e0d7ef76b8d33a71337de5b6daaab0,987925,2020-09-28 12:41:54 UTC,1154017062,1154001482,false,15580,0
2d104d8b0f08e7f14695f0573ba482ab3ba0f4a5a55fcc78ec90c0559b01e5e3,987925,2020-09-28 12:41:54 UTC,1794213762,1794198182,false,15580,0
8914e49457bf0e400151e920e195ff87a40b58fccf705af3f2b8b7b3a4e8d302,987925,2020-09-28 12:41:54 UTC,104986875,104957975,false,28900,0
52717a645b9cf8fd5769205b30d0a969508df6de7217998c4ffc19878efddf0d,987925,2020-09-28 12:41:54 UTC,65972029,65951650,false,20379,987914
45e77c4efe2c7aec29de5df123085a6c351a9c7d54e4910fde6e3eb8843c09cd,987924,2020-09-28 12:38:44 UTC,2014147435,2014131855,false,15580,0
40b7bdf6d06c56dc0b4a4b47cbba140780bddda3b0976b158d1a53d6443fea7c,987924,2020-09-28 12:38:44 UTC,85343413047,85343410697,false,2350,0
f422a80a0a85f7a882fdf405fd61c8e297725a323b6c7e6d2c9c7bf8f26e1cd3,987924,2020-09-28 12:38:44 UTC,2538386243,2538370663,false,15580,0
7371506aa74d9508dc67e205b36b8381bae32bc4bfc7e0680d7d18a179df2c13,987924,2020-09-28 12:38:44 UTC,3601047164,3601035005,false,12159,987913
24c70fc136a3407f405aa35798e83631569afc4cc79c338dc50e322b6629eb94,987924,2020-09-28 12:38:44 UTC,661354401,661338821,false,15580,0
a66b0af4a26b1ae0e772ae2aadb793c91b61d24adbfc32ecf7607845172fb0a0,987924,2020-09-28 12:38:44 UTC,1364606234,1364590654,false,15580,0
683a604206e37b539143fa4dc6b6c55352f977d5ea44439076fbf053012eac2a,987924,2020-09-28 12:38:44 UTC,214048687,214045727,false,2960,0
dce19425b8ee9becc0960a381e74fcf62c8c8fe111bab12a33dfb8637c9c52e1,987924,2020-09-28 12:38:44 UTC,39145536395,39145520815,false,15580,0
73960a50e67427127f7fd067895d9fad1929268c134ce13b6a690cb758aec87f,987924,2020-09-28 12:38:44 UTC,12074895042,12074882667,false,12375,0
1e536b8fcd3df779bd337854660494ffb72bb1d45e1a706a53b60b20521db2d0,987924,2020-09-28 12:38:44 UTC,1934631077,1934615497,false,15580,0
c969b562b579da0e722c3812187209c8d3a938092349ca3f20360e0cece966d8,987923,2020-09-28 12:37:11 UTC,572319460,572300935,false,18525,0
db7c5751d359a019c3b012feb1854ca2a120918d5821691624945d622b9ce328,987923,2020-09-28 12:37:11 UTC,5000084441,5000029241,false,55200,0
f6a2dbd6af0620a37a6c8c8d3c25e7732ba7fc259aef0886514ee98f33d6245a,987923,2020-09-28 12:37:11 UTC,87596177,87587632,false,8545,0
4e2a4c8a97a94fac45a76853743791342842299e84cc992fcf5db09873c3f1db,987923,2020-09-28 12:37:11 UTC,245683533,245680573,false,2960,0
c997565ea6080b9d1dd615f3a3ad5161c19148d05db2548b0bf0f8d2a079048e,987923,2020-09-28 12:37:11 UTC,85356970619,85356967929,false,2690,0
e2e62207ac8ff1639904bbcdd337e293b4a8d563a645cddfd5cc19a44fd9ead4,987923,2020-09-28 12:37:11 UTC,463100440,462463580,false,636860,0
3c9b9fc85b4b631b26c3b826bba6be3434098d51c7649411c1b0b59fe9ca4c22,987923,2020-09-28 12:37:11 UTC,1500000000,1499990000,false,10000,0
7810c974526da35c9acfff28779d3fdb27fceecc7346be3b7c2d5c98c9b478ef,987923,2020-09-28 12:37:11 UTC,87564593,87556048,false,8545,0
0bd25b167bf89bb9919a080810a8a59655408536c2ad369b4f21d499bb03dbc1,987923,2020-09-28 12:37:11 UTC,87732918,87724373,false,8545,0
9030735faed0ecc909c088452eed98d30b89d41214b709a6d9cc7df685df51aa,987923,2020-09-28 12:37:11 UTC,4201317969,4201311969,false,6000,0
c009f5986febcc334d7ed47707fcac7dcb43c92535fa206fe4092e67fc2f4b8d,987922,2020-09-28 12:33:37 UTC,10000,,false,10000,0
a1dbf865c4e76fa71366a576424eecf8f716ff7af43c761da91523cf4b754901,987922,2020-09-28 12:33:37 UTC,500000000,499990000,false,10000,0
f41dcd46744cea9e124d167616fdb762b918079f549dfa9c1ea3dd0a49d0c286,987922,2020-09-28 12:33:37 UTC,11388095,11384522,false,3573,0
7795780ac0f53fbf775b05aeaea9b1e96fb9f6a69f639f394d097d885b00bbe9,987922,2020-09-28 12:33:37 UTC,112334,109884,false,2450,0
ce980c0c09c9c4d7b474e54601830c8a612fd5c65c439a41d66ed562c60d543d,987922,2020-09-28 12:33:37 UTC,100000000000,99999970000,false,30000,0
6e75d95f7360edae0062fefda421e8ea49d98fc65f47b6b366b0f0233ccc417c,987922,2020-09-28 12:33:37 UTC,51557201,51555857,false,1344,0
481109b789214dc5330f985cec4490c0dd11643bd8ffd66baa44e06a0176e07a,987922,2020-09-28 12:33:37 UTC,85521171129,85521165719,false,5410,0
ab7af76ef445fee8d72a7c2a8504c4a1ad5c3e25f10bf1a229ed4409a8abdfd0,987922,2020-09-28 12:33:37 UTC,11399662,11396988,false,2674,987911
6ae4b39784e313a77375f074edbf8a2daa98ff04835afb561a72a29c7f0ce1dc,987922,2020-09-28 12:33:37 UTC,87880680,87872135,false,8545,0
6cc481d2d55e60477664c0efb547e469a0dff0b7b18d408d8659018702adb972,987922,2020-09-28 12:33:37 UTC,1307144209433,1307144207366,false,2067,987911
a80a13776073ecbc44f43c5b1d3e4b6485bc063ed9cf9c02fe733eeeaa8bb768,987922,2020-09-28 12:33:37 UTC,499990500,499980500,false,10000,0
287bb392590553cb1e72f8cc986e6944a90541ec79a4c7bfbd66c9ec2901f5c0,987922,2020-09-28 12:33:37 UTC,43562939,43494443,false,68496,987910
6b003c0c9089955f81944abb1d3993f9a69c06c52f9350df8e246d16e6c07c19,987922,2020-09-28 12:33:37 UTC,85467376403,85467373713,false,2690,0
f2fb9cd4cd8c5bd5326c5e02055c39a8a15e1199c4a692b8eacabfc2e025daa5,987922,2020-09-28 12:33:37 UTC,214239348,214236081,false,3267,0
bb5f65a49bbfbb8a92b09b32232b17d189e7b4ddc95ac1c9c900fe3824694f48,987922,2020-09-28 12:33:37 UTC,51570293,51568949,false,1344,0
1954da3a1ba94f617d3e400a5dd0ab5c8007faab60f4a81335bab12157f64305,987922,2020-09-28 12:33:37 UTC,66514959,66490205,false,24754,987910
cdb9c5c7f6e49895093c76e0e07ab9f208a300afbaec8edef232239e976c1d23,987922,2020-09-28 12:33:37 UTC,87795473,87786928,false,8545,0
60de2722fc1507e2b85d6f2a91512d260d15c76c1102dfd045c52dc002bd32f8,987921,2020-09-28 12:29:44 UTC,2250010000,2250000000,false,10000,0
d3bdedd0d8995527b5ef13ab18719d732ae69ddebe9c28da294d4fc2b97a661d,987921,2020-09-28 12:29:44 UTC,45349655,45334075,false,15580,0
d721d6ee40e197963db35944c32f075b3cf850103b39a80ed308f4aa8f962185,987921,2020-09-28 12:29:44 UTC,85560754806,85560749396,false,5410,0
0165fcb041c5cf6e1e137366f9172292163c25d2422a1badb7266f9f7ae528ae,987920,2020-09-28 12:28:30 UTC,245855948,245852988,false,2960,0
69a5eecf44fbf7e935ab534ef6bbf3ed3996fc501f7933338474f1c60e0c9b5f,987919,2020-09-28 12:28:06 UTC,85586751320,85586745910,false,5410,0
e847929de9c314647f5eed5c1662f2cb768f5c36de6a690976cb4c73b3f8de07,987919,2020-09-28 12:28:06 UTC,392264972,392254972,false,10000,0
2cfe0b00ee32fa0b70bd277f2b8563e7975db319c093c29c959596aac3008752,987917,2020-09-28 12:27:32 UTC,243612069,243609809,false,2260,0
d5a3f988acf4dfdb5fe911acfc0aeffe6b96635734b7b4d4a8471ea33dcbd769,987917,2020-09-28 12:27:32 UTC,2425500,2418720,false,6780,0
b54b9521c4eaf75793f8aa82fddd85b8c85e29a1f398391b295330894a8ce6bf,987917,2020-09-28 12:27:32 UTC,85878056749,85878051339,false,5410,0
59f41596cc03a937cc2e5df4b839f687d93478dc02e4ab31d284382be1a106bc,987916,2020-09-28 12:26:33 UTC,11581087,11578127,false,2960,0
c1ebb82d3d0d0bde381813e44122286ca3d527ff0564a58e015eec4fd761bf6f,987916,2020-09-28 12:26:33 UTC,86181596918,86181591508,false,5410,0
d1d0ba70c6626785c5187ba5eba62c285b8865b738147b68c331b183f4544d73,987916,2020-09-28 12:26:33 UTC,968972437,968962437,false,10000,0
aa72ce678ad038626d8b5f250a510342b3df32a383382674b54c3f10bf40d05f,987916,2020-09-28 12:26:33 UTC,699488679,699481090,false,7589,0
a120b7b87e4f1d035bbf49ef72ac99b77dac3f08795d09afba95ebb5e0e4cc07,987916,2020-09-28 12:26:33 UTC,86228620906,86228615496,false,5410,0
8add22441380a440e6294e98811d7882675d5643dac2032ec1d192b8c4b7bc62,987915,2020-09-28 12:24:52 UTC,139175236,139174090,false,1146,0
02971f01396aaf2be627a9adf69b0c2f7bcabfb20f74708385daba4d1c76718a,987913,2020-09-28 12:23:47 UTC,411543340,411539991,false,3349,987901
bc117fb65671ff962608dfa9a9224c8be793e1fd2b376fe0dbe4fb698a3c85ed,987913,2020-09-28 12:23:47 UTC,7398622445,7398606865,false,15580,0
a3d3ec9b1041607b6db23ab2227576eb4bd0e57cb350568ff5acde9fd66613cb,987913,2020-09-28 12:23:47 UTC,214395743,214392783,false,2960,0
2033193be793386dc407736284826fcfb4785a8daf7dc9253da8a93bfc1651cb,987913,2020-09-28 12:23:47 UTC,210046,162246,false,47800,0
17fe4feaa55007e171b39bad8582febb51ff995ef5f581b5dd6e4c25f7e1fec8,987913,2020-09-28 12:23:47 UTC,1004816400,1004800820,false,15580,0
bc1dc8cddab0c600db6f020332e33ab629d7b86ea6956460206e7dad35c81b62,987913,2020-09-28 12:23:47 UTC,284852738,284784378,false,68360,0
7eccb74afc0f62bc63278f5cc561ea4c4d7c6550b3f99d72498be0673dcd8788,987913,2020-09-28 12:23:47 UTC,2048771057,2048755477,false,15580,0
b1a2763a9e50e2cf7e130645a247a45b5da26222356e9f979d903aef8eee617f,987913,2020-09-28 12:23:47 UTC,502087256,502071676,false,15580,0
9da0809ce79055ba8a261f36d35e5f172398d7a844f1e4353412b8d54dd86233,987913,2020-09-28 12:23:47 UTC,26080703,26065123,false,15580,0
97c2fb31fb7cca09bc7d55f896cdee1eab5ed78e051bd8f250d339034fb5615f,987913,2020-09-28 12:23:47 UTC,39345695,39330115,false,15580,0
f1a95a03e6eb9cf2de5bf7b58c4d311f9ff1c8bd5965502afdfa32b43463bc3b,987913,2020-09-28 12:23:47 UTC,1506874417,1506858837,false,15580,0
5ec2385e20659bacb152bb8da2cbc6dd92d9ada3b2fea10a5af170b59517a57d,987913,2020-09-28 12:23:47 UTC,726500717,726485137,false,15580,0
33340d44f3a212644fce093fd50fe0827f97cfda39601b667062ef06eb314c32,987913,2020-09-28 12:23:47 UTC,651516227,651500647,false,15580,0
5a7a3cb527ebb1f33a6c4e7b41d04c823b68ae03b576b4077a7a311d8f39407c,987913,2020-09-28 12:23:47 UTC,1863821587,1863806007,false,15580,0
0322802c1f793c04b02f81c7ee3a23bffd4b6de2f2aadb7a5dbc1b0643753352,987913,2020-09-28 12:23:47 UTC,749251146,749235566,false,15580,0
7b20e3b99b7ecc7d0df214286109d63f6ff4b540fbc0b1697dcd2613f0e0ecea,987913,2020-09-28 12:23:47 UTC,139185236,139175236,false,10000,0
ef0162de13d5867dd0b40cb72a21398387034d80bcc7afdf59463bfb6dc88672,987913,2020-09-28 12:23:47 UTC,404770646,404755066,false,15580,0
1998e2ec70cc946015d97c607dfee1455f1e028868a226f5577f4ac44e279dec,987913,2020-09-28 12:23:47 UTC,45107873,45092293,false,15580,0
b46aa08c4ec854487e26ebf1a270f963b4e19d1a0333a1301cf13748b6ed5202,987911,2020-09-28 12:21:29 UTC,459369710,459354130,false,15580,0
4f5665617ebf951293f6889619f4f9a03ebec530daca2593d4f87c52335081d9,987910,2020-09-28 12:21:15 UTC,249642623,249627043,false,15580,0
ca0244a6db59c9e176746c50c58af0e368f5908ac4f2dcb91b782dd1ac037f30,987909,2020-09-28 12:21:07 UTC,283868154,283865770,false,2384,987898
54351f2cd304c81047fbf86909f1dcc8393d213b8fe2c5c3f6e08ea47955f63d,987909,2020-09-28 12:21:07 UTC,14866388,14859253,false,7135,987897
d345af8ca1d9a3140c010bcf7bdc84e98cb41f189cae2f81e6fb638e48b20544,987908,2020-09-28 12:20:36 UTC,89130550,89114970,false,15580,0
6eda6f58f7bf6785883fdb0742c47e5e67ef116310c27c5f7b8d35ae2ca33c5c,987908,2020-09-28 12:20:36 UTC,44572290,44514723,false,57567,987896
ae46c93bc1891c795f48f72fe8bbe9cb7e039e21dc400af2404f57193c054cc2,987908,2020-09-28 12:20:36 UTC,1047781,1045688,false,2093,987897
f1cc954b1fbfdd9ee3f0e8cb3afec033e4ac097126afb01462ff5b2d9a3e9850,987908,2020-09-28 12:20:36 UTC,68683642,68659187,false,24455,987896
0838a0bc12f0de1dcd2511699ef058040569dcc2554e18eb80bd3d16e5df14c6,987908,2020-09-28 12:20:36 UTC,660182445,660180909,false,1536,0
e859a9bff41ef3daa610cc01d296b7a54f501dff304a0443e29ff11057e84911,987908,2020-09-28 12:20:36 UTC,1307543311525,1307543309432,false,2093,987896
ecf5fe574903f625dfea531a3e5e599c829442641452a982d8b01f4e482384a9,987908,2020-09-28 12:20:36 UTC,18082600871,18082590871,false,10000,0
5792577627b1c824e5986a51bc8b7214e3d0aaf4bbc4c77be1d862aa71c7f04a,987908,2020-09-28 12:20:36 UTC,324161244,324145664,false,15580,0
09c4835cb7f76b997fae0ec18eb3ccb8a32d6dbd89bd826b0565f80a2a70f0ef,987907,2020-09-28 12:19:35 UTC,1007707038,1007607038,false,100000,0
6084680a1d9194d19f9fc7f9f92e99db7ae9cdb0ef732de05df23668b6c3acbc,987907,2020-09-28 12:19:35 UTC,1000010000,1000000000,false,10000,0
8bf446659f4a345ee7c83df936722b2f1a29320da1b7c12f1b2814d8b2bc20ce,987906,2020-09-28 12:19:05 UTC,500013338,500003338,false,10000,0
9d988f97dbac8de14784a1b87cf8617267fbb01a81c0628dfbd4d6a930335ce5,987906,2020-09-28 12:19:05 UTC,985016300,985014185,false,2115,0
ad0e1403ce48cb8b4608a5f84109bc8ee2130e773b7ec51d70c12e6e01a324a9,987906,2020-09-28 12:19:05 UTC,246008614,246005654,false,2960,0
1a68594a2cf21c17967d718a4a5dd24a3d919b7a1e63cf058438cb928d8ecc15,987906,2020-09-28 12:19:05 UTC,500006635,499996635,false,10000,0
00b0cf98b1cd3cbf07e0e3fe7def15420b46eb41607e575344eb6ed95e2359d0,987903,2020-09-28 12:15:17 UTC,171241423,171237683,false,3740,0
72fc16729b95ac972cd15341511292387d4e414cb1e34a4c5b14b845f277d1de,987903,2020-09-28 12:15:17 UTC,11759199,11756239,false,2960,0
280252c9263ceed2f5223965e1e84e96832e60a1090731da92f0401d042c2907,987902,2020-09-28 12:14:55 UTC,6001216840,6001213491,false,3349,987889
6be4e4426fd7fd7a2d055a04eb89c5cc43e6a351d8cb2c528d7c73c05da72f51,987900,2020-09-28 12:13:05 UTC,319094981,319090101,false,4880,0
c2cf1b873198da399d693617a49e2bcd70a164131528354b5e33794a2be33758,987900,2020-09-28 12:13:05 UTC,87916329,87907784,false,8545,0
3001e8a7a566e41a86ef329da038f71d7a71ac6263faaac034168b2de7400be2,987900,2020-09-28 12:13:05 UTC,3534103986,3534103915,false,71,0
24dd4fe2a87da6bd7b7b2a535bb55c693b79eaf7f6072ddb437ba8fc01f5e3e4,987900,2020-09-28 12:13:05 UTC,410500000,410498080,false,1920,0
d88c6e7fbab1812ecbc3b67964db77ae526ab45da38dbcd10e0791587d7bc141,987900,2020-09-28 12:13:05 UTC,230000000,229990000,false,10000,0
874163ac7c81ca5756826de4583d36fe51a05c56d250e0aeccc6f0a8e3e0ef09,987898,2020-09-28 12:11:47 UTC,88238632,88230087,false,8545,0
8869ed90ec306cbdb32bd446b277f9b1eb65ae2529d9b925d25564f4c53bc1c6,987898,2020-09-28 12:11:47 UTC,100000000,99997550,false,2450,0
755071e519308c78d18a7e9255ce448d214404661c8c5162b0f3333372b4261e,987898,2020-09-28 12:11:47 UTC,1309059813891,1309059811525,false,2366,987887
41f58a826c72c4a0255b5379b90af848833ca3c19dbf0d961763e361e8d04513,987898,2020-09-28 12:11:47 UTC,274333164,274329424,false,3740,0
5c66718d4863d60834da2a58ad703402ea1e95dd194dbe8896a1c3685859fa9f,987898,2020-09-28 12:11:47 UTC,152985486,152983226,false,2260,0
3cd8c55476235e6a329886294e41e92f18d9603c11d098e30bb432c065fd0d37,987898,2020-09-28 12:11:47 UTC,161259401,161257141,false,2260,0
e87b6d4ad72a841f1894c7c4fc067d6b67eaf9364cbea3050bd17126f5c600ae,987896,2020-09-28 12:10:19 UTC,69314421,69293751,false,20670,987885
9232dbd32f9a43f8d00dcdd2c008bd12340d6b7e28138d7421c0c9a663901d71,987896,2020-09-28 12:10:19 UTC,502494843,502474823,false,20020,0
a6436e2c9ba2f4ffd2abee8106bc155b63eb24a9463ac6c012bfe94bca91e0c7,987896,2020-09-28 12:10:19 UTC,126076873,126046193,false,30680,0
b57338f576e107e4529cc82d5dec29ecd294b53bec66dde84c0648cfd1686aab,987896,2020-09-28 12:10:19 UTC,88569088,88560543,false,8545,0
0e849c24b9ee86d4140cfe01e573d14c5b10448fcbed1116702e80f4775d9715,987896,2020-09-28 12:10:19 UTC,230010000,230000000,false,10000,0
9ddaf964db040c21ff80fa98b1ff82f803fdddf74e35eebd0cf771722f81f390,987896,2020-09-28 12:10:19 UTC,45876452,45813707,false,62745,987885
2e036991ee99e3b14a854bd151beec3a67cbc48e45cfd4c8925574193976dd09,987895,2020-09-28 12:09:16 UTC,500023338,500013338,false,10000,0
23cc5ef59d46ffad5e0e741a2058011db75af755948f1a0ca1731544adca0a31,987895,2020-09-28 12:09:16 UTC,88701313,88692768,false,8545,0
55205bf369cd87177d1aa9ad1672da8360316b53d40720710aa749b808245571,987895,2020-09-28 12:09:16 UTC,39924,27924,false,12000,0
4b9e44bfd72888279d415a7c12cccdd27bf416445fa769477c166dfe785ec9f4,987895,2020-09-28 12:09:16 UTC,9101026785,9101006790,false,19995,987884
4b8e8de3ae376cc2852464946e65f7fa4f6709b416aab970471b6a88273c29d7,987895,2020-09-28 12:09:16 UTC,20608326,20596241,false,12085,0
1ecf7853092dce070eccd07ebde18749a9e203c377e99acbe4672b4e43f2382f,987895,2020-09-28 12:09:16 UTC,492500000,492497740,false,2260,0
8925e8b7d17fed61f7d06851858925ad1adddf9554796457208eeb68e8e3a585,987894,2020-09-28 12:07:07 UTC,214588337,214585070,false,3267,0
b826083121147627accf233e8e67e6b7e83f52fe3374bc463877baf0a5a52ba7,987893,2020-09-28 12:06:48 UTC,1195508288,1195506195,false,2093,987882
97a59351ecf3edec489d07bcefba31dd2f69c3bff903f4bfe52e1bc7033eb484,987893,2020-09-28 12:06:48 UTC,500033338,500023338,false,10000,0
b65fcac2d97c38bca96da93c3e57df8b5994c0a9e63f49ad1a6ea17194e522f9,987893,2020-09-28 12:06:48 UTC,1000070918,1000060918,false,10000,0
19414afeba5b974c1cafa8ee394e1b08d5126cd4afd9394bdd3812cca3ca5d0b,987893,2020-09-28 12:06:48 UTC,1297912205,1297906205,false,6000,0
a7f35b3d3fad3ccd6082df6159e230c58ebd3a773ce4824b8ed678667989db40,987893,2020-09-28 12:06:48 UTC,244730676609,244730666609,false,10000,0
525441e37cff2c36fe779be0a2319b2eb9ef2b509b199c611d041bb9753cb3b8,987893,2020-09-28 12:06:48 UTC,605747239,605739059,false,8180,0
3854e264a04013454fd6a9e86b07c35cb22fabd140810ed062129900879427f7,987893,2020-09-28 12:06:48 UTC,1329059315984,1329059313891,false,2093,987882
a3dc2502e622581acf99af277d7832a2448096912c6ac8b801eabd22417743fd,987893,2020-09-28 12:06:48 UTC,2000266724,2000256724,false,10000,0
4b190646f575ac74f4d1ac15f70350bc01954b296fa9fca521ec9550800e8ebd,987893,2020-09-28 12:06:48 UTC,500181177,500171177,false,10000,0
c1b6b3a734e1af5e60e205303a3ef7fcd50798845e7d5c5fb7ef60303c419a26,987893,2020-09-28 12:06:48 UTC,985019700,985016300,false,3400,0
0b8308765295b1c9f15166881526523bfa5c2d4975fb901b914e25e7be1fb1d1,987893,2020-09-28 12:06:48 UTC,18743478463,18743468463,false,10000,0
c94aa93554a47b9efa858529f62943124cd26a030574cfe31972c104d876625b,987893,2020-09-28 12:06:48 UTC,10501388993,10501378993,false,10000,0
c453f600cd9a4a2b5b1b6938ea32aa0744129580b23db37dd9f1a986a03ec41d,987893,2020-09-28 12:06:48 UTC,151911351,151909431,false,1920,0
0f367c127220269ecc090a9c3f6e6d7ab2a952132918c8e08618b9e89af2e9f2,987893,2020-09-28 12:06:48 UTC,2000014569,2000004569,false,10000,0
e783c50d26ba392c2e769a2006183ab499507aad2ebeb5c47c902c45a530b962,987892,2020-09-28 12:03:49 UTC,21655866100,21655856100,false,10000,0
0d79706baedb64973eb8baef3c6ce9e75f67a290c2658895b926d197fbbd5947,987892,2020-09-28 12:03:49 UTC,757066101,756997741,false,68360,0
8dcbe3f5ad5d4f6d1340b26c7f0af4db8d0e23d949e503c3884e1026ee924bef,987892,2020-09-28 12:03:49 UTC,494322497,494312497,false,10000,0
2910f489d6dc4083463deeffd46895a3ebf4c54a1e838f8b57e7b0023c91de64,987892,2020-09-28 12:03:49 UTC,1238590071,1238587405,false,2666,987880
cb61129dd09bced9ccd77fa8fa3c18f3fd656cade463d976a070d2aeaa4877e7,987892,2020-09-28 12:03:49 UTC,90134496,90124496,false,10000,0
f041b815295ca6a2ae1d04f8d3155eeea740d4f98c75b506a339d30eb3864c47,987892,2020-09-28 12:03:49 UTC,1329231844868,1329231842784,false,2084,987881
c78d7deb82c2a5d25b2355c8c1e19a50fbc86444b19a8e9e63595f63660563ff,987892,2020-09-28 12:03:49 UTC,89085943686,89085940316,false,3370,0
33ddaa1aaef10e1a283f370b63d1b34fca2b1eceee2a53ce015de6b78ba7cc17,987892,2020-09-28 12:03:49 UTC,557933586,557888826,false,44760,987891
d1fafb036a7ef24a9c44dbfa05a5f798929a97bd4bff1fa38996c6892cb74e88,987892,2020-09-28 12:03:49 UTC,187211099,187201099,false,10000,0
46c8ed21fff82d367607d62c48a4e5f04dbd730288fd84a8201aaed3b7ca558a,987892,2020-09-28 12:03:49 UTC,88729332,88720787,false,8545,0
d86e0102e6132257ac8ad1a2d4f5c820adb851e00f8acb6efe53156878ff4ffb,987891,2020-09-28 12:01:11 UTC,245041623,245031623,false,10000,0
9feafd919afb3edbc3a0968168aecdc64c2f93b3be96459f174cc5a02a9071cc,987891,2020-09-28 12:01:11 UTC,1050660,1048567,false,2093,987880
03278e0feda4587c8571a2d5247a785d8dd3293e79cf2911ac57755714f2f6cf,987890,2020-09-28 12:00:23 UTC,17880017351,17880007351,false,10000,0
f8ff23f80aafe3f857dd2f90b2b2ea3ee66b9c1572ce3c0dc20c0e7ac3d59130,987889,2020-09-28 12:00:17 UTC,21685876100,21685866100,false,10000,0
f28724f92262fbd8fc3cb0d8068803a6309420c0ebac7d185333460eb4ab7146,987889,2020-09-28 12:00:17 UTC,69888119,69868030,false,20089,987878
7181753f3dfa28e9a48852fb76f4ff4ce9dfd14eff24c81cff2609528589e109,987889,2020-09-28 12:00:17 UTC,9572531,9542531,false,30000,0
8d971e336bd4c9a0854e6dbeefaffc09925bf8e026277412ce076cc420305fd2,987889,2020-09-28 12:00:17 UTC,47112495,47056996,false,55499,987878
a1ad4dac41e9ad2b87842da617230e088ad7e29f57235aa59f4ba61f6eabeab3,987889,2020-09-28 12:00:17 UTC,1563688108,1563685143,false,2965,987878
4651ef76eb1256f9ca90c2c873618772678938d80435ac0558f0a881833ee1c2,987888,2020-09-28 11:59:40 UTC,18375749821,18375739821,false,10000,0
67d8dcbf66655e780e2315df11e23563149ea2781bf3eeba77d67326dfe4ea7f,987888,2020-09-28 11:59:40 UTC,929134000,929128000,false,6000,0
e15bfd8778cecdb6eec1979f3ce4307da786f3f3730dd0b4ba740b53e89bed55,987888,2020-09-28 11:59:40 UTC,130409,127959,false,2450,0
f5f84926cda0ddb13170933013199c93deed337d6fd5b71e8aebe5153afef837,987888,2020-09-28 11:59:40 UTC,101166124,101152024,false,14100,0
8172cccc6ffcd97ad30f890717951e78951b9bcac6146fa2cd8070cd0595398a,987888,2020-09-28 11:59:40 UTC,246218031,246214764,false,3267,0
8a326f2f41812747e9a047d75d2b42e9740cf7fa63062f6d5e3e391316385c0d,987888,2020-09-28 11:59:40 UTC,3861655,3860509,false,1146,0
b7b57a657e210202c60b37eb30e8ab8865837eac887abccc6f7e8309656be8be,987887,2020-09-28 11:57:10 UTC,104000000,103999000,false,1000,0
76c90675aa474040f09cea387ad70af0b4aa422082d93102aa9d032a0e9a8424,987886,2020-09-28 11:57:03 UTC,38357360,38356360,false,1000,0
799e3cd5f2006bf44c2e3558d62abecacface5b9b202e2a1f9f3ca6d7cfe1a3a,987886,2020-09-28 11:57:03 UTC,88798727,88790182,false,8545,0
a4b5aae9af5cf316d28fa4f74556b211fe4a83ab7fbb1e88a02aaabc59a484b5,987886,2020-09-28 11:57:03 UTC,290144604,290142344,false,2260,0
c7ca0cb84060d1b18eac009cd706db0a6e484e5a2b875c58d04f3705ee9d8297,987886,2020-09-28 11:57:03 UTC,1500010000,1500000000,false,10000,0
e70d72c53a8438f7b819951c0e7e1ec3066d3ff477881d41cc40f2ac021c3dcb,987886,2020-09-28 11:57:03 UTC,1251012407,1251000231,false,12176,987875
0371c5163f727e8f60a124ec5fc7cd1cea2f3a62a45808d576bee4789831826c,987884,2020-09-28 11:55:18 UTC,69294,59294,false,10000,0
e34f55b402d4743df9f2e7a840f3d24c6125539afe0b8733bc71e37882fd3c50,987883,2020-09-28 11:53:43 UTC,500000000,499990000,false,10000,0
bcb19e7047feceaa72ea400cb60f526d55690f33df04062eb7bcaf725f3fe346,987883,2020-09-28 11:53:43 UTC,334739069,334736976,false,2093,987872
8edfd7c73a45eb3dc9d847633ead2cb1fe5ceec16c0ebe2d1d38a4042c46598d,987883,2020-09-28 11:53:43 UTC,88892255,88883711,false,8544,0
aefc86c05f081374bf0ae3f7d36c5622dafd7c01f8c16b5409ace534edc11da5,987883,2020-09-28 11:53:43 UTC,157920064653,157919964653,false,100000,0
c16a32c9c0ac3878eab312dd9d66fa957b2164947db95e72402130ec2d2860a2,987883,2020-09-28 11:53:43 UTC,88965636,88957092,false,8544,0
ec6bab294a2f7ac8662b86445317e481f70158b5a11a52ccdfdfb8b845068ad8,987883,2020-09-28 11:53:43 UTC,23472276,23447525,false,24751,987872
0a598310486f4145fe65ef111dc664cb5dfaa223aeba822deebd07545f78a5f0,987883,2020-09-28 11:53:43 UTC,498457565,498447565,false,10000,0
ec0de114169f26bc686a9102d1f88d131f2dfb9b3ead0dd105a6ea9ab4a4ee0f,987883,2020-09-28 11:53:43 UTC,745978418,745975800,false,2618,0
ef8fc3c0538a93b0cd56e1d0c438b52081606eee2ade0d72cfef5366ca43800e,987883,2020-09-28 11:53:43 UTC,48507740,48449616,false,58124,987813
1995673955704e2fdf393a3b74d75eadbfbe78abdfe8fed874114b5b5ed0a4d0,987883,2020-09-28 11:53:43 UTC,70650383,70627400,false,22983,987872
d0a61f4a73c07d6db77bde5546b1a1f82b7bc499e5e1774695e69abce59a47be,987883,2020-09-28 11:53:43 UTC,214744821,214741861,false,2960,0
f21f4fbc95486efadab01366de43abdf38ae6e15bda934cb6cc6618e7d60ace1,987883,2020-09-28 11:53:43 UTC,88995059,88986515,false,8544,0
08f5c273a0fac3daff7bc589c51092e895f89e4de590963070047c11a5a434fa,987883,2020-09-28 11:53:43 UTC,92911895001,92911892651,false,2350,0
61948cef07812bb95d53f5b76b0214abfcae4627b982aa31975379a9b1407a9d,987883,2020-09-28 11:53:43 UTC,11911405,11908445,false,2960,0
44f15b997980b3bb02f723f932ec5a7f471c6b49ef880b678fe48af6742b266e,987882,2020-09-28 11:47:07 UTC,246483896,246480936,false,2960,0
01d6f99be3da77f19f9d553ccdee9f5ec9706d7a13c625cc4bb72eb247100a1e,987881,2020-09-28 11:46:48 UTC,1340750102276,1340750100200,false,2076,987869
fc0192d92da9149e2962fc8e5fea1ae64b3713c5f41fe8644aed23fe54133ce9,987881,2020-09-28 11:46:48 UTC,18375759821,18375749821,false,10000,0
99eb78527d8263ea045e6d97dc46e55a6b47e6f48a742634a5fb139c06cfaaea,987881,2020-09-28 11:46:48 UTC,61400867244,61400867144,false,100,987775
cb672105bf2ffe9e98f83014e2e7a45234e8752559a2394899d13371db0a1d7d,987880,2020-09-28 11:45:31 UTC,3367602821,3367600901,false,1920,0
083438da7c1ea594649904c9a6f392f5098d7a23e9bc99814bd6134c4fb9dbac,987880,2020-09-28 11:45:31 UTC,3729140000,3729134000,false,6000,0
6ee713e21c86d14b3f805f9da7e7004142048d13b5b958f78b9c6d7f0271aaea,987880,2020-09-28 11:45:31 UTC,143916452,143848100,false,68352,0
2ea41c3f22db12f026462d41426af36d4d5d7a9b011289782b0c980b9c8deccf,987879,2020-09-28 11:43:59 UTC,12131960,12128693,false,3267,0
09c586eb4ca3bfbd565edbe16028bb78e6d6cf594770d6c912e306b304b83929,987879,2020-09-28 11:43:59 UTC,89030962,89022417,false,8545,0
aad1b23cab3b00f51951a08689f0f5abf9d9881a0769787ae493b8de80c38af2,987879,2020-09-28 11:43:59 UTC,17886689238,17886679238,false,10000,0
04d48615404e741e2d735476a0d6272bc8d3fc7828709d7296ab31a365b51eff,987879,2020-09-28 11:43:59 UTC,10884302,10872126,false,12176,987868
e737f435e5034d5bf30af1e8aa209fa29cec314e74ba5c1ee237a9c31a15ca29,987879,2020-09-28 11:43:59 UTC,901466926,901004324,false,462602,0
83ab148dff8aaf4aeb54679563781bd059ea02a9f5433c02eed333addb240b2c,987879,2020-09-28 11:43:59 UTC,5062301,5000000,false,62301,987868
d4066c93b9ba5e13267ca6cd54fec49b80265e50cf78708bc48fe234c9afaeb9,987879,2020-09-28 11:43:59 UTC,499990000,499980000,false,10000,0
18f05e9392ca093065ae6486afaa422986a238e0870d8e0a788e1e3f1f089964,987878,2020-09-28 11:40:30 UTC,60973951146,60973851146,false,100000,987866
e776640eff691e2e94dc9d4c8928226c3fc61d8c78a7bccaf6615d3616d72909,987878,2020-09-28 11:40:30 UTC,49580415,49527830,false,52585,987867
c9b294e06d0cc94b66c52c3c6f416982a6cca921ece470f3bd098b29cea53d5c,987878,2020-09-28 11:40:30 UTC,71319036,71291692,false,27344,987867
cdde2651b317074fc468b7fa09bb69366b62833f3b755c8aad0c09aa4d7b2ea3,987877,2020-09-28 11:39:50 UTC,500000000,499991455,false,8545,0
8932bb5f1d835f3d3823f017db3289ec106d92c9aa115972c079679e344af0d0,987877,2020-09-28 11:39:50 UTC,11228841139,11228711921,false,129218,0
ac8aa0638648244aeaf78b830e76301f1aba5347046027bc5f4522e647c97df6,987877,2020-09-28 11:39:50 UTC,210373551,210114951,false,258600,987876
37b54a6b486b5b4b21ab0b4634e63167d2c01bfb265d2c55658e3ed380e0ae9c,987877,2020-09-28 11:39:50 UTC,1000080918,1000070918,false,10000,0
bc3ddf8c1d45d4e4750ee626394776de802bb902f6ae7b953bdbb91262f64292,987877,2020-09-28 11:39:50 UTC,98334497650,98334495300,false,2350,0
88c6db4ca32f7cdcdbd751e267731463f6e6729b95aa48f30afdcd5f96dc7f4f,987877,2020-09-28 11:39:50 UTC,73653749030,73653747935,false,1095,0
a376bde664a34dd695aae98ca16a09076f850ebb32c996757f54e5e5c9edad69,987877,2020-09-28 11:39:50 UTC,89264481,89255936,false,8545,0
761f5e26a11a4885775aefc98936c8135b5d05671ed4287ba7d12ac418195763,987877,2020-09-28 11:39:50 UTC,3941549,3934414,false,7135,987866
5ddaf819c82ac5b7be5d4b3a79f08d46db6667541be462fd79122d94bdff5d14,987877,2020-09-28 11:39:50 UTC,17886699238,17886689238,false,10000,0
a8e3781e5a525b153262e2c363273c43e013263d72bc6a66571bb3c47d0eba9e,987877,2020-09-28 11:39:50 UTC,373548064,373545680,false,2384,987865
a2d4c083fab3d49d1ca8f24bc710c2930923969261fa11007e76d263ea4f6c74,987877,2020-09-28 11:39:50 UTC,89062154,89053609,false,8545,0
eec21f3f112232403bd27c8491c55de9732092c348a39e5d86c00638e2c17fc0,987877,2020-09-28 11:39:50 UTC,106832439,106820439,false,12000,0
725a886cff7e8ba3e28911ea9a81910a73a09c227f0a7189ea81bb2118dbacf5,987877,2020-09-28 11:39:50 UTC,500000000,499990000,false,10000,0
a40a73bbd951f7d78846274d10772777c0b721fc57a53b8b13a5238d1ed906d0,987877,2020-09-28 11:39:50 UTC,214921469,214918509,false,2960,0
78fc9d210ac40f80ec4fb4478240c3719a406b19b19b5be10db52ddb79457d06,987876,2020-09-28 11:33:12 UTC,89301230,89292685,false,8545,0
fd81ec6a4e6b0376738aff4a0f4beb1bfcec82f8fd4b78b9dc934fb69a6739d7,987876,2020-09-28 11:33:12 UTC,17900230018,17900220018,false,10000,0
1d2e71d5849e372ee3a1326c5dd8ab827e1828a4cc094a60ad5aa338e675bdf9,987876,2020-09-28 11:33:12 UTC,246645150,246642190,false,2960,0
481afda7e165f6aea9f42e4964dc41f842091fbccc0c6a3ab992129139dd41b2,987875,2020-09-28 11:31:07 UTC,500040037,500030037,false,10000,0
95e95802d94e39970555262ed4b463f7ebdcd4221c18d614e7fc46bbc7d3ed76,987875,2020-09-28 11:31:07 UTC,12801654,12798694,false,2960,0
3eb22432d344ebb8dac4fecf05f201d37a3dbe97b943cf632e0816b37f998aa7,987875,2020-09-28 11:31:07 UTC,15897265,15878783,false,18482,987862
35ddc38bb9393c00121e074920e68f8f7c922e0099f0d44f1c6ba25be9b1edf9,987875,2020-09-28 11:31:07 UTC,500000000,499990000,false,10000,0
758d5c3bcee273786d13bf7f81e5c456ec6274511c96d75418cbcad13d396f6a,987873,2020-09-28 11:30:20 UTC,415065145,415062885,false,2260,0
a22c5ebf2e3ec7b31cf02ab8261e43d489e4d52bf8a9db4e53ff20c4af18d409,987873,2020-09-28 11:30:20 UTC,72033919,72009165,false,24754,987862
165c4e2e823aa5b7a3fb8a69fe9160114c14fa0bc338ef71781575ec4e25e1cd,987873,2020-09-28 11:30:20 UTC,51239553,51175321,false,64232,987862
709ec23401dcc7afbd839f31303106b366a8370106d93f22f2e6ec8fe41530bd,987869,2020-09-28 11:29:08 UTC,49008875,49006782,false,2093,987858
42b38076d09539c16031dfa216e57697417bc25bf9e3426e5726d7393a9737c2,987869,2020-09-28 11:29:08 UTC,1034434,1031984,false,2450,0
aa8cf5b1b7b7477c996a38545353c1a569ff5106638fedf537269b4509c1bb13,987869,2020-09-28 11:29:08 UTC,61843936,61838380,false,5556,0
fa3cd6fcabb1e76ddc439bd07de8deb997a8dec72c3d97016bf1898971ff5f56,987869,2020-09-28 11:29:08 UTC,17900240018,17900230018,false,10000,0
edb6a610b75f1b0110356ac583814c22a64d6d6fd9d67e94159dd950520514e3,987868,2020-09-28 11:27:06 UTC,616112428,616044068,false,68360,0
d316a55303a35e4358ec53edea10e78d36b2810be6563d4207314d3ee3b73c7c,987868,2020-09-28 11:27:06 UTC,500010100,500000100,false,10000,0
c0ad94f756d71ddb8cc16d072b654699475d47be7b869fa5ff57bf3baa7d6c19,987868,2020-09-28 11:27:06 UTC,595153,585153,false,10000,0
a6632aa1be7c2794e4407727312ad9a82a63709b59373cf766a6a96525b38dd3,987868,2020-09-28 11:27:06 UTC,215293346,215290691,false,2655,0
d109a96dabaa115c5f7dc9929722f5f2706b07979130b34794f50a55a3452234,987867,2020-09-28 11:25:47 UTC,1059793,1057700,false,2093,987856
d8f01ac765f3993027f59eb3a83ebc4943debe855ba144a7553bf8df6f0c47ca,987866,2020-09-28 11:25:00 UTC,50546,39746,false,10800,0
c1216aea5cfc8aa42ea5cb6829c463fbc36c968d90ccb9fd0143db0badb947fb,987866,2020-09-28 11:25:00 UTC,565000000,564998080,false,1920,0
b2891e468a85a0c42464567ff592e02be6cc5a9b2059781613958aca373a9f7f,987862,2020-09-28 11:22:00 UTC,52734850,52668644,false,66206,987851
ed269b220455a780dc2440d89a2515661f7ccff9110b341e812598530c8c688a,987862,2020-09-28 11:22:00 UTC,4502377000,4502367000,false,10000,0
b71abdad01d9d3fb70b254c47cb1a4db3ab1212f45fe1b70085962aaee3f67bf,987862,2020-09-28 11:22:00 UTC,189730,158210,false,31520,0
2bacae997221451c94acf71ff3bf132f06c405799be98d1d380f196d83ef7f07,987862,2020-09-28 11:22:00 UTC,72632452,72606587,false,25865,987851
033bfbb3aec7d78b05789d5a8b1870ac9f92fa4a8f98df0d24e6eeb1f274b892,987862,2020-09-28 11:22:00 UTC,128993446,128977529,false,15917,0
19d470d92ed85ee42acc1a6447fa94c449a54fa93809d41f7fa5399f2bfa9f90,987862,2020-09-28 11:22:00 UTC,565010000,565000000,false,10000,0
cf3447202f0ae16bb15ea7d8f450a2ee0eb600e348cab85f0ecf21685428d64f,987862,2020-09-28 11:22:00 UTC,147610234600,147610224600,false,10000,0
3eb9ee095e3ad7e1d51fee8cdd5aa79a0fc9a88c9daf73ecb0f4650bb4e462dd,987862,2020-09-28 11:22:00 UTC,398522917,398520824,false,2093,987788
628d5676196815a81451fc4345afad1e6bb104e1d538712bf22f07d6dc939d5a,987862,2020-09-28 11:22:00 UTC,1000010000,1000000000,false,10000,987851
37ba6fca1d275b9720465ad07bef475e020ec81e20d2681e78e3693e46cf2272,987862,2020-09-28 11:22:00 UTC,1082582410,1082580490,false,1920,0
e4205ec7125eb930b61081d46fbc2282ba3342bcd4845662d33228784563bb20,987861,2020-09-28 11:16:55 UTC,1082588410,1082582410,false,6000,0
f95f2d306955d6b95f1959672c1cf11ffe86d6df30bfce5509cea4cc1184728f,987861,2020-09-28 11:16:55 UTC,216700800,216680800,false,20000,0
7da077ebf5a8e7a5c0d98e121734aa3aeda61c5d273f1c8d66e72665385adfd0,987861,2020-09-28 11:16:55 UTC,86898995,86888995,false,10000,0
e9cc79189c161edd2aa7e91c7d9cc13846f3aa12e5263de66b0784f62909a939,987861,2020-09-28 11:16:55 UTC,246799546,246796586,false,2960,0
a0abff2ac1004781d944582510db6d7b1d2b835c6a4f88cff40481cff3230cab,987860,2020-09-28 11:15:25 UTC,17684641412,17684631412,false,10000,0
1cdd19feb097ad6e0bbeb496f4b1145b8b223b5fd2a49ad64838da1ef24445c1,987860,2020-09-28 11:15:25 UTC,13010235,13006968,false,3267,0
ba363c3bba1cafc0fc32ad518b4977a04652b8e7250dc4cd34b9a98d844cf921,987860,2020-09-28 11:15:25 UTC,10000000,9997740,false,2260,0
6a904558bef835dee7236f5a9464b292459cd41876bea5cf1d1f695494d9db31,987860,2020-09-28 11:15:25 UTC,222293697,222290787,false,2910,0
95a2e388c70a1e325855123d786cd4da27acf32ae0a8ff2da66fa7c3ad3d5510,987860,2020-09-28 11:15:25 UTC,500020100,500010100,false,10000,0
313340592c8760132d53ffe3643079f069a8955ff4c2dd30618f4d0f113af0a4,987860,2020-09-28 11:15:25 UTC,1007785038,1007707038,false,78000,0
e7dfa3f278a0928acc198e259a100e5c37537b8f1340b575f02e8dd47bd38109,987860,2020-09-28 11:15:25 UTC,59158145,59148100,false,10045,0
98d2b8faab454cceab7b1591a8336eb483932016349d78d319b562b91be62b47,987859,2020-09-28 11:12:03 UTC,17686046568,17686036568,false,10000,0
2fa6d8888788068f8d32f07430165bee62b1349642a0ac89aa7d8906716827dd,987857,2020-09-28 11:11:10 UTC,500030100,500020100,false,10000,0
ca3f431920af52674ba71374c99f36fde33d02884bda110ffa4b561c81967a08,987855,2020-09-28 11:10:38 UTC,73316354,73295667,false,20687,987843
263d2f2da03fdd36337e91fa429ba09a305199f6d075c094eb443395b42d1a6b,987855,2020-09-28 11:10:38 UTC,53963109,53903508,false,59601,987843
d8dd6aa3f9a689a00c0f6f894d5018708e92e960106ad2220b4e923ae1a86695,987855,2020-09-28 11:10:38 UTC,15534242,15529628,false,4614,987843
4a11663e9f87a9214f66e834a350d0f0fd25dae115fc244497ea9ccd622dcee3,987854,2020-09-28 11:10:01 UTC,79165,77583,false,1582,0
ec564d57003b2674e0510c3f34ad441d44fad684a74fecf778b6e7894a2a6dc4,987854,2020-09-28 11:10:01 UTC,444012,434012,false,10000,0
29e966e6ed930a6d26eda1630c28a6e39db3be9b6b9f84ba20b08b89edf5d1ca,987854,2020-09-28 11:10:01 UTC,1472034036,1471965676,false,68360,0
aa002793fa5ea87c9ff198f2853e48f2f2a1bd0fff7ea30e46c6cac3121b65f2,987854,2020-09-28 11:10:01 UTC,17686056568,17686046568,false,10000,0
5819cd1952f2da1328b3fc36327d8d47627f8715872ec878709cb96fe66612eb,987854,2020-09-28 11:10:01 UTC,7073654,7066954,false,6700,0
596602de3f55c088d849bc497d3a712e71ceb4b4efee757342fd2511788d264b,987853,2020-09-28 11:08:47 UTC,1353049604369,1353049602276,false,2093,987841
cae7f940d31ef24ca902fdc0ad14c5969868c3ffe72c03438d39ec0fdd5a6499,987852,2020-09-28 11:08:14 UTC,17962606787,17962596787,false,10000,0
db531206537968d62c4d7a29b3ed1341ea9c1e545327c28a6978e8f63518a0ec,987852,2020-09-28 11:08:14 UTC,2990017694,2990007694,false,10000,0
87b86b66980bfedc950906113b1010c7406810422d6efd81ae3e90f15a838ae1,987852,2020-09-28 11:08:14 UTC,2346730,2339950,false,6780,0
85df7912ef7a1c3b2da5de8c0d28b40a8fac196af3899c1d9c7768af5147ff25,987852,2020-09-28 11:08:14 UTC,121856252112,121856249762,false,2350,0
63a33b24b21763e20c5a257526411c1235fd603ef49a9027e71cc5b2647c559f,987852,2020-09-28 11:08:14 UTC,89330690,89322145,false,8545,0
9848c3eaf0184e404210a35ab305c7245c641d5384cba47ad5dadb6b1115331a,987852,2020-09-28 11:08:14 UTC,89393436,89384891,false,8545,0
8e2346c69e3696702f1688652277e08f1109926a1df91d90d9d67561ceea5dc4,987852,2020-09-28 11:08:14 UTC,1136424601,1136324601,false,100000,0
74bc46ae1c73ccf6b59eb609bbd4d1b2c9f9c7f05d5e5892d224703c7b0c57aa,987851,2020-09-28 11:06:18 UTC,215460280,215457320,false,2960,0
1a4c5d60c9ddb002885961159ac1e0fa85b329b5bd489e7740c6ee6b6426d6e2,987851,2020-09-28 11:06:18 UTC,1373049106453,1373049104369,false,2084,987840
7fb8184ab859c06e8392e1f266fb15b8d47a6eaaee2c37944da00e1307155896,987851,2020-09-28 11:06:18 UTC,1500052830,1500042830,false,10000,0
263a71ba3d4c7d962365db96b5b2e994de939bf0f618abf7ca3a9c6868968413,987848,2020-09-28 11:05:27 UTC,60993891656,60993791656,false,100000,987835
5ce754e7a1581bddc5fd54f3847a5939ccad94219f6338e39a2cce55d6b4fbee,987846,2020-09-28 11:04:55 UTC,14410752594,14410740219,false,12375,0
830f16f197fc5f46a37faf7cd4dd5dfe6b535ebf702a3159d9b6bc6e491f4fd5,987846,2020-09-28 11:04:55 UTC,3027011484,3026966304,false,45180,0
5ff66a957dc6d4064d38da0255846cb3f00c7ce73c85fd183fb2e2a5caf48ed9,987846,2020-09-28 11:04:55 UTC,2000276724,2000266724,false,10000,0
85487980c8e1b9b8c49fb5db7a93cb579aa1e28753c46d452b7847f795d3520f,987846,2020-09-28 11:04:55 UTC,3500745752,3500735752,false,10000,0
1d20728c82fa4197265116c78e0666f77abd24bd13dfbe8ebd0d33ecba301c14,987846,2020-09-28 11:04:55 UTC,241519779116,241519769116,false,10000,0
1fcf914878023f92c28a42545e79beeb199a575c395727c0f10270fd1ec57818,987845,2020-09-28 11:01:56 UTC,1002012695,1001631937,false,380758,0
5c3cb405464b7d885d73526428a4bc802dbcdb77dde355946439677163217cfb,987844,2020-09-28 11:01:52 UTC,74048478,74023741,false,24737,987833
4f0e9e7ac4140c33bb2612f53a9dadf4fdefc0e2a3229f12fa5d569694e178c1,987844,2020-09-28 11:01:52 UTC,1794015317,1794012062,false,3255,987833
9b2b76a31bda066735fc6731a0640c16487f64347af2b9c5c25ab1809a705766,987844,2020-09-28 11:01:52 UTC,17962616787,17962606787,false,10000,0
b1a27b95d9880d3a8a822d82be233e9e73ef5670102d1c8a1ca59dba1fca5195,987844,2020-09-28 11:01:52 UTC,1621479562,1621476597,false,2965,987833
ca35ee09a04e53d1da42d3613e1af306e3b9a482d1d49b861010a9fd5c36d551,987844,2020-09-28 11:01:52 UTC,55399724,55338465,false,61259,987735
0c6d6c02aaddb582c0b71495345568328fa6d82aa7a5d26b993496e054a45ab5,987844,2020-09-28 11:01:52 UTC,192632,174632,false,18000,0
58d4f5ede5a7b5eddf2365849aba9eefa8af7cb926647eae1fe0fb27571a7d50,987843,2020-09-28 10:59:37 UTC,499990676,499980676,false,10000,0
bcf6cbf5d3202cfd63324679050d4a72a7d463c408a044be08028df3ca5b7704,987843,2020-09-28 10:59:37 UTC,21824009603,21824007683,false,1920,0
b0f505b345313d62082935511b0474712a24c83909358c9a5d582b6c6ed907b9,987843,2020-09-28 10:59:37 UTC,71313183002,71313180742,false,2260,0
74c3f6be63e29d45f2f9ad1bb59e6a592cfe5b2b8c444b2c1af51ac605a48c09,987843,2020-09-28 10:59:37 UTC,10003510003,10003507467,false,2536,0
72eae52b4041eeea60494fec3c4c0598f217c2630b16706d33789b01de7f026d,987843,2020-09-28 10:59:37 UTC,499981728,499971728,false,10000,0
824745be823dec27fb57d0e1aadc856586c340a9edcbb14577baae3ef16e129f,987843,2020-09-28 10:59:37 UTC,46573021320,46573019060,false,2260,0
d89fc5cb6774ce953b5e1e77c06057511ff54e336e55878e194b5506d012421d,987842,2020-09-28 10:58:20 UTC,96053344684,96053342424,false,2260,0
26e0e024112634ba5bbfa819ee656dfe5c1ca4a1106e8052ee71ee6de6c0f3a3,987842,2020-09-28 10:58:20 UTC,246967357,246964397,false,2960,0
98cd67ea4e4b7b849722545dfbca780ab177e118f7db025efd66eab99621efff,987841,2020-09-28 10:58:02 UTC,10000,,false,10000,0
456512eb1326b127389ae9581422158dd9adf6818bf33606fcf38b7f5fb86061,987841,2020-09-28 10:58:02 UTC,10003510003,10003507467,false,2536,0
dae9c702d873f1717d4f7de3bb2e0026a114de082865d3816dcc79dd9c1c3003,987841,2020-09-28 10:58:02 UTC,10003510003,10003507467,false,2536,0
b9a47fc0e9c392252f8bdce6c3c720df6681d65bc31da77b583bebc9aacc9913,987840,2020-09-28 10:56:42 UTC,499991728,499981728,false,10000,0
a70d98e2b6745f6ffa825cbfa9d02adcf81a194b4b5d7c769208e16c802cac22,987840,2020-09-28 10:56:42 UTC,24754259014,24754256754,false,2260,0
ead72b570d60bc2c51926d4795970cb9f5b9b7f2681650d6052abe4db2f4237e,987840,2020-09-28 10:56:42 UTC,14750746751,14750744491,false,2260,0
5c2329481c4192de052cadf79dd3563de6d2057c29566401e2d15df7ecd5d6fa,987840,2020-09-28 10:56:42 UTC,106056858427,106056854687,false,3740,0
975f28875a3076a05858bc515cc3d089b033a80813b27d21abca7d28b751dd47,987840,2020-09-28 10:56:42 UTC,250061231,250057873,false,3358,987828
20541a1a4c154b426f2ab7167900c6cbd5632769d7d4de2ffa3586f24ccf9bd3,987839,2020-09-28 10:56:02 UTC,61850867344,61850867244,false,100,987827
b69d17965c47bb54c68d1876c6f6cf6f5966e87570705dd31ef1d9324423ac7e,987838,2020-09-28 10:55:47 UTC,500000676,499990676,false,10000,0
9a8f3c3397934d659a716628356c69af7f27f44cfb7295d8454db16dd69057c1,987836,2020-09-28 10:55:22 UTC,74889946825,74889944565,false,2260,0
640966f4e821b810e3abb8ecc664be3bc26cf14ceedc15afca1a5cecf6f379c6,987836,2020-09-28 10:55:22 UTC,50211922094,50211919834,false,2260,0
f5edd71068b91f8b9d0769e1da03e1cc77e422e65e8b998fe6275877f21c8276,987836,2020-09-28 10:55:22 UTC,43748417443,43748401863,false,15580,0
5a79c86c6140afeb9cedc1d0b4bd4c38574015f899221bedd2cca288e023e82a,987835,2020-09-28 10:54:13 UTC,159864580,159861231,false,3349,987823
04de88eceacc5c53eb870e82617a0e7f1fe81311827af47b2aadd41c09eb34ef,987835,2020-09-28 10:54:13 UTC,99567973036,99567969296,false,3740,0
9117146bc05c160800387172b0abb487526ba7b874bdf628fc98473860e1224c,987834,2020-09-28 10:54:04 UTC,13654127,13651167,false,2960,0
9c330da11b7b96b136a1b126ac4fd1469ceaf3954df2c6d58e62ccc737b846f1,987833,2020-09-28 10:53:57 UTC,4600500000,4600497550,false,2450,0
6364291f9ee342c47d716510d6086e88fd04b951645b63db0b563ab3f485f914,987833,2020-09-28 10:53:57 UTC,1382748608546,1382748606453,false,2093,987821
e11ba3118d20a848536244fe8bd821daf476b435742dd6837e25a81bbae36613,987833,2020-09-28 10:53:57 UTC,500001728,499991728,false,10000,0
c7d33ea04832704beeeb521b1013995c2b017441e0829135ab47a22393475e6d,987833,2020-09-28 10:53:57 UTC,27798480796,27798478536,false,2260,0
38e366f97c34b108b507fa3bf15058e1cadf07835e40875fe310b011db58c718,987832,2020-09-28 10:53:35 UTC,31913735806,31913733546,false,2260,0
d550fdeffcf8221224d6fd60b307b405ee24f9e94493d1856079fb8157d34b3d,987831,2020-09-28 10:53:18 UTC,17446255807,17446245807,false,10000,0
13fd4605dfa70c0b25914ad7fe0e42023aa8608ec1ad0ff48ccd98e2a6433c75,987831,2020-09-28 10:53:18 UTC,159427583,159425323,false,2260,0
7c6a267371e2b03fe2f361c71a74af692be16436a30c2975acdd7fb7ca6884aa,987831,2020-09-28 10:53:18 UTC,40144243566,40144241306,false,2260,0
ccc3fc8c90058e84f241e7660debea1fd430a838f382e005022d52cf245ddf76,987831,2020-09-28 10:53:18 UTC,89452256,89443711,false,8545,0
1532a5bf2b499046d6bf62e34b5b249bb2226165d8e42687b60a45ea0b71de5f,987830,2020-09-28 10:52:13 UTC,10003510003,10003507467,false,2536,0
0e0b655e5f5998a4ad8b6d297849e65a454c9de9164f4bdbd49a780666aaf833,987830,2020-09-28 10:52:13 UTC,99194823,99192563,false,2260,0
473947fbaa6f548b8ff6a248b9602b4933f146b6e9a48f841b4c7969df8e57aa,987829,2020-09-28 10:51:56 UTC,13010561,13008641,false,1920,0
b2acd5c43432003eb018460a88d562493c7c73e58f9ae039e0cae54d4383f678,987829,2020-09-28 10:51:56 UTC,100000000,99997550,false,2450,0
ba60fd0b21ec57b83088ff4ccb76dfe2dc7c6e9e8ea307ae5cc0916760eb528c,987828,2020-09-28 10:51:44 UTC,10003510003,10003507467,false,2536,0
8cd43b1753edb5bf9e6b98ac5408f09fff57a11885bb5b4075707818be0383c5,987828,2020-09-28 10:51:44 UTC,169787389,169775304,false,12085,0
5873e02e4749a3af3b7cf3476b01b8a5f32f31a2aadfcc98fb8b55a2d7ed7b13,987827,2020-09-28 10:51:26 UTC,1384345610639,1384345608546,false,2093,987816
86d5417180d25b40a5f4f33142cd4a050c32596956d7f94b4f714cd013982913,987827,2020-09-28 10:51:26 UTC,50147755829,50147753569,false,2260,0
bb324b08cb4cb58db54c68ca52676d06027332ee2dfc8bd2387c4d9d4ed00994,987827,2020-09-28 10:51:26 UTC,74539096,74520767,false,18329,987816
662f2998415eb20a26a12288b52163daeaeafe03eb4c371aaf0c5ee5ac509f08,987827,2020-09-28 10:51:26 UTC,105000000,104997740,false,2260,0
7e4f5e5d8c7e718b693770499fb8bdec3bd5add6d8af61c26fa76d925da16564,987827,2020-09-28 10:51:26 UTC,60702730074,60702720074,false,10000,0
0a6f7e8b1db26db53203bcadc4d0ac7661fa65406c690b09cf0da6dd3912632a,987827,2020-09-28 10:51:26 UTC,89490137,89481592,false,8545,0
9ed23a65955d2a7f64dfbb180b52fbb0030052c17ba8b5e627b02dbe63760846,987827,2020-09-28 10:51:26 UTC,215815463,215811890,false,3573,0
ffc08c4e2bc860def0f4f183bc3b0765d78df105e032fdf6ae19ede90efd55ce,987827,2020-09-28 10:51:26 UTC,424128597,424060237,false,68360,0
aad58d5ff099e6a0e51a0e7d3bdb5de12fc1af76b3e338b7320333b09a1f5c8b,987827,2020-09-28 10:51:26 UTC,17455756279,17455746279,false,10000,0
b9a2c729d1ddde375a30b5c4b5a039d69a21f45410924dfa99ac8d1dffea9f67,987827,2020-09-28 10:51:26 UTC,56396935,56341743,false,55192,987816
96fda13a4e83ef8446a1a1fd5ac6ad7d85f2fe433246a800b49e783eeed0ca56,987827,2020-09-28 10:51:26 UTC,2138847370,2138827370,false,20000,0
cbc82381fe508de5a03998cda8c2501b9967df49ec5c7405c47b46d24eb8758d,987827,2020-09-28 10:51:26 UTC,6607931228,6607831228,false,100000,0
6bbaa716cd2c2d5d03c022fd136aac43866d5311a83b7dc843c9d292addde593,987827,2020-09-28 10:51:26 UTC,180453648,180436798,false,16850,0
65290ee85a206bf92f1eeaa8ea57ed736665a0dcaa76d159df5cab7f5d17dcc8,987827,2020-09-28 10:51:26 UTC,60151268092,60151265832,false,2260,0
f57204a17e2e42235da6e5b4f541e09f0b88d9b96738218f46cd7dadc6f5e7e0,987827,2020-09-28 10:51:26 UTC,60802710074,60802706334,false,3740,0
9eb5178455aa8a76a20a3533a618d0ab73b2f3d7b95af2ef7877cbb2be325230,987827,2020-09-28 10:51:26 UTC,89558149,89549604,false,8545,0
b242ec5901faf7643b6008e48ac15efa54b476152e14efb5c0df11e7e6c1d580,987827,2020-09-28 10:51:26 UTC,416802696,416792696,false,10000,0
0e529435434ffbf4f21108911a2567af720bee50b7bb2da755882b1a893c8a3f,987826,2020-09-28 10:47:26 UTC,1484345112723,1484345110639,false,2084,987814
40320757d9dd6d4770f4d71b0b3a68e9c522a413da1a6e5ffb3d69776964b4e6,987826,2020-09-28 10:47:26 UTC,249000000,248998080,false,1920,0
51e2b24b6b60cef406bb2d0e85b5720f061bc58d80ff6ca189e39f6223445c0c,987826,2020-09-28 10:47:26 UTC,17455766279,17455756279,false,10000,0
6ef52ee562b5aab4d8619a4f1d04715b28726ad06fcb6167b52e021e3d3fed08,987826,2020-09-28 10:47:26 UTC,1014416,1007636,false,6780,0
27ed28046a81180eee7ae10758cabcab6bd2b3961a08a66a28b1da1790f3405b,987826,2020-09-28 10:47:26 UTC,336569771,336567511,false,2260,0
507ab8532e7d55562aaf73b7e4103dcb34029913c719efaded506405fc2986dd,987826,2020-09-28 10:47:26 UTC,2011830288,2011827183,false,3105,0
d1182ec12f9c761471bac1b02021e51e3920ae6a2d72b9add64c3a606e4e2646,987826,2020-09-28 10:47:26 UTC,127451760600,127451758250,false,2350,0
5898e02a42b95ca7025fe31abaf2666a1a14c3f7d8e212371aabd9f9075ebf0e,987826,2020-09-28 10:47:26 UTC,64960071,64959071,false,1000,0
45fa2ae08b0f6ca62f89286c37e53b3b027832a8b79264acb6301cd49fb24ada,987826,2020-09-28 10:47:26 UTC,14459903290,14459800290,false,103000,0
67967f4f4bc8c58a043b0f52db3fd1b868e720dcf3da1e1128ffb73a4754680c,987824,2020-09-28 10:44:55 UTC,10000,,false,10000,0
a4313d44921f3e9dcf976e42b60e727fb59b151bc965a47745fadbe90d044b2b,987824,2020-09-28 10:44:55 UTC,60702740074,60702730074,false,10000,0
3e86291c360aa4bf3a3d198761e0f82cd26836aed590e845ac74e0b6fe6428ab,987824,2020-09-28 10:44:55 UTC,90672820,90670900,false,1920,0
05e6c21a2e08ad2095be9937985a216d069182759e8cff58bfbf2fd79b95e145,987824,2020-09-28 10:44:55 UTC,250113009,250000002,false,113007,987812
8efe89561862163f1200e6a23edeecc56c298fd6cb390762c4a3c145a4080d45,987824,2020-09-28 10:44:55 UTC,1076812,1074728,false,2084,987813
9cc562f4ed107fe527c3822d0039bbdffef497a7ba0193c3c389d4c176345581,987824,2020-09-28 10:44:55 UTC,129019587889,129019585539,false,2350,0
f74797e4794892a3801b48884a757b1510c09816939fd52e28c7f7f41171da66,987824,2020-09-28 10:44:55 UTC,17460665033,17460655033,false,10000,0
a2ffb37d451e97f1854b9271e7eda104249fb15e2a081a7fc82fcae39b50fe61,987824,2020-09-28 10:44:55 UTC,247199923,247196963,false,2960,0
a195e9d79b7b8662cdcd37d2c876cfc0a5b935c92da57fdc4e7c5801e5a636bc,987823,2020-09-28 10:41:58 UTC,218381542,218379282,false,2260,0
354b66663b76fb9545dc78b0faa6e5549e30b2832c52ecb85a42764f6382d471,987823,2020-09-28 10:41:58 UTC,74995314,74978987,false,16327,987811
f3eed56d5c3ee8b82897df7e4f061f6c1e3cb9ab064d9627ee3d7a63c01226e6,987823,2020-09-28 10:41:58 UTC,101309633939,101309623939,false,10000,0
cbc53effd0231481c151852e9909efe03f7def5f8f49ee9819f9350d10ab3b8f,987823,2020-09-28 10:41:58 UTC,57389106,57336792,false,52314,987811
402d9321046a1e89077055b72b566d12535b0edc4ed65c42e679a1676f43ecc5,987822,2020-09-28 10:39:57 UTC,433993059,433990966,false,2093,987811
eef4a5258ac644561a684f049671828c02147fc87ecdcdcd485ae175c49f64f9,987822,2020-09-28 10:39:57 UTC,20139875418,20139865418,false,10000,0
719cfed5e0ccb13653b426987bfe050163e259d0591b14081f1cbc67ab5d6f37,987822,2020-09-28 10:39:57 UTC,89930260,89927810,false,2450,0
317e877afc9331f2b926f060b84d5511113faa796eba1ac890c5cd3e85f900a2,987822,2020-09-28 10:39:57 UTC,500000000,499990000,false,10000,0
20415f403932a57f76acc7b105621164fd0e62eef4eccfafd1480948eb685e4e,987822,2020-09-28 10:39:57 UTC,966753122,966751007,false,2115,0
9417ced69a05d2c87ad68e346b8d4a14b0d1eebb033309ebb9c3e22b1c35cd2e,987822,2020-09-28 10:39:57 UTC,26956490484,26956480484,false,10000,0
f9f9312d7b201e40899086f5bb1322f95315a02b42ba6ca71a9ea72921c2a93b,987822,2020-09-28 10:39:57 UTC,176478225,176468225,false,10000,0
10786cc931b99edd9fe5475dfc3927adc456f9643042bdf9cb77164a61f0e44f,987822,2020-09-28 10:39:57 UTC,158800000,158798080,false,1920,0
5c535142f53d833459a4da35a2a000237164d95ecf2ae12542cf44be6e94c047,987822,2020-09-28 10:39:57 UTC,500000000,499991455,false,8545,0
84bfc85e5d3fe77b6a5ca34c928f0970270153a56d2c92da133f72777cb691f3,987822,2020-09-28 10:39:57 UTC,37999996254,37999986254,false,10000,0
ae5502a92a775269a926b8511d18e7fe67733acb6f2ceb5806373bd71ea2dcb8,987822,2020-09-28 10:39:57 UTC,13860415,13857148,false,3267,0
469854dbbfa391c9d21ccf044d7cc63267da0f5b9fcf2b1514115593554e5682,987822,2020-09-28 10:39:57 UTC,366920000,366910000,false,10000,0
4bae527938cd738a2d44fefe76174e25cbbd2126dd244503be8a9c2113871d40,987822,2020-09-28 10:39:57 UTC,20056088564,20056076189,false,12375,0
27f921b76e6b68743e900d2d9e4e08eef5b6516e647c9a60e09074f9b703d614,987822,2020-09-28 10:39:57 UTC,3682566761,3682566623,false,138,0
266c296bfa291bd03f2e4b70e3efc3835ed3f312030aac202d87d93926058f37,987822,2020-09-28 10:39:57 UTC,60704750074,60704740074,false,10000,0
412f3062697b03f0c4141ad5f97fa77043232fe4e397f8101bc71d4c6a09c572,987822,2020-09-28 10:39:57 UTC,1495444614816,1495444612723,false,2093,987811
22f5dcebc22e48717f066dd2d53edac6a42a5db0fa10d15dd3a231ebfe32bbe6,987821,2020-09-28 10:35:27 UTC,17460675033,17460665033,false,10000,0
200a152449ab15a6e1783e17787b1e3e731343f5d882bfb3eadb3840173cf030,987821,2020-09-28 10:35:27 UTC,5500000000,5499999929,false,71,0
39be991586424fce165e623c99cd94eb2e4fb0db31fba0dc3eff90e52afe2c98,987821,2020-09-28 10:35:27 UTC,80000010000,80000000000,false,10000,0
a64aa9dc98ba4f886742edf73303142db49423c28d01318bc37deb5cc584df83,987821,2020-09-28 10:35:27 UTC,215955354,215952699,false,2655,0
bb3f0ca7c99ff930f09e2eb932077f2ac9c55c0bd8aeb97ab3b06c9844785c2e,987819,2020-09-28 10:32:51 UTC,158808015,158803325,false,4690,0
d41917543719d94a7fa3bcb5497f2411928ff1726f41ffaa2f8a6f21b48e5e36,987818,2020-09-28 10:32:31 UTC,384165000,384163418,false,1582,0
8e0a45b37b0743cec40da9b56e6c323931f236ff47509a55d573a22bb0460583,987818,2020-09-28 10:32:31 UTC,89594409,89585864,false,8545,0
52ff57b9ea30a2d7c8ccd57adbefda2da18988036b676ac98f539175a79c3dfa,987818,2020-09-28 10:32:31 UTC,426082368,426014016,false,68352,0
086e9a4faaad6f9e2df387e932cded7e19557a01e146a570b19eb8b46c4ebbfe,987817,2020-09-28 10:32:04 UTC,344639940,344595180,false,44760,987816
54e3155cdf20be2476538dc272520d851b06c26d6d51d66bc5a6435ff4d60a79,987817,2020-09-28 10:32:04 UTC,506087722,506077722,false,10000,0
d5efc9f7a5286a3261b030409a3979bea18e027f778f587b1d7706de04a72e6e,987817,2020-09-28 10:32:04 UTC,75348269,75330804,false,17465,987806
ec07cd8e0408c0cfee583412ba2e3b45b6ac1d4193fbb650f4e8221ffb81f6f0,987817,2020-09-28 10:32:04 UTC,49448360,49446440,false,1920,0
11037e2edb82d5010ab5676820277ae0673a674dfabef639fe75190d0bac1a8b,987817,2020-09-28 10:32:04 UTC,58497406,58447692,false,49714,987806
b941686a1ee4ca48d3b212da967a2408f9783ef0696e4f4be8f7a3971b7ad72a,987817,2020-09-28 10:32:04 UTC,43680808488,43680803523,false,4965,0
b87169d0c5148c647ab48c4711ece6557ec9692126e865219852fb64227b1668,987817,2020-09-28 10:32:04 UTC,99770,75770,false,24000,0
88a93c2646e45a3745a433f99e3b233456315b4afbac6d48369b9479b1687579,987817,2020-09-28 10:32:04 UTC,100000000,99990000,false,10000,0
29d13af9ce891157efefac66a92d3e1e82acc85a7f7aacc231d7f501cde36afd,987817,2020-09-28 10:32:04 UTC,504993644,504983644,false,10000,0
0de3691180f903b2f78f50eb8543731d60ab310bfa1fdca2d91677454e3cc0d2,987817,2020-09-28 10:32:04 UTC,19035738738,19035728738,false,10000,0
2c73d170607e0958a89c34ddff3b69d6977e74201b70006c69a5d50f5c8413b6,987817,2020-09-28 10:32:04 UTC,73408,70498,false,2910,0
5a60337e6cd275d190bf86e12473d5c2bd1c5823696812c0cb08ce72d5b16df7,987817,2020-09-28 10:32:04 UTC,46186865818,46186855818,false,10000,0
621f1652f1d4286981437b786edfd1185ef53aa141b6144f190555dbc17339db,987817,2020-09-28 10:32:04 UTC,89683218,89674673,false,8545,0
b98177ad3af5eb6afadef1e7d7b5c5a9af7710c0da1d9d78216549d7cf6a7af8,987817,2020-09-28 10:32:04 UTC,6350721,6348461,false,2260,0
284c0ee58ce21b653eb5a867a30e621d890a581bbd0635a134089b44102026a2,987817,2020-09-28 10:32:04 UTC,500000000,499990000,false,10000,0
62caecb1ba82fc56d2375512bad27de2a38e5a96420124f4c4dacea327ad5d2c,987817,2020-09-28 10:32:04 UTC,49849997740,49849987740,false,10000,0
cedb6104f222ed024da659b56072f280c4ba2760cea0fcfb78f30dbf5d1363f6,987817,2020-09-28 10:32:04 UTC,1515444116909,1515444114816,false,2093,987806
0191f24b5c0b922fddfe3390143d1459c245be32a08a27a3ddd0ce1e1a35f61e,987817,2020-09-28 10:32:04 UTC,5657810442,5657805477,false,4965,0
5208c760ba8e73da32ec1a323aec36d09a168e965138592b8b6d6c8141ac406d,987817,2020-09-28 10:32:04 UTC,1550672730,1550664747,false,7983,0
f2d36711725b0f785d3edba56ffbb8f16fa295a327b95d5190aeafd6ebd868f4,987817,2020-09-28 10:32:04 UTC,243056200,243046200,false,10000,0
f665a398e9670e75b67822110c3545c69fc59992bd3cfb342d897f21f9ce2f7b,987817,2020-09-28 10:32:04 UTC,89654190,89645645,false,8545,0
4291f63d7637b8c9f7b593ab8464800b64af36d6a8e1496bcfefd33da3ebb36e,987817,2020-09-28 10:32:04 UTC,32112219,32107024,false,5195,987806
102a72169d329870c135bdbce128f40eb3de37d131e5da57a50e2c69e049a6c1,987816,2020-09-28 10:23:33 UTC,63588000,63580000,false,8000,0
680e0d8219dd6b03b33c36778a5224906ff9419975d8c37a0e9d4a1e94db9b7e,987816,2020-09-28 10:23:33 UTC,12705522,12701782,false,3740,0
904bc5ae35671a190473718bb9981cf2c947a6017e2dd4ea40debc4891701414,987814,2020-09-28 10:22:05 UTC,2429048484,2429047484,false,1000,0
0d5146aead0b00d3997d239ad1de76ad8c86b0fab1fb5180cd179622f19a4184,987814,2020-09-28 10:22:05 UTC,247451554,247447981,false,3573,0
8383dc4d0f2c51803d7bff351a3e74648adc912fb1dc589ba4213dd0699231d6,987814,2020-09-28 10:22:05 UTC,19035748738,19035738738,false,10000,0
8993de1d7ac82a036f630b6d3b9c15d307e8bf99f0b9b8da7d8666074d4e79e6,987814,2020-09-28 10:22:05 UTC,867139500,867137745,false,1755,0
11f43ca67ee326d9591b7981dbe29e7529dc910dc68038208ee72d5824998de4,987812,2020-09-28 10:20:16 UTC,13755572702,13755542702,false,30000,0
93f5a6a5ccd5976b95772efe9b53763aaa4a9d081468faa26d412a08ea4fb388,987812,2020-09-28 10:20:16 UTC,75895854,75880689,false,15165,987801
6f0ebc501418ec84b0a68f0c008edb61991a0597cb6cc0beb88a3ae0c0848bc3,987812,2020-09-28 10:20:16 UTC,283113599,283045247,false,68352,0
0fd3dadcdaa7941c3891e96f7d95bd9b75ef8fb8b4f50ad5a95e11874b86de12,987812,2020-09-28 10:20:16 UTC,91928380,91927380,false,1000,0
f4417cc8a14e44993ea36bcff904b070bcbb698f05cb8a0d1d5ff3e134f11bab,987812,2020-09-28 10:20:16 UTC,463289609,463287525,false,2084,987801
7ca689383ab47ec1fee802963e92e9d65f5897aafaab773b26a3ed1decf46b9a,987812,2020-09-28 10:20:16 UTC,20729558,20711558,false,18000,0
7b21a4386ff4960c668ff07ed0a50d5206cf02bc5b3e8a83aa8eda29e817eb1c,987812,2020-09-28 10:20:16 UTC,100000000,99997550,false,2450,0
333c3ef2f2c85e5965d92065fb4ddbc59bb3d2472890f138077fef60b3cd2a46,987812,2020-09-28 10:20:16 UTC,383569293,383567033,false,2260,0
0e762e1549ca882cf3ffcb55a575863de1497e812f4b80f15dac09c6b2b9e94b,987812,2020-09-28 10:20:16 UTC,89718864,89710320,false,8544,0
ff9672d9aa54922759fc9c47db0685b8a2c98222b8562e6078fd87380f4da735,987812,2020-09-28 10:20:16 UTC,59605877,59558211,false,47666,987801
dcb7770d58119cb06d37195e06cc6ed85005177265388b79c8ba50f41cc45cdd,987812,2020-09-28 10:20:16 UTC,28567,25500,false,3067,987801
d02e82166f5d52b67f18c9b98670d7574ab41c5bb9869cdd3a71b137bd89d2da,987812,2020-09-28 10:20:16 UTC,513543620,513541360,false,2260,0
641728c79653e5ae9e4a15f5d547d6cb162f1a96906ce6206574b8c0aac4719b,987812,2020-09-28 10:20:16 UTC,19081819579,19081809579,false,10000,0
b276089a5096e08c35355a7d96f32fb0ad89b1e0531896d0538e6a4cb49fc06e,987812,2020-09-28 10:20:16 UTC,14120284,14117017,false,3267,0
efec9231e8926bec2a574d0a0896bf39ac65e9f55ac1436529491e2d4cdbd7de,987812,2020-09-28 10:20:16 UTC,100000000,99997550,false,2450,0
8bc70b9701d24077c4c63b04272a1fb9ed6c65dc46c2bb55fcb6c2b28efe0b4d,987811,2020-09-28 10:14:05 UTC,19081829579,19081819579,false,10000,0
94e4aacb759dc9dc21f250cbf83a8deea4e7ae8462cba1ea2ad8d29b75dc40e0,987811,2020-09-28 10:14:05 UTC,14310110,14306843,false,3267,0
713de8931614f86ba2bef8a540583f2abe79bdb3a0e5dcb2accdb14a03cf80b1,987811,2020-09-28 10:14:05 UTC,60988611,60934024,false,54587,987800
dda60983a95cb1e4dba473673c5df14ecbfa6cb713b98264f4221960e7393a45,987811,2020-09-28 10:14:05 UTC,77404586,77385952,false,18634,987800
f5b9337cf6e71ebce12bec5657a0a0e6a0e9ed2d69621ac691c2983f9a5572c3,987811,2020-09-28 10:14:05 UTC,136766158,136725685,false,40473,0
754e1f30bdcfc02d5c87ff10e810a07833c59a1a5cad04ba53e33882e105ca1a,987811,2020-09-28 10:14:05 UTC,216099022,216096062,false,2960,0
bb0c0b3fcc45cf902e0bdcddcf9b627ae63fe84d054a907b2f98a6bd9326ca9f,987811,2020-09-28 10:14:05 UTC,460497500,460495918,false,1582,0
8f633b00d199284ed1cf8c952daedfbf7ad991f32fdfd917c312fb4f2077b7ea,987811,2020-09-28 10:14:05 UTC,500004185,499994185,false,10000,0
95b5003ac76ce10723182cdb048c56f99be73a7c322e328b6384bbe5c3b198b9,987811,2020-09-28 10:14:05 UTC,248321642,248318069,false,3573,0
5e2a9e0a80b59be0cc99ed1dc31f4470d71cf6c793019bf16baf6b86c81816a2,987810,2020-09-28 10:09:38 UTC,179431323,179427583,false,3740,0
6a99762d352d60cd2ad37e4bb2111425d7a4a1d1a8657a3ce770af455b1937e5,987810,2020-09-28 10:09:38 UTC,602520448,602518528,false,1920,0
9f74e2335a2518a7a471c4e40fe381d14b362f8bb258c29ca363afc0bde8b8df,987810,2020-09-28 10:09:38 UTC,224108538,224063778,false,44760,987809
26ebd5255e51df8a149b1a93f340616566ab07a589543a49e9bdc407b8b1885f,987810,2020-09-28 10:09:38 UTC,499980000,499970000,false,10000,0
57fbcb0910d7ce34b68de00104118f087a19d5e98767bfe4480673b19b7b30d3,987808,2020-09-28 10:06:54 UTC,430538118,430535858,false,2260,0
4ced018a7bf72599af22aa38aa6f78eba437f9b14d6d4941c52d460811419dfb,987808,2020-09-28 10:06:54 UTC,303640731,303634207,false,6524,0
f0575f3cce66cc2ed106c98d15b711348ec36abf194bd2a7a935417ca6fb3a47,987807,2020-09-28 10:06:14 UTC,30441100939,30441088564,false,12375,0
0126695172b72a81924ece934b4cb95fe6f346ca47ee99f898eed2636cd0591c,987807,2020-09-28 10:06:14 UTC,216376720,216373453,false,3267,0
ddeae1abc2baa3ca970090ef787ec0995b936a00c1db3cd088c70f9227028b52,987807,2020-09-28 10:06:14 UTC,201043782,201041402,false,2380,0
00b0edba915059de991d80350c309906a62a0d418eff7a09ca32c1f054b01d97,987807,2020-09-28 10:06:14 UTC,499980000,499977907,false,2093,987795
914ee2ee6a75398926cff636dc6d6ddce56914b96833a6515e035f41343fd87f,987807,2020-09-28 10:06:14 UTC,3500755752,3500745752,false,10000,0
ffc9984e041bc769306cf02f3df35578ab35f0e8a3749e38624fd026125e9b0e,987807,2020-09-28 10:06:14 UTC,2000020576,2000010576,false,10000,0
4cf652fb075b3a9427ee51cb631a0a7ae675c89268a86f9f217ab6a746dbbf2d,987807,2020-09-28 10:06:14 UTC,499990000,499980000,false,10000,0
420020c57de548355008488217b338b64dbf5eb9543229b947758702897c9953,987807,2020-09-28 10:06:14 UTC,37209919300,37209909300,false,10000,0
2c81f77eba85184144a5b2a5827e7a51205b79d32d079479647e2129c185474d,987807,2020-09-28 10:06:14 UTC,240782770578,240782760578,false,10000,0
ce418ab66355913b8d93fae9f316eecd4139c285ee77cda53166789d78b79659,987807,2020-09-28 10:06:14 UTC,695555941,695546005,false,9936,987796
eb8593af4341eb4aafbbd3e50bbd3783182efb664a1d456b1e752c02b97d86c7,987807,2020-09-28 10:06:14 UTC,519162308,519151640,false,10668,0
b63c0b8411e1f2cd3e814b9ea41ff627f1c43d354a62392e0b53a0bd553b7c97,987807,2020-09-28 10:06:14 UTC,310356000,310346000,false,10000,0
67f5ad0b22bb715f78960a91a761461d6a4a880b617e81fc51a368174a4be9bb,987805,2020-09-28 10:03:14 UTC,276488225,276478225,false,10000,0
b69d56259c3ef5288b5663ee29ac4be6b751d69c2212afe6d401e134c3c226b1,987805,2020-09-28 10:03:14 UTC,89749098,89740554,false,8544,0
52dfa69384a92d785067f503e9054e098c2b672a725ae30d656487a29d32d7a5,987805,2020-09-28 10:03:14 UTC,500000000,499990000,false,10000,0
065ebab07c2142eebe65631065fbfbebbfc496ff93f7aac5bb790f4f3e16a1bf,987803,2020-09-28 10:01:16 UTC,1700611708,1700608163,false,3545,987791
4c3f33fb130da877bd2e3dd0fffa3484449248d6f2f4f49cfecf33af29cce190,987801,2020-09-28 10:00:54 UTC,61978833,61923323,false,55510,987790
1244563ce10e57484e9a84d2fba0cb9f20bc491a9c1a65db1952a960a046bfed,987801,2020-09-28 10:00:54 UTC,285051656,284983304,false,68352,0
4c1c467403dcde0b11cd0b3115a6993c5ec21067a47d88d375bc0939b2153698,987801,2020-09-28 10:00:54 UTC,22215507706,22215502826,false,4880,0
048599d3d3da741c76f404febda106db44093ab05df35e0efa13e4e532658fa5,987801,2020-09-28 10:00:54 UTC,89777869,89769325,false,8544,0
85c4f9fbff51b32c45d01b814ffc88f8a8006c5179ef3089459fff74dcd00f1b,987801,2020-09-28 10:00:54 UTC,1746626851,1746623887,false,2964,987790
b4a48d5e7840cfddd291df274899fc7638821278ba9f6c09c9e4255be6ac7fcb,987801,2020-09-28 10:00:54 UTC,500002960,499992960,false,10000,0
0ffe1c6769f5dd136f55e47dca75bf4c1bc223069c45892f608867e3431a8cfd,987801,2020-09-28 10:00:54 UTC,77745397,77728779,false,16618,987790
b19d0f8372e8422e0468e070b8d1762edfed01f53553b3cc4d069292f90f9ead,987801,2020-09-28 10:00:54 UTC,1515544118993,1515544116909,false,2084,987790
67435687d4113296431e1940ce6ceb2d51d5d7650ead745ebf63abdcb4acc041,987801,2020-09-28 10:00:54 UTC,41034859,41000000,false,34859,987790
09f579f8f3e4bd29ce48560e4d79db13995d88d65a4ee6ca50b550636fc2f323,987801,2020-09-28 10:00:54 UTC,248466761,248463801,false,2960,0
553c8aa04ff626da29699b2bc27fcba4f3efba4402c1e770c94fc0cf1ad45020,987799,2020-09-28 09:57:28 UTC,14520926,14517659,false,3267,0
f5d8a8d9fece440e843dd49747988397caac423c38e242aa902605196e0ea9af,987799,2020-09-28 09:57:28 UTC,13719319,13709319,false,10000,0
fef5035e1267331195dff0522a4c5e4a2b9de978f45b566ef5c5a50e1bd6ef31,987799,2020-09-28 09:57:28 UTC,9000521,8800521,false,200000,0
b0d37b483099b540d8257fe472591a6e30e7fc91e318d79aa19de61211f20edd,987799,2020-09-28 09:57:28 UTC,500012960,500002960,false,10000,0
989ae21999d6f856f2793364c1869cebbd9ba54cdc694b49d9bf52b85a82d895,987796,2020-09-28 09:55:28 UTC,145000000,144997907,false,2093,987694
1ff579368ae26134267601bac84acd87676fe82d53e40731bdc5c3b7d7a401cc,987796,2020-09-28 09:55:28 UTC,460497500,460495918,false,1582,0
5fc77ed852242f3610ef07ead66b020b7de15e267eeb517dd2a09e1894ed2324,987796,2020-09-28 09:55:28 UTC,216552271,216549311,false,2960,0
e30277cd9725e56b2aa290700dcaa75fc0a36848c775692f5d4e26b0be961b71,987794,2020-09-28 09:52:28 UTC,1028616612,1028606612,false,10000,0
791ff872cb3defe6aae2fa1af542eb877c18ab07fc085e05fcc4f2bec6242317,987794,2020-09-28 09:52:28 UTC,11218252935,11218243335,false,9600,0
dc68edced48d8a5d68faaa32f66345ec1f4008c84d787d289b2ac76d0844cc75,987793,2020-09-28 09:51:18 UTC,100481488,100476608,false,4880,0
c3d726ba63e67c29fc08b83793cabf5865a5bfd450a1358e8a5c5404a55948ac,987792,2020-09-28 09:50:30 UTC,40394914,40361576,false,33338,987779
564459a7188a57441fe30ef01528f9ff29cb6455bcd42db2f48c977cf947573b,987791,2020-09-28 09:50:14 UTC,62729063,62687514,false,41549,987779
dfa324f45417d41274f23c41199557f2532e48084a194b4ffa17e103ade29b73,987791,2020-09-28 09:50:14 UTC,78070844,78053936,false,16908,987779
c16b76780814c5e962d9c3db15bfda2f3cbad4ccd760c3861992a558cb095dfd,987790,2020-09-28 09:50:04 UTC,248687631,248684364,false,3267,0
fc59a00219d19164dc6fb108d68d220717ceada57c66ec2781a5ed87614dfa58,987790,2020-09-28 09:50:04 UTC,500332233,500000000,false,332233,987777
9c257412b928047a2c7aded159f1f92cf43c47f8c865d74c0cadaf4bd16c1ba7,987790,2020-09-28 09:50:04 UTC,74268,70476,false,3792,0
6d3f156865134713f1f4b6d57719beada8d889ebb408f24610e24f19397160ed,987788,2020-09-28 09:47:07 UTC,499990000,499980000,false,10000,0
56ea994a8e0a5b1fb173e3cd199630b2d761329fbdb6fecb8f9359f865ddec72,987787,2020-09-28 09:46:38 UTC,2036734,2036734,false,0,0
516bd1ea45bef22e2ff7e2d76f5ba7275a41964c38d0a025018649c80b409fcb,987787,2020-09-28 09:46:38 UTC,10000,,false,10000,0
981269a0b091805b0b4e9ac3d94ef9c94798256afbe8019cd81a77efd8128d1f,987786,2020-09-28 09:45:46 UTC,14717489,14714529,false,2960,0
eb44b8181feac527b34f23ca5eaabf5fdec7adbd489511713a57fbbeb4bb5de2,987785,2020-09-28 09:43:28 UTC,1000000000,999994000,false,6000,0
f4a5d6693ce25a168dae675187a2ac20609c4aaf243ca4e6a3a9a11a3b469e05,987785,2020-09-28 09:43:28 UTC,89807275,89798731,false,8544,0
f8b2e7abd3ab48677848bfed2109492ca329da1d0b0f1f07d22aac389747a7fa,987785,2020-09-28 09:43:28 UTC,159064438,159062518,false,1920,0
00ef4113714fe31d0636d2fce3e24489df45648ddecb62a10b0de7a103ace34d,987784,2020-09-28 09:42:16 UTC,1167159657,1167091305,false,68352,0
e5ebb972aefb05b9bc0bb8cf19a1afbeedad48efc9c713530c2b31d430528264,987784,2020-09-28 09:42:16 UTC,78329484,78317514,false,11970,987743
0b02087a54a545360d94f09d0180f936953ca50156dd1c96623c070cb72f1cab,987784,2020-09-28 09:42:16 UTC,99994080,99992160,false,1920,0
72cec4f587180f8d71cc546896e4c46ecdba810362dc5954063e1d4a020f6093,987784,2020-09-28 09:42:16 UTC,216743200,216740240,false,2960,0
e9d73d0862e0a0e874ed7ec731e00aa205a185c4c229e255be8b9c6454c7d6fe,987784,2020-09-28 09:42:16 UTC,63670095,63626205,false,43890,987773
9afa1055aa1ce6435bd7053a06aa7e535d8223fe446ce0d4d10a220fba4f308a,987784,2020-09-28 09:42:16 UTC,10000,,false,10000,0
029fee1345ea430e00d9bda360408a449dd719e30c8988c756f71e00cc8bdbe4,987784,2020-09-28 09:42:16 UTC,18350359681,18350349681,false,10000,0
800ae78a0a19a5bdb61894afa38ffddd3370b6e93ff237f1ef5e13c9b0f2435c,987784,2020-09-28 09:42:16 UTC,6087776023,6087756023,false,20000,0
d4ba9afd70a058ad6c0673a80b1798b950057ebc5d18d677adca769f3839f371,987784,2020-09-28 09:42:16 UTC,33150030,33137945,false,12085,0
962f2b80c36fa5ee5cc00d94b1b14572a021724107dbb67914e2e22929e39d20,987783,2020-09-28 09:38:48 UTC,31890642,31888549,false,2093,987772
59e94268164066db250f41bcd9d139a31c61308b1caca1edfda44265f3270fb9,987783,2020-09-28 09:38:48 UTC,18351476708,18351466708,false,10000,0
d73142510fd04162ae96cf422b0003f1104250fed82bb80e7c9cc73b4409337b,987778,2020-09-28 09:36:40 UTC,248854335,248851375,false,2960,0
a510b7a5aedafc45276a1d5bd69ab9da3558703320268eac763e9d2c49a376c1,987778,2020-09-28 09:36:40 UTC,1500169463,1500159463,false,10000,0
cd4d14ec179bc0ecedc97a9ea37f2bc71677efebee0ed5a4bb586ddd1a934776,987778,2020-09-28 09:36:40 UTC,90193004,90184460,false,8544,0
0ff137f4a629ffaa59cfe418ba71879e90ef886d3d3e4ef375af5bbddbec05e4,987776,2020-09-28 09:35:33 UTC,2003558,2003558,false,0,0
c50bf92e4d46752d01f2bd63e04169971105ff82a16001751d2a91f5df736afb,987775,2020-09-28 09:35:23 UTC,499998544,499988544,false,10000,0
c1b05b6424dd0d07d199c38e3b7f3ae29a9152ac3564603e084e1495b16500a2,987775,2020-09-28 09:35:23 UTC,216924795,216921835,false,2960,0
7691c4552b6cb095f069b51baa2b370765e3b0e426379c225e48dcd29298287b,987775,2020-09-28 09:35:23 UTC,90381975,90373432,false,8543,0
c4f6f652aecbbcca5df98298fc2ba74ced3e277198d6a983a7ddc179910cb640,987775,2020-09-28 09:35:23 UTC,500000000,499990000,false,10000,0
0c9f91fec74d1addf346ef099174a8a2dde1e4b99e74a5d5717945207b8f1b77,987775,2020-09-28 09:35:23 UTC,15521406,15516785,false,4621,987763
8c53329adf8bb53ccf61a7861d508ff6e5e9e8636d4d8e28dd2c96e144a4fbd3,987775,2020-09-28 09:35:23 UTC,22071865290,22071665290,false,200000,0
970efed704f6b594acf85db733a0d4004767391c45fd6e28381f9e972dbfc60f,987775,2020-09-28 09:35:23 UTC,64807970,64758037,false,49933,987763
142ef98ad1067fea03515cb729cdeef612036a35976e488b12c2071f0ca72fa9,987775,2020-09-28 09:35:23 UTC,20322,17872,false,2450,0
938d4ecc3406d68d52e1a43f7de53757add95d5466e54c8e2f935f144536aa30,987775,2020-09-28 09:35:23 UTC,90228765,90220222,false,8543,0
93aad059d56129e8fa439d7cc00966903371247ddaa6ae5c33a3ec31f9593bfa,987775,2020-09-28 09:35:23 UTC,78872396,78852303,false,20093,987763
9d6b67c9de3d97ae6f46ce64a3249cda262ec34235841cb8e93fac0ea4f259d8,987775,2020-09-28 09:35:23 UTC,755107718,755105625,false,2093,987690
cedbbcca2388e82fcdd8f2d3f003f4296d5225322aefc1fe13e3c4331bf2cbb3,987775,2020-09-28 09:35:23 UTC,61987722444,61987722344,false,100,987764
6654577f6d843410e8c31d5398e36b28692cc448128512401bc9f59b875d7d4c,987775,2020-09-28 09:35:23 UTC,14902511,14899551,false,2960,0
d6210d2b5c905dcc0446b29b4f9d26d893627a742240844437274f4524802efc,987775,2020-09-28 09:35:23 UTC,30287706,30285446,false,2260,0
6b99a617c527155ea6939dac6190b708ded19aafcca434217c6470561c3ea542,987774,2020-09-28 09:30:13 UTC,800010369,800000000,false,10369,0
4c23901c5171d215c6a8ae0d057d056889287d33bacce415d5e7b251cc20dc4f,987774,2020-09-28 09:30:13 UTC,121043005,121042813,false,192,0
5a6dac412e1ff4647e02a9d82cc3e52ee14c2a257fcd0ef42f81ca0a9e0deebf,987774,2020-09-28 09:30:13 UTC,90415944,90407401,false,8543,0
db4110a8224d0452298de1cb301f298a2bdce40b1577e2f5a4b52e50b8b92d74,987772,2020-09-28 09:28:31 UTC,901294074,901253176,false,40898,0
50bd559ae0ef3b2654cce2d0cd9610695f5ca11b359c9cbd5e60c7b0a430ab7f,987772,2020-09-28 09:28:31 UTC,249132025,249128452,false,3573,0
c5322c66b2c2f5d89fb28bc5853375edf0e3f069eebdd239d0fb7d49f174dc46,987772,2020-09-28 09:28:31 UTC,732056232,732009972,false,46260,0
8b9146499537ec06b13ba628ce5d9d730690989e5b3c9db61dbcb1ac1ce40057,987770,2020-09-28 09:27:00 UTC,1423898,1421448,false,2450,0
9e8f7f31e86a5a1d443a80e55aa0e009ef4580945fc3f3a4b1a352993a8b56b8,987770,2020-09-28 09:27:00 UTC,18351486708,18351476708,false,10000,0
ee07311a751ed084a6910313e22fb8be948650146b75c206dc25ec28f4e88480,987770,2020-09-28 09:27:00 UTC,6440518,6438490,false,2028,0
67447a3300e4b5bc193ea08bf98b3a65984b2a4e7a917cf35d1efe919fb7761c,987770,2020-09-28 09:27:00 UTC,9274853859,9274853788,false,71,0
4b9f7055ff5562b4e8a68a0f28a934306d83eaa8cc52eff4ef85abfa29bee2e5,987769,2020-09-28 09:25:01 UTC,18890990270,18890980270,false,10000,0
0069d571a34edf92db08b9c45641d642af0eacc3ade9d5bdaeeead2840ee5092,987769,2020-09-28 09:25:01 UTC,3372596563,3372576812,false,19751,987758
86b4d126530ab6b4e19de85b42f10bb81e05e7c0285895095f60acc9ae88fb9b,987769,2020-09-28 09:25:01 UTC,16009698,16000053,false,9645,987757
9d95f76bd527b85624611eb9ff7b45828e9f54be188570fd596a27e83f7f9db4,987769,2020-09-28 09:25:01 UTC,217161986,217159026,false,2960,0
dabc3f9d774b61fb38ee5528be70d93b7d581102a47c4bf664518b81a173cc6a,987769,2020-09-28 09:25:01 UTC,3774912709941,3774912691281,false,18660,0
af77c59762a5cc354e670420a7b3231d8c4581a7c5d3ff9a3ba5f95c2e60c04b,987769,2020-09-28 09:25:01 UTC,362648000,362638000,false,10000,0
71961ebe41a86975216c3ba184e38e334d321ab45e988bce4c568d3e853b329d,987769,2020-09-28 09:25:01 UTC,90672973,90664430,false,8543,0
16793778b53d3275af4fc5205f6da4821f4bfa25cb1e099071a4e0d10605e9c5,987769,2020-09-28 09:25:01 UTC,144000000,143931656,false,68344,0
d82d44131e1a19318144e01efe7c8ac5209300f5ac23689607a773c2c61b1332,987769,2020-09-28 09:25:01 UTC,599996340,599994080,false,2260,0
034c30c2062ff4d50530484cdbca5d27ebfbd56cfd791be470dfc75520c608a8,987768,2020-09-28 09:21:45 UTC,781112018,781109925,false,2093,987757
5a55e871c0e0f4b9af65b7b9c69fec9bd8d8f929d59d648ab2eecb2bf4d2cb93,987768,2020-09-28 09:21:45 UTC,500008544,499998544,false,10000,0
377afa9ef61d36950ae9f905b3ff6f8224dfa24b067700283c3e0f4f58a00561,987768,2020-09-28 09:21:45 UTC,8829160,8828602,false,558,0
59fe27c18651c542db8e1587d64350a92ce166ed2d678eb15016fb98c4f88d21,987768,2020-09-28 09:21:45 UTC,5333508276,5333501275,false,7001,0
fb2fa24444838ecc4ff99bbce2df6038c3cfb9b2b10dbb122025318d4a1ce975,987766,2020-09-28 09:20:17 UTC,79437979,79418185,false,19794,987754
4f74a969e337d963697e1df137cb2852439ee8cf01a33f81c0f7b3c4dd22cf0c,987765,2020-09-28 09:20:06 UTC,951349937,951249937,false,100000,0
7dc7060ce8bcf06f4f393c27f1960a594bc6e1637441b82b3cce0da8490120f4,987765,2020-09-28 09:20:06 UTC,3188900000,3188800000,false,100000,0
8bc718c6f6d3705cb9ad7142ec1fbf484ebc8b93a7ce93c7a0f222dcc09106d8,987765,2020-09-28 09:20:06 UTC,65812699,65765089,false,47610,987754
69774dfeb70f18fea6f6deaf7c563aff9d1526d4d3d6c5c9a16a990ea95c3c1a,987763,2020-09-28 09:18:52 UTC,114071,111621,false,2450,0
b6b0b1b8d365775a6fb6bf3aa1bd0a6e404ba476d002bf2326660bc29b256af2,987763,2020-09-28 09:18:52 UTC,156952413,156940413,false,12000,0
7c73a0bd57dc03d3fdfee9783975ca7965c4027c253ea71faa8a22cba22e1faf,987762,2020-09-28 09:18:04 UTC,15117204,15113937,false,3267,0
2a2c9bed8e5d10550b03bf2521039720f4d3d877cb5d2bd1ee2fb210576b5238,987762,2020-09-28 09:18:04 UTC,1552754040377,1552754038293,false,2084,987751
86ade831e4a6b7034517da646e01f8984040a98d9f201bf6abbd10b0a246ae10,987762,2020-09-28 09:18:04 UTC,1208918,1208918,false,0,0
d7fc33c0b67124559001e6acd5793c2caf931e74b5924dcd8c86c51b90b3a3b7,987762,2020-09-28 09:18:04 UTC,62209622544,62209622444,false,100,987751
577717f7c4d25f508976d0a66019777c78acb51a7550d3ecd2336b5a8e4c5238,987760,2020-09-28 09:16:32 UTC,1068068615,1068038615,false,30000,0
65423a9bfd7a7b50caa2abe514aed52c776a4358c23fb98f0be4314938c5be29,987758,2020-09-28 09:16:02 UTC,499998960,499988960,false,10000,0
4157d21793d0c44fcaf15e496d89a961d4d9c1a73a025acd21f123830e14341e,987758,2020-09-28 09:16:02 UTC,249279031,249276071,false,2960,0
0195d3896659c478c482f8d2f8b437a032630abe6c8d1d62fcb2fbce2bfb60e9,987758,2020-09-28 09:16:02 UTC,6510574,6502031,false,8543,0
6cb0d0c4fb5ff2487c64e83c3fd3c903362e9c971963e0732f1180bcfa1c867b,987756,2020-09-28 09:14:09 UTC,60165696529,60165680949,false,15580,0
330274a62933e70bd0001bda2542600774913d3366aad3a8d396b720b8fca403,987755,2020-09-28 09:12:55 UTC,500008960,499998960,false,10000,0
ae31748e008b84ade2ba2f032c99067f546dd74f3911314ab0182e628627d28b,987755,2020-09-28 09:12:55 UTC,999940074,999930074,false,10000,0
0107eecf961e63379564c9929845d5e3348519d916065d6ca6e177fae8a651b2,987755,2020-09-28 09:12:55 UTC,35278,30398,false,4880,0
34cdeba1e0cb4334f18ef896bc791a5c24fc7d4f34f0033b98efaa4a8f835ee5,987755,2020-09-28 09:12:55 UTC,217445328,217442368,false,2960,0
1132bf627b068099a89abafc4391ac4da23ffe3c20cb2de57c80e8227864b8e3,987755,2020-09-28 09:12:55 UTC,477802519,477800259,false,2260,0
61a165bf8f0e330b16a1d64e1b18312023b7264ba833fe4c68bfb97c8b1a9eef,987754,2020-09-28 09:11:17 UTC,90720028,90711485,false,8543,0
69b088c945819489cda0624eef20363c578c9ffbcb101e5adc50afbb6ed6a0ab,987753,2020-09-28 09:10:49 UTC,90755605,90747062,false,8543,0
8d11865aacb29f9b267392bd84379a5d742635f40901065546e137b0987c9cce,987752,2020-09-28 09:10:44 UTC,127955058,127945058,false,10000,0
ba683b804fd4d86fbbb7800266f9f0b9d52e8b920cb16a9b8290bb6cc9a67f0f,987752,2020-09-28 09:10:44 UTC,63011522644,63011522544,false,100,987740
82ddaeb5c26c84957b931101733593f6078f28da3536a54362d9c7a9e0b9b6d4,987752,2020-09-28 09:10:44 UTC,79983480,79963379,false,20101,987703
3580b27155ebda3dd7c1e43dcd44d2f043556b4e83e1300c0b8e4891b3c9d978,987752,2020-09-28 09:10:44 UTC,66649716,66602363,false,47353,987741
8e1325a64d7bb078ca131cc9610ef2be6ee0f91149d9511e221f788f23521056,987752,2020-09-28 09:10:44 UTC,700000080,699996340,false,3740,0
9603b7b88b1bc3723b67446c096e64d326e734303b4eb795b9f9820f13a11ff6,987750,2020-09-28 09:08:19 UTC,68510968,68508875,false,2093,987738
d4204a8e25b51f94016b4303652dce972c42b5dd629cc2ef666bdacda587af0a,987750,2020-09-28 09:08:19 UTC,149999500000,149999499929,false,71,0
83eba8378933085a853bf52c252085f7d3a703123cb29a5b40131cd6e81f1fd1,987750,2020-09-28 09:08:19 UTC,1648885314,1648785314,false,100000,0
d7d850b44eac8aabe59604d4256ceb08d9895de29a09a93e010bbbfe05829381,987749,2020-09-28 09:07:29 UTC,1553024142461,1553024140377,false,2084,987738
ff323799d4714562e42c07713d75c0d104a2ce55aee5822d151a27cf7fa5081b,987749,2020-09-28 09:07:29 UTC,15372335,15368762,false,3573,0
04f6e7e2e98914f27901016f9fab5dbce33677ad6eb73803395f6da29eeb098c,987749,2020-09-28 09:07:29 UTC,1000050280,1000040280,false,10000,0
5e3261fd0c006dfbbc885687413c248d9d45df638bcd37e655bc99a1fa7d60f3,987748,2020-09-28 09:06:17 UTC,124071,114071,false,10000,0
76693582ad8cc819f0aff650c2b926b665f096646aece86c16e206c05cb0212e,987747,2020-09-28 09:05:22 UTC,1554272096144,1554272093761,false,2383,987736
5e607328a57bcbd971414db7afea651adc7e66dff2018172c98862d055bab680,987747,2020-09-28 09:05:22 UTC,2000030576,2000020576,false,10000,0
dbc670b823f34357eba678406dc31b4e1f30db8b4df783b600e737160b5d8d04,987747,2020-09-28 09:05:22 UTC,2000123116,2000113116,false,10000,0
447e451fce2e602bc72fc2ba87cab042a9e7c6c98b59e0903d71c65964e8f9e2,987747,2020-09-28 09:05:22 UTC,19365649126,19365647065,false,2061,0
7a13687360d2e9936d70e92b8245b30e4f9f5b7848c0dc2fdad0f2bc78f7f245,987747,2020-09-28 09:05:22 UTC,10000,,false,10000,0
8eb71b8771edec32a2b1918e28ede1a05c734f320f0398b5697c6ca7dbaf9a75,987747,2020-09-28 09:05:22 UTC,500000000,499990000,false,10000,0
1b48daabe9da973bb28a2acc4a4f80a0a289c1b534972e915af9d7b562bc50fa,987747,2020-09-28 09:05:22 UTC,90997441,90988898,false,8543,0
4a127b8dce246078b8b7d0651a1e5e1bd5141233ef17fbcaeb351381fc3fee91,987747,2020-09-28 09:05:22 UTC,196964603,196962153,false,2450,0
2b3546395815637f8a72648bf8c3cd4d9e259a97132d519d3180fb02b2884f1f,987747,2020-09-28 09:05:22 UTC,1505925126,1505918126,false,7000,0
536ea31e57d19a52e25a0c8395f5b75080d0afff7841f2bc698f4bfa444542a0,987747,2020-09-28 09:05:22 UTC,240080627911,240080617911,false,10000,0
137927e266eca567ad35f9fe1cebfc19b0c08ede90584a5c2edf40ba139baf4a,987747,2020-09-28 09:05:22 UTC,249492207,249488940,false,3267,0
8253cd1f8e6cc29d3b3d2a4851df3c4c2a85d1cbcbd38642d3bdb85e5d0198dd,987747,2020-09-28 09:05:22 UTC,144000000,143931656,false,68344,0
9266d12d77bdb60c95842af6030e9e63ba0bb1b53ca32c5368c3dffcb1b1d905,987747,2020-09-28 09:05:22 UTC,91048936,91040393,false,8543,0
26eaa5b139334befeb191835ad5a80503a553848a49cd06b9d7849a8b045b71a,987746,2020-09-28 09:02:40 UTC,8669204,8666138,false,3066,987734
cbaffe09c5bbde64eff976236c15b40a8aa657d3ab08b3a81614564e5826b699,987745,2020-09-28 09:02:05 UTC,217656915,217653955,false,2960,0
5e9aa241473118b938421326794e054bb78e4c0cedb709437b7683b508789faf,987745,2020-09-28 09:02:05 UTC,1835985242,1835982569,false,2673,987734
7bec3dc97438adf84471c2857359791f631c1867d197cb7bcdd159d903687601,987745,2020-09-28 09:02:05 UTC,7313241812,7313237874,false,3938,987734
af9be5cb8ad3e2d90f0cde549db6cbc1f10acf98d53b44e5468d8854f97af6c7,987745,2020-09-28 09:02:05 UTC,2918382537,2918378797,false,3740,0
b6f1355df77c8a7adf5f769b27b4d190f9eaee72b815ad9213d903b8c7761391,987745,2020-09-28 09:02:05 UTC,524943598,524941338,false,2260,0
71d72a1ef509eda28cae63f02f71e103735da2adb8586b8ec4686f5479e28eb8,987744,2020-09-28 09:00:33 UTC,80503783,80482230,false,21553,987733
859b5f6baf27238e61234d1209f10357d6104e49d3e32db1307cb0914952283b,987744,2020-09-28 09:00:33 UTC,85641374421,85641374350,false,71,0
52a41fc665be23b49c6283bf3f1e9d71e6ebde15f97bf71282cc3d472d63fcd2,987744,2020-09-28 09:00:33 UTC,35065029,35058249,false,6780,0
43cfed97ed7f2a5f50168335e501e5192dbdc22d0a3a6fb7c9d3b1def463e862,987744,2020-09-28 09:00:33 UTC,404614214,404529974,false,84240,987743
ecf56dc9098b62e99263e3fca3cc51d6ec47ed791a9356329ceaf05faeaec597,987744,2020-09-28 09:00:33 UTC,93321000,93311000,false,10000,0
b6f8cacfdca40844cfc1ec11d17b74ac4955030d6b407d0d3ce341cbb6154c5c,987744,2020-09-28 09:00:33 UTC,67840683,67791536,false,49147,987733
32153ffd91d00373969d91b16bf717cd8ae8b3d253d013b00873a1303134bd9a,987744,2020-09-28 09:00:33 UTC,16632027,16627842,false,4185,0
e357e108a730a9a32e3eac496bcf3fbfb48aa3678156d492501fc98aac1e178b,987744,2020-09-28 09:00:33 UTC,10000,,false,10000,0
f5c5a265c53b9ed2c84eeb59ee532d3fa2f2387917267f3814535953b90c9252,987744,2020-09-28 09:00:33 UTC,54607146,54601146,false,6000,0
22c7f7545a06e16270f22911726f9e656fb4f88d5bde9d7cae945ef74ce6add1,987744,2020-09-28 09:00:33 UTC,37943415568,37943405568,false,10000,0
70b08858fb0d1f41461934271c9c2afdf8d55e4d6ca7cecb7a0be8af69ed672b,987744,2020-09-28 09:00:33 UTC,2310000000,2309997916,false,2084,0
81fd49e1a8aa00efea778fe3cbcfc918d916830693b4f8fe95870a6869059714,987744,2020-09-28 09:00:33 UTC,1564272098237,1564272096144,false,2093,987733
693aa2c771f12e8f9b95e3dac6e3f84c859c08072d8d485dd108cd90019477b7,987743,2020-09-28 08:54:41 UTC,3501013997,3501001849,false,12148,987731
6c5f6c2d862dc3fed481be9eab8874ffa799b4577c53feee028e309369286abb,987743,2020-09-28 08:54:41 UTC,91085981,91077438,false,8543,0
3323b862a794871807aa1a1c5e6352a1bcd854dce1ee84258c76dd5c08feba8d,987743,2020-09-28 08:54:41 UTC,572049667,572047407,false,2260,0
c29ac18935929a438d1449a77eae068634acdded1286a432349ff2dc2c0e9bf2,987743,2020-09-28 08:54:41 UTC,112406976794,112406974444,false,2350,0
8bc59e96cb19e494677135322d053ed87869e3642fbebe16c232e1ec7aa68eab,987743,2020-09-28 08:54:41 UTC,48392680,48382680,false,10000,0
0b7e02639c59bd487a7923b3346539f2d3dfb2f79a0ca49a92a8792adb3981d5,987742,2020-09-28 08:52:53 UTC,14749602702,14749572702,false,30000,0
d6900257c78fc0880f7af23c74879ca3cc67d547e12facbe063cd933c3f7e1c9,987741,2020-09-28 08:52:31 UTC,249984482,249979073,false,5409,0
5c70e8336cea9c4e818d13401329475cfecaa813fcd2f71218174649c1afc158,987740,2020-09-28 08:51:37 UTC,4582500000,4582497550,false,2450,0
2e9aab95b26a4bc61b8fc7daed2658182873ee76c2d1f30def51a3fdb3f3ece5,987740,2020-09-28 08:51:37 UTC,819452672,819450579,false,2093,987728
a536bee7fcac8372ad2e96af2917e2034be189002b67e45d46f6743a0b36fdc5,987740,2020-09-28 08:51:37 UTC,47662788,47627244,false,35544,0
ec52de6e7e1e9e0c3e73bf857c86a849a9a44f4a3a044cdf123c075d5c2091ea,987740,2020-09-28 08:51:37 UTC,81084001,81065643,false,18358,987685
2641404a9c660cb27234d69adeedbaa69735e9f8b46870b25314e0ec43eebc82,987740,2020-09-28 08:51:37 UTC,1567168659149,1567168657056,false,2093,987729
04091ea3b55eeedb4c58141365eca5bacacaf4f6ed250f9170185dd905e3898d,987740,2020-09-28 08:51:37 UTC,69232001,69185476,false,46525,987728
2f53d84e56d526fa7bb6a3069e3658d83d9d7c4879e5059c2ccfe93e2c16ce0c,987740,2020-09-28 08:51:37 UTC,120238527,120209867,false,28660,0
a4b0562f27ad095633eb862ebf9cca67cdf277805a9467d66aa480edd93c890f,987739,2020-09-28 08:49:51 UTC,619193610,619191350,false,2260,0
931469ec3a61d474f23f8e781e53ed95e44499ab83c322c525027e529f5dfdd4,987738,2020-09-28 08:49:21 UTC,61001735468,61001635468,false,100000,987727
718b5b5fee8722e1d7df21c94204608445ecca31008ebbf1a324f53af26e1a76,987738,2020-09-28 08:49:21 UTC,190570883,190567143,false,3740,0
f6969fd1040c0998a109700fb78cf0dde9454f051b101590bc93d7319a0121e9,987738,2020-09-28 08:49:21 UTC,104411647,104401647,false,10000,0
a406303217f0f5db64158f94c5fa81f4521f9c5ea89578fc0cee59604d779026,987736,2020-09-28 08:48:33 UTC,95290365097,95290364421,false,676,0
ac6d445612abc311396be945693df4258556b17f7053178cf8db5be078d05d36,987735,2020-09-28 08:48:02 UTC,1567337404667,1567337402574,false,2093,987724
90a868f44fc80f1f19f5b2917837b5177764a12a0eef4f9d7913118f6ce7ac9b,987735,2020-09-28 08:48:02 UTC,666339131,666336871,false,2260,0
cadda1f185cffe3bd08ea7421e31b542efae9cc3634150ce19a38bea13bbee49,987735,2020-09-28 08:48:02 UTC,279886841,279636472,false,250369,987723
6f33dcf4ea4d28b220c0eb8e68e26fec96f54163828f61639ec22b0c279550af,987735,2020-09-28 08:48:02 UTC,109672152,109662152,false,10000,0
a054ea28dd0dfd208d0cb65c5b73d1cd063716a8dda5e3431ae7340f73b3e7b8,987734,2020-09-28 08:46:10 UTC,2824984862,2824731659,false,253203,0
8e83fc677e4538a84bbf76a028b1b4da03b154c7a6043e7646f43649546b2b4e,987734,2020-09-28 08:46:10 UTC,106726119,106710000,false,16119,0
2b7944a3464a5d7aba0899fb2a7322b2736ff7c6b2fe816aa91131e9020bc1f1,987734,2020-09-28 08:46:10 UTC,249112,249052,false,60,0
f93ef0be6b2e87eeac10da6aac1e8eb88895d1a69c05bf6e99b26d35b5e2f8db,987734,2020-09-28 08:46:10 UTC,189284818,189260818,false,24000,0
2279d54e99d6f1820519b1d8a2e1de55a874834316be6ec21407cf2c1e5cd2aa,987734,2020-09-28 08:46:10 UTC,91241184,91232641,false,8543,0
162c8ff7c159214d5ca59b3a0b70420fd897945895ca671bcd9742a88395090b,987734,2020-09-28 08:46:10 UTC,951418281,951349937,false,68344,0
12240466a3270256c25adc84ba17c8dcabccecadf117a5bd70cb18a09e266e92,987733,2020-09-28 08:43:15 UTC,713471485,713469225,false,2260,0
b750932aa8a01883679148890a19fd4ded0b322d9f59fa6caef77a20501779ed,987733,2020-09-28 08:43:15 UTC,217900246,217896673,false,3573,0
3dc4d1d5a5765f6c4c21f7ec08bb246aebd7cac9e1ac745b683086530a5a83b9,987733,2020-09-28 08:43:15 UTC,31986211,31980211,false,6000,0
cbc861706df0207ebae8d230a5fb33a08904e30e2f60e60daaf7c5fbf82cdf6b,987733,2020-09-28 08:43:15 UTC,70593399,70542552,false,50847,987721
94cfd01a19d1e20317773d7c1095ea6367c980ac4f44e12876b25efa856b2f62,987733,2020-09-28 08:43:15 UTC,30306914,29402954,false,903960,987732
b2748f202afa88181691d2b0d71434f3215e4aacd5ee70a38fa258d8a7bb87fe,987733,2020-09-28 08:43:15 UTC,149990000,149985326,false,4674,0
da88a38fe0b7f04b2164e95ad2ed76f68426755ffe5768e47e3062318d117778,987732,2020-09-28 08:40:08 UTC,595840,593920,false,1920,0
009c34240747678285cbf9c4ecadd63e4c10354cfe4a288b430e370264d1f44d,987732,2020-09-28 08:40:08 UTC,5000712834,5000702834,false,10000,0
6c34b5dddbd9688805e4d20da69d04bab0e191a394b41b6ca1985f143f2c7067,987732,2020-09-28 08:40:08 UTC,39955929,39949929,false,6000,0
19bfce388bf280cfed6f8806de3530e8d9426a054fd5f86c1b84a45294a238c2,987732,2020-09-28 08:40:08 UTC,1567443409720,1567443407636,false,2084,987721
700ea64182ee038a7ae99251e6a7b749d99a79fb252a2bde08d79169b3285913,987732,2020-09-28 08:40:08 UTC,66957764,66955671,false,2093,987721
71abf6de0f726d68ffea6c123922e231d59ce2ac8a8399cccb22177edff8008e,987732,2020-09-28 08:40:08 UTC,320122443,320120523,false,1920,0
d2db384b77c478b567cdc05b3efc8b2c5b37378811cbe9632d108be7b38df5ae,987732,2020-09-28 08:40:08 UTC,1241631,1237010,false,4621,987706
9861fb1241127de2200e8991d8405b42b26de14cdfc64c53b27da0f5022d24fb,987732,2020-09-28 08:40:08 UTC,218750453,218746880,false,3573,0
fb1aea91732fb8ebd16e0c473a4bbf5d9b14b5495403ae9e0488282538ec7166,987732,2020-09-28 08:40:08 UTC,81878289,81854121,false,24168,987721
439ef77f1ef42d81a41b17a79e7a10eecc02dbf8c27b358a911c40a2e5cbc1bd,987732,2020-09-28 08:40:08 UTC,15188920049,15188890049,false,30000,0
07e7ea2ca9708c71d49867c4d520fc7f592a9c9a09a0ecee5f86e64f2173af85,987732,2020-09-28 08:40:08 UTC,645234,643314,false,1920,0
893ee891ac8ff4a9d839ebdbb94a0fd5b61649c0343e27db31327d36b8bb65e9,987732,2020-09-28 08:40:08 UTC,1180974,1154500,false,26474,987721
fe9bb84e47d251f026e4447bcf5a1c87ad6640d9911c928ea3760111dfa2d84c,987732,2020-09-28 08:40:08 UTC,250304005,250301045,false,2960,0
bcf55748e01cfb0f7b44191c98195a6a080936de64be57b4abff12d0846ab493,987732,2020-09-28 08:40:08 UTC,71560562,71517583,false,42979,987721
e4d1066bd47147d1319d66ea34eea540256a7119f2d6c8c1b52feeef560dbf69,987732,2020-09-28 08:40:08 UTC,218049281,218046321,false,2960,0
5226ee4e4fdcb5f6028e83de2802f02861f5290f9d0e7dcecf4cc1786935168e,987732,2020-09-28 08:40:08 UTC,63225666836,63225666736,false,100,987721
32a9f8e4ae6ba952a27675f9b407511d67910d3236bb0d8802112cd5917f546e,987732,2020-09-28 08:40:08 UTC,779233,777313,false,1920,0
1f29ce7d64d658c58538e6d7447e3925e3d7563b1f8a946aaeda88ffeabce96a,987732,2020-09-28 08:40:08 UTC,218403735,218400468,false,3267,0
9e53e648c17b14fd4b56d4a92adea432c9fb2f40be5f05989d13808b8bc439b7,987732,2020-09-28 08:40:08 UTC,506049,504129,false,1920,0
9483dbf2a155ebd33deec398c36626652bff5aa405f2d3ca6494f1a70076753b,987732,2020-09-28 08:40:08 UTC,131747254,131746802,false,452,0
bcd43999b794d3ada68b22b1da2b07334048f03e39df1b8879aa8b909310b4df,987732,2020-09-28 08:40:08 UTC,580944,579024,false,1920,0
edd06350d2406b7890f4cf3ac3dd39efd136b96e92341e24bcbeea261e20381e,987732,2020-09-28 08:40:08 UTC,6334408,6326002,false,8406,987721
4b56d990a6daeec0696a123333cc66579ebc3e220742df224bead0a3a3d1e737,987732,2020-09-28 08:40:08 UTC,976558773,976548773,false,10000,0
13095ce445b0a062c106feda6f0ec01e5e303f3d94f522945806efb4b4b2e601,987732,2020-09-28 08:40:08 UTC,326253,324333,false,1920,0
0f2b856222c0f6de228d44b0ab76eb8522c37c4dbe1957722781ad65bf8744ff,987732,2020-09-28 08:40:08 UTC,45702738574,45702726199,false,12375,0
13d4f572c28c490dc8b6fe367454d52646a1747bfba66a337c2397646df24cd5,987732,2020-09-28 08:40:08 UTC,91409425,91400882,false,8543,0
ac054a2c4560e669510d70695431afd64e422b00fd8c401f92570448f311a938,987732,2020-09-28 08:40:08 UTC,16870107,16866840,false,3267,0
8792ada69b72014fd83db36d8d77ed2d716446bd454e3d91f26750bc5946459d,987732,2020-09-28 08:40:08 UTC,557680,555760,false,1920,0
e5d0dce10f6c57a7f9dc13ef39e1a769e329ee83b7abdf625d832ef02f6ff5a8,987732,2020-09-28 08:40:08 UTC,872323241,872321157,false,2084,987721
af4e792fc11f1389361e5d06acc0b96d0d14f23f15f5a2d5169c35434efe53f3,987731,2020-09-28 08:29:01 UTC,18391011310,18391001310,false,10000,0
656055315cf91fe40a6fde145e4850719bb210976389ad8c85aa57651d748cfe,987731,2020-09-28 08:29:01 UTC,191126156,191046156,false,80000,0
32af2dc877a956dc7c3d9e80666cedde04c059478e5f9108c843ff9ab9d77de0,987731,2020-09-28 08:29:01 UTC,1002552,1000632,false,1920,0
807a0d46fa206a952a7ff7c7526ae756345a797466d7d2ef3dee92ff470e6c87,987731,2020-09-28 08:29:01 UTC,1301481716,1301401316,false,80400,987730
f6b472ee456f37565a0dadb296985ddce74c155ec16189a20dbed389beae1267,987731,2020-09-28 08:29:01 UTC,401280541,401000006,false,280535,987720
b03ba0b16695e0fd57215a01ba761a4445f7b74224baa30a1896fc58541ecce4,987731,2020-09-28 08:29:01 UTC,9776539607,9776535867,false,3740,0
2869052233f5e9e3cc1445cef224986aeb61c2b1c8b202ca602bba4003e3e084,987731,2020-09-28 08:29:01 UTC,849177,847257,false,1920,0
a061ffcc578201d8feb47d3771398d7b2b7c3047584d15e823e843f3c3fcde21,987730,2020-09-28 08:26:31 UTC,218910895,218907935,false,2960,0
54780ee4720958d78a441c5b6bedd9cadc66536adde18963d6f54f7199861bda,987730,2020-09-28 08:26:31 UTC,1570578311796,1570578309720,false,2076,987717
905b466d38352109a575394ca694e7245524d7088109e9870b5efbea9f858494,987730,2020-09-28 08:26:31 UTC,194849978,194765738,false,84240,987729
9875d91e0bf0dd2eac660ddd8cd4f8bf42227523d75a7dcf172160b8cf71592c,987730,2020-09-28 08:26:31 UTC,52744818,52738818,false,6000,0
306511e55d7fee08b8c5fe4038df603e85558599d6f04f7ec402dbf499222c02,987730,2020-09-28 08:26:31 UTC,499980000,499970000,false,10000,0
ca593641972ef5a3cd3cb4260943b3f0e3e3ace5bafe9761ace1dd7c39c2048d,987729,2020-09-28 08:23:50 UTC,98631920,98630192,false,1728,0
1ebb08b46ede1e368cb3edfd1aa8001c4c2b99b64f84679f04ea79cb592828b2,987728,2020-09-28 08:23:32 UTC,190046168,190000000,false,46168,987716
829d24bdd10c4e143919cc2b54979701447b4b9e180fa83ef4f68791776233bf,987728,2020-09-28 08:23:32 UTC,34041018010,34041015917,false,2093,987717
4f9f016fa84a59fe53a33263476918c1fcb98f4697c16a75cf940811eeda6baf,987728,2020-09-28 08:23:32 UTC,17077889,17074622,false,3267,0
564603da3d94090bd8cc49fa84505fa58b68c09d849ea8c24b8a0a13a02e28c9,987727,2020-09-28 08:22:10 UTC,1006264,1001659,false,4605,987716
612685fff6b862ea92fdb913f1f870627487a10719e533078936732d6021fb20,987727,2020-09-28 08:22:10 UTC,1600259486780,1600259484696,false,2084,987715
14c57061a0326530cf4ad6d49cf4405d60ea6a7254abe38b82eb9a2d6ca64772,987727,2020-09-28 08:22:10 UTC,905667672,905665579,false,2093,987716
e0b54a784965af2d02c185f41aefe22c74e3dd3612fe6e5325d6375d5a85d8ed,987725,2020-09-28 08:21:21 UTC,63335794429,63335794329,false,100,987713
8125133bfae44019bc5fb9c80e3b5be5df87e646d6d88a916cd3f3a241339331,987724,2020-09-28 08:20:24 UTC,82664431,82636498,false,27933,987713
24da7fb920fce872bc3ea2a8eaa9249237bd314df20c9c957ae523254e6d6aa7,987724,2020-09-28 08:20:24 UTC,72723348,72670463,false,52885,987689
05381cfc90c60627d0f1df7d2ae7f62d497b0c1be3ca53eeb957132ac9cda208,987721,2020-09-28 08:19:25 UTC,131724570,131722120,false,2450,0
1fce9af1b4712eacee20e031122f41b3b93e295cdb8fd0cd1c76e7050121d18c,987721,2020-09-28 08:19:25 UTC,499990000,499980000,false,10000,0
45de9168a16c920990a23288981d13da682f1e6191da0ae8b812243146b8d5de,987721,2020-09-28 08:19:25 UTC,1610014197282,1610014195189,false,2093,987709
e3e92217e3d131719c76453668cea4620a2843277970087a7f7cfb58c4840837,987721,2020-09-28 08:19:25 UTC,108549669714,108549649714,false,20000,0
45f051d41e3151df50f8d3b70039de01496feddb3895b3e64969999b99dd3e6c,987721,2020-09-28 08:19:25 UTC,98633648,98631920,false,1728,0
07b3c443e832d49356c139875548621039646c10e3a529e70d6b2e5b832dc2e9,987720,2020-09-28 08:17:24 UTC,250658162,250653977,false,4185,0
e4f46a24a74e7a9ac709a5d2c4a69651581a35c09a3834cd9528484badc61b44,987719,2020-09-28 08:16:11 UTC,91528879,91520334,false,8545,0
81b516103c17228a866a587d41f562cad3e858bdf9e7b1b08fa94f7017c7b2a7,987719,2020-09-28 08:16:11 UTC,92878010,92868010,false,10000,0
16cdaf6f229c646371536c4b6bffefef52609647002450d615874bb0f0b1b32a,987719,2020-09-28 08:16:11 UTC,472037510,472027510,false,10000,0
ad27aa2e5cc1eec3a3ec8430fb98e3ad7b9a0a680d0109c2f45efcb608d2bf0a,987719,2020-09-28 08:16:11 UTC,500000000,499990000,false,10000,0
8e197cb8741cde0620dc84e5de856720e9981196bde9f6c9f775f943f800948a,987719,2020-09-28 08:16:11 UTC,64335783744,64335783644,false,100,987707
5fd436922083e415d4210d0e6f6324741d9cddccc41aff8c34d8937999517542,987716,2020-09-28 08:13:26 UTC,364311430,364301430,false,10000,0
66c1fddabbba5c858dcf2d8f97dfd802d176958f91093396267f23a241c2d1a6,987715,2020-09-28 08:10:55 UTC,1000000000,999990000,false,10000,0
24c38e135e1c31da5f669e80e7e5921ae1b9544cf17b1d8ecf54fce06b277e2d,987715,2020-09-28 08:10:55 UTC,994997375,994987375,false,10000,0
874ce894503d769b83e199a73ea683de5bb550abdc46acd6efe838527a5814d9,987715,2020-09-28 08:10:55 UTC,73975515,73924075,false,51440,987703
3a250103d51369214575c1719cb011c81d83e26ef21b68e79d1bf7fc93e96ad8,987715,2020-09-28 08:10:55 UTC,219054388,219051428,false,2960,0
57ec91dd9b2d86d68553a1d5362f3ae28453ca59a43ca22dc4b4af1b2a985128,987715,2020-09-28 08:10:55 UTC,622200485,622132125,false,68360,0
0575578f19ab16127ebe41682843eceb539943e3ecf5300eabee63ec68c4fbed,987715,2020-09-28 08:10:55 UTC,6000342,5900342,false,100000,0
73eb1a5f7dbc42b41c7d4f6b8021086ebeb0925d105bfec787e30cffb82481f3,987715,2020-09-28 08:10:55 UTC,83117284,83097511,false,19773,987703
fba6e0df6a34e671cf326c094e3a635ecec9d42bed5684c462591b7201298a4f,987713,2020-09-28 08:07:36 UTC,932254958,932252865,false,2093,987702
0d6161df25a66d8faaa021d75685e07793d7eeaa2276cb9049384acceb11c4cd,987712,2020-09-28 08:06:30 UTC,500010762,500000762,false,10000,0
4e48be99d1c4e8274e4e6c640f1a268d7d4ef5f12d196f5719513da780459a25,987712,2020-09-28 08:06:30 UTC,10000,,false,10000,0
7c02e7a062e2892ce3ba5446001407ce6e311ff7e69616a01be21f500e0494f0,987712,2020-09-28 08:06:30 UTC,102681343,102675465,false,5878,987700
b9414d61b7d77dfb6a941bfc3742ddfb2d0c698bfae61f7f1681b5e38cda7416,987711,2020-09-28 08:06:18 UTC,1500085802,1500075802,false,10000,0
d602c2333242c53b94d5d1857230d1c11ad0c2d06a069621f73c75dede627533,987711,2020-09-28 08:06:18 UTC,237698037472,237698027472,false,10000,0
52327775da3e0b142714b964149e2bf166949fed0febeb6ef7df14471f6275b1,987711,2020-09-28 08:06:18 UTC,51453996,51451546,false,2450,0
aeac596aa20fef4798701111f230a3ebfb9908f5a690705c0ab0e3cad561a82a,987711,2020-09-28 08:06:18 UTC,2000133116,2000123116,false,10000,0
65e00bdae8e27fc6a2fe4b73479cced34583cca32d3d1d5987704e5270d8af0d,987711,2020-09-28 08:06:18 UTC,20020940,20019020,false,1920,0
168c5e7b6091dc8d52a60365dffe8eca64efb914c9861e8e585c94295db574c0,987711,2020-09-28 08:06:18 UTC,91557470,91548925,false,8545,0
59fc3539cc35a2c517bef1b8144eb70d91bb9c948c64fc291a4f7fdf161b71f2,987711,2020-09-28 08:06:18 UTC,17235161,17232201,false,2960,0
38b1578eab7c093cc101c55a036baf84c55b56779f0f214da0c14c6f3788d49f,987711,2020-09-28 08:06:18 UTC,3001696500,3001686500,false,10000,0
c7af618af9e11f072c6aaf0ccbb42732295a5942c067fbf47f22c208cdb27883,987711,2020-09-28 08:06:18 UTC,91906259,91897714,false,8545,0
e87199e46e94ac9a4b41578441a1e7d55fb0f538120fa4a46baf38d8dad1224f,987709,2020-09-28 08:01:18 UTC,1879764028,1879761354,false,2674,987697
1947038d1455656e3b05a1c40e0b67cd387c695c6d9fff8c46afabd20321ac3f,987708,2020-09-28 08:01:00 UTC,83532187,83514123,false,18064,987697
799c84af6f70d8972dab8194a4d3bc16698c09a2de289253d2d45edf243d0635,987708,2020-09-28 08:01:00 UTC,180890627,180886697,false,3930,987697
d3ecc9794782b0b3edf0b342a973cc41a79a6fa79875b7ed770028caf601a9d4,987708,2020-09-28 08:01:00 UTC,101759486,101732224,false,27262,0
28d3b2db83df57ccde9201dc81e71073b521307341073cda11d201fdfd4ba602,987708,2020-09-28 08:01:00 UTC,251008686,251004807,false,3879,0
65f3ae14b67418e8e1334a59096c714c0ed3bb0b9b3740a1900187b70806a3d0,987708,2020-09-28 08:01:00 UTC,74922302,74872596,false,49706,987651
3e9a580f1b05013311d941f69687804cf81c7e9e0aec9d92b771530141ceaabd,987707,2020-09-28 07:59:34 UTC,18296880559,18296870559,false,10000,0
2a8bfe5c2a64cae85ec812bbd43785e62d484607439af68300ca157aa440cbcb,987707,2020-09-28 07:59:34 UTC,92046755,92038210,false,8545,0
cbd85f11527caa802a1f853627e5ac24fe4faf9ad6f5543dd94c9e3b2512684c,987704,2020-09-28 07:57:27 UTC,219245969,219243009,false,2960,0
51982a3be39a17240fe39941e9df19f3b98ddbd475c2649de85a540636642b6d,987704,2020-09-28 07:57:27 UTC,18299804556,18299794556,false,10000,0
0e66690be962470f97230d36e331f25424bdcbb0576c7a8c286c773ae542e7ce,987702,2020-09-28 07:56:47 UTC,92137898,92129353,false,8545,0
2f1ec6c732dbebbfedc6ec067f01e59968b4b5c0e7773202f9f19ca380335bdf,987700,2020-09-28 07:54:43 UTC,8106066,8103826,false,2240,0
a3a3d23d5febc6a95c4e920392161dd0e428d816c4ab8f3a1cf25117a9db8084,987700,2020-09-28 07:54:43 UTC,92257789,92249244,false,8545,0
9af3f7b70eb90fe5ec0eff6996826d841b144120d0f86325b4451cfaeedc6e4d,987700,2020-09-28 07:54:43 UTC,6474736,6457834,false,16902,987688
a12dc47a54ab2a4c54132884d856871dbc803ec8d07769250fc2e4cb40db5c7f,987699,2020-09-28 07:53:47 UTC,380850,379704,false,1146,0
57c462af767943c00f9bb3f225d325505ec6e14fce071c89d6b0ec83c2a9175a,987698,2020-09-28 07:52:35 UTC,18299814556,18299804556,false,10000,0
6df6c4a797b8c955f91272f140da3d2836320ae397fb8922dff6a89dce2d8ff6,987698,2020-09-28 07:52:35 UTC,17436004,17433044,false,2960,0
7ea6e68c966d80b53c876586e6abd375041cff73b19d0756e9f9c113507bc107,987696,2020-09-28 07:50:57 UTC,1109891701,1109823349,false,68352,0
742da4e3517611d9b420bfd970b3288e475aaa53d45e997be4107bba082d51bf,987696,2020-09-28 07:50:57 UTC,84089586,84067757,false,21829,987685
98693eae5ec690fd30f969a9f60b73e73b30bf347329ffba289ec57561b90184,987696,2020-09-28 07:50:57 UTC,94484,88928,false,5556,0
a87e2b0b9c57f8a7ca0c8c2c79fd2e376fdf6883c1b1f9281103b17d06156067,987696,2020-09-28 07:50:57 UTC,75909928,75859032,false,50896,987685
95e64120de9f59964e2bc454b7f1959a70725dda503915309f091f5187accab2,987696,2020-09-28 07:50:57 UTC,18946529875,18946519875,false,10000,0
973a39f3054ad35478fa1ac5268d4021f93f55e771b2ba059e0fa196d9094c59,987695,2020-09-28 07:49:38 UTC,472192199,472037510,false,154689,987681
31e7b92f8c3a0c809c05c116d5a0b35fd6335df604f58c3dd2be77b8e037ff0f,987695,2020-09-28 07:49:38 UTC,9586075416,9586071676,false,3740,0
8df23084d303abbb8ba2e3d3d7e7312a09596f7b8e09437c4f1508a4a5283941,987692,2020-09-28 07:49:18 UTC,71448904,71438904,false,10000,0
1361db2cbf36830c2cb7d62b8296cbc76e98d4c1603cdff81d9f38b7215890a3,987691,2020-09-28 07:47:43 UTC,3915090350,3915088090,false,2260,0
ab5d1eb0cbf741a9162bf6d0310aaa8d147af92c336482e2e369bb266051c937,987691,2020-09-28 07:47:43 UTC,298821,288821,false,10000,0
5864bf91efdc326216abfa6c0a195572c049559448926ba83efbb00bfc7d5ea2,987690,2020-09-28 07:47:12 UTC,1503903340,1503803340,false,100000,0
72aabf4b44c60c677e5302da777ef37a3aaaca7a562c4e8f6f0b2af1587683b8,987690,2020-09-28 07:47:12 UTC,759928079,759925819,false,2260,0
630d398eb8588f833bc82842b22d97981f7ac43e370b8ad966a6dab0aeb0af13,987690,2020-09-28 07:47:12 UTC,4999990000,4999987740,false,2260,0
f6a77d0858e4d53736e3e22aa80aec67c302884b0ca708a1849f0fa18037b863,987690,2020-09-28 07:47:12 UTC,111363133,111357645,false,5488,0
37d274200cdeda0e7aa108edfc6f26c18c5c9d53cd254f91d35f1a8ea4463ecb,987690,2020-09-28 07:47:12 UTC,4013070453,4013066713,false,3740,0
1ac2f480722f5d4cc0347bea0c72fb5c36dc630a75aafc852faf6156785cf5fe,987690,2020-09-28 07:47:12 UTC,251285415,251281842,false,3573,0
476043b82d76dbb914f84d3df96b46da81c4fb65fd7bbd0b409ccb75c548d7d4,987689,2020-09-28 07:42:15 UTC,235032553,235030293,false,2260,0
57650286f21413edb5586b0407e481d885ebab6ae696e607bd4828e6ca839830,987688,2020-09-28 07:41:44 UTC,2583322996,2583280696,false,42300,0
a2ade9a12f91a718ed43709dabab659384670268193050ea519b20667003691d,987688,2020-09-28 07:41:44 UTC,9100000000,9099999929,false,71,0
b30217e1c19f51f16ebebd23c67e670cd43d965aca2b5e71d6747d7a706b643b,987688,2020-09-28 07:41:44 UTC,23950181,23943047,false,7134,987676
6ed53d0fab5b1e907cc68c8efab5bc22a956c12316dd1c340c70b581c723d2d3,987687,2020-09-28 07:40:39 UTC,76627184,76579483,false,47701,987676
10b5a8e971aca9ff6f88925a4c9acb314d81d280f541963e74be09507b135624,987687,2020-09-28 07:40:39 UTC,250,,false,250,0
0bd52a05f42440c9566cd10e47239afa339d252a560d41954cf8514180a63a81,987687,2020-09-28 07:40:39 UTC,18946539875,18946529875,false,10000,0
0d5626a1c2485671babac71fcf76622702037cca6a4105d4bfaf97405f8f3623,987687,2020-09-28 07:40:39 UTC,1619578439853,1619578437760,false,2093,987676
377825373f67d5fc4233beeafd18039128b94bc5886a58b9917d1b252a9fc959,987687,2020-09-28 07:40:39 UTC,219418035,219415075,false,2960,0
1e8340a11c6a3d9360cf1f7c9d2da6d7e0aa053629935aa7f3d6bef6ad6b0425,987687,2020-09-28 07:40:39 UTC,84521688,84502456,false,19232,987676
902fac1a5b8f136dc7a9e89976d5de6562b8f75d73d8b630e4f861f67a40b27b,987685,2020-09-28 07:38:07 UTC,19478728310,19478718310,false,10000,0
9f02e6ea451a94a008060985bbb942fcba18eed9a05d440f7669ed4d8552ee4f,987685,2020-09-28 07:38:07 UTC,92286259,92277715,false,8544,0
37b66c6ca2229abc8f6bc75aa677641298cf8f225d52e694fe1c48b463935f60,987685,2020-09-28 07:38:07 UTC,966927110,966925026,false,2084,987674
c977573f25fdeb4942d4f8f1e4ecb87292dca7348ed40efaa864b8cacb4a4e7b,987684,2020-09-28 07:37:04 UTC,92319778,92311234,false,8544,0
02a521ae37756b04ed629879d97adcca03f94a90aaeb77d44767c84e6419a5e0,987684,2020-09-28 07:37:04 UTC,2000167749,2000157749,false,10000,0
dd6af141ac62ff51ccb011587bcb66bb7187ab885a1c295a6072bbd042dc1088,987684,2020-09-28 07:37:04 UTC,500009523,499999523,false,10000,0
3440436e96de16c04f6b453a1432ff0c669c41214f5d4e1da961b195b4065e1d,987684,2020-09-28 07:37:04 UTC,18978738787,18978728787,false,10000,0
2f62aafb1e3e3c1502f8d115eaacb9ea00ab597d55dd1b7b0d8789d5e21e7652,987684,2020-09-28 07:37:04 UTC,92370833,92362289,false,8544,0
efc92ae1ac4b36f3fab202915f2f71f1d042c3d79b8465495cbbd7789b02ad33,987684,2020-09-28 07:37:04 UTC,566799255,566703255,false,96000,0
8881fd9b50c1b6f3674d3d6006bb6d3b33070287567108066f728edd825d0e3b,987683,2020-09-28 07:33:49 UTC,473616801,473548449,false,68352,0
3cf125a3edf21b92122fbd77cd30f638bb6646584602c23a5f7de39f69ae66e3,987683,2020-09-28 07:33:49 UTC,9062542686,9062541451,false,1235,0
d49a6e241288f85a7733a3bf3d7032f27653a5272f2cc58e60633d52b69569fe,987683,2020-09-28 07:33:49 UTC,1500151384,1500141384,false,10000,0
c0b5612b540c01b5a20e814c6e6b0716c2912f177f15a4525eefd31a871f8719,987683,2020-09-28 07:33:49 UTC,19091054201,19091044201,false,10000,0
bb7823bb464e6fc195636cf0adfa4cf07e6d782ecc9d5daff7e61920862976a4,987683,2020-09-28 07:33:49 UTC,500019523,500009523,false,10000,0
4adb95d41107d71978a58466523736bdfaabe14e622fb6963f49469d706cd018,987682,2020-09-28 07:31:21 UTC,17844053,17839868,false,4185,0
60f669434f9957f70080d95a2ac1f7cf8842e8ecd46b218be13c68a15515bb6f,987680,2020-09-28 07:30:36 UTC,627545061,627542801,false,2260,0
b61fb9e7d1db382dedebec3eeb6a56581eb952e033a704939df905c8f2cfbe86,987680,2020-09-28 07:30:36 UTC,84986115,84965738,false,20377,987643
21111d6688c1228d6718235c07c9c61968f4fa96e78f136a18559b31f14347cb,987679,2020-09-28 07:30:09 UTC,77591244,77538408,false,52836,987667
6175373001e30467ce26e0c65526980fcd76dbe70f5dc8d9cc07111c883e84f1,987678,2020-09-28 07:29:50 UTC,13530,10130,false,3400,0
61a450e77e300e6483eb250a13bc822b766d86634fdc18de42ed9eebe9ce1e7a,987678,2020-09-28 07:29:50 UTC,500197644,500187644,false,10000,0
6049590b2a9d77aa065420d8acc1b2f483c500ac6d2d0ba938a13e43928e8c54,987677,2020-09-28 07:28:36 UTC,56927047367,56927031787,false,15580,0
d8f6905dc330c3db5f1d21b394b4b5869c8c01a9b45576fe3d0ee189ef435db9,987677,2020-09-28 07:28:36 UTC,61013158682,61013058682,false,100000,987665
1295f55c8094dd4883dc628006bdd8d0fbb02a31504f18fa59b54bd59e280827,987674,2020-09-28 07:27:20 UTC,500207644,500197644,false,10000,0
b9fc015b5dac099efd27dff0986976980a99aedba6e268e139d81df0339cfbc3,987674,2020-09-28 07:27:20 UTC,251459488,251456528,false,2960,0
24713d47bd97e20bd7587d80d5074cb88e8cce4ef5721bef704d66701a6d3efd,987674,2020-09-28 07:27:20 UTC,499993740,499983740,false,10000,0
4b94ba80fcbff12a455ad2ebcda933f0b5b9bdc6919409b15667364ac601f1a4,987674,2020-09-28 07:27:20 UTC,456740000,456730000,false,10000,0
78a6447fa0871fb779ef4df8dede227935b504c1c5bf1f5cb68c528d55ad1be7,987672,2020-09-28 07:25:45 UTC,92424589,92416045,false,8544,0
5512077f48206f1b8376fb1ee29c30665ed9ffdfa59b6a4825948ce14b69da1f,987672,2020-09-28 07:25:45 UTC,500002375,499992375,false,10000,0
9a877e4233edf657ecef0239a69cd056a32641d1658a9c4d160e24592e7acd02,987672,2020-09-28 07:25:45 UTC,92459061,92450517,false,8544,0
e8d76d17b9f9b053f4dcb22866e39c49218ccb25869b3482f9151ab467a20f77,987672,2020-09-28 07:25:45 UTC,500003740,499993740,false,10000,0
8fae68375bfd878f01edff1f0d07172c138b12018442f433a7520ff652cb7bbe,987671,2020-09-28 07:22:55 UTC,499990000,499980000,false,10000,0
d808a34cbc9d00bd300a597eeda4f1ef75c0f1fcfcc728e187c56b5ec25fa5e4,987671,2020-09-28 07:22:55 UTC,219616010,219613050,false,2960,0
e13111756e6f7a75e37cc38c43fb18e448e3e1f1ad35c1fe574fa630f5aa9aa3,987671,2020-09-28 07:22:55 UTC,1639577941946,1639577939853,false,2093,987660
526f18e2452dee671bff83e1035e61ed0157efcc0b738e15dd24dccaac5c4b18,987671,2020-09-28 07:22:55 UTC,21349537000,21349531000,false,6000,0
bfc17692ae1e29ee59a18f919e67c8172ecc95464143d024e6b34fdb8b9ebb46,987671,2020-09-28 07:22:55 UTC,85543913,85523809,false,20104,987660
70c4abaf1d18e2bfd670fc7ff9c1570364dacb5c0685046677b4593249eb95a8,987671,2020-09-28 07:22:55 UTC,92509845,92501301,false,8544,0
8111b582f2623a023cbf66f11163b057b058332482029c14eb4a6e05330b56eb,987671,2020-09-28 07:22:55 UTC,517361468,517355468,false,6000,0
469e765cec5f577ed04561570de86b34762b5a529d71a95242d39140eff79d4b,987671,2020-09-28 07:22:55 UTC,78683203,78632033,false,51170,987660
9494c0338a4a4519cfe99efbb7efefdb6c3f5a73883ee6dad7404e33660efd36,987669,2020-09-28 07:18:45 UTC,807662246,807659986,false,2260,0
f8ee1cd3db9e916b4846ec83001ae85a7b66da83df6c30a5d735a98e79ffa55f,987669,2020-09-28 07:18:45 UTC,27623333,27619984,false,3349,987658
a5a28d5aefba1a8d0429d42f003b2f772b8b66656d80ab3ddb4ba951da41dbbe,987669,2020-09-28 07:18:45 UTC,4454,2534,false,1920,0
8c2915c44868fbd609a5c04bd8a0f71fe78da27e53915c0c5346b10986b3b7e3,987669,2020-09-28 07:18:45 UTC,500000000,499990000,false,10000,0
388e412ef6642b247aa9b1bf48115c4b5108dac0a27172fa97f3f661b54d6745,987669,2020-09-28 07:18:45 UTC,64445883844,64445883744,false,100,987657
5cda349fe803d43247be42be154ee49d75bf44fe8e0cd61ebddeb8f64af1ad2b,987669,2020-09-28 07:18:45 UTC,92552261,92543717,false,8544,0
3a4ae6eb70277cb73ae7cf97487606bac57029e5700d0d0362ff5510dc0884cf,987668,2020-09-28 07:16:40 UTC,46238220,46235169,false,3051,0
a44aa94dfc0927e3cdb0ac75998bed76256300487ff3fbcb46f08878021c0b57,987668,2020-09-28 07:16:40 UTC,10000,,false,10000,0
fb7dc622b14880ad0f5e56cd6b1f2ba629ff9fedd82a3c4003bf5ea7fc9e8af6,987668,2020-09-28 07:16:40 UTC,1457270000,1457260000,false,10000,0
a60b8738fb40ff02f0523ab8ea4a176622c5db534d2f1efb36d8eedc7d5f4e7f,987668,2020-09-28 07:16:40 UTC,778098454050,778098451700,false,2350,0
58cb1ce0cb1dabeefd7a3a17ebb19bdc34fea48f78f6d263717a5fec3089b038,987668,2020-09-28 07:16:40 UTC,2620543000,2620537000,false,6000,0
43905bc5c2501f4a92633010df583abee851da80b43fea366944548f29d96d99,987667,2020-09-28 07:14:35 UTC,901940994,901602712,false,338282,0
2422c735c5b6b6db66169308f84cdc0037177ec276a09159e333f8252311a244,987667,2020-09-28 07:14:35 UTC,861620053,861551701,false,68352,0
3ad375aa37176d884c45712f06c3997c7089e356de748f9d419a69369a10b342,987667,2020-09-28 07:14:35 UTC,57805879,57800010,false,5869,987656
7571e3eef8dc720ebea72e097cedc0593b4e101ccd2d7aebfe96bfb3f8eeaf2b,987666,2020-09-28 07:13:14 UTC,18048716,18045449,false,3267,0
09c956913c2e8002b74fce91258be76a55b6eeba2378ddaf2d2ca9eb73f6ad11,987664,2020-09-28 07:12:19 UTC,183469906,183443577,false,26329,0
f0f4ad6c9539ef760b5cf4dc64eeacae445344e8a6d4d7e1f34162653d7deee0,987664,2020-09-28 07:12:19 UTC,338196,271156,false,67040,0
61138f0f40b21424e3b19a2c15c73298e4f27edd2b7cbfab6d7a5690f808c0cf,987663,2020-09-28 07:10:39 UTC,92769427,92760883,false,8544,0
9551a0c99ee53483aa679b365822bc1b18e9aa7956207fa67d1a6d5cdf53fc8b,987663,2020-09-28 07:10:39 UTC,79874571,79822282,false,52289,987652
977c1c85c953ce6e4c43827ca369068132512bc6715daa33e6d99c8f10f556dc,987663,2020-09-28 07:10:39 UTC,85944297,85924211,false,20086,987652
d65d79e65fd57c401dd7a7e2454fc4d01d774f624a67eba321ace1ece0464527,987660,2020-09-28 07:08:43 UTC,92798205,92789661,false,8544,0
33035c3f62b48445e6fb6971ba6d91ef54cd6417087d142a3f929de624d4d591,987660,2020-09-28 07:08:43 UTC,19091064201,19091054201,false,10000,0
4cecbd5115051856b2d69c8730d17ffbe61b67953350f08f202e93b968bcb036,987659,2020-09-28 07:07:30 UTC,251674628,251671361,false,3267,0
ba2797a6b8a99971a3d0ae76db4fe0ebab9f611fb6bc37c4d1fbb87b97309693,987657,2020-09-28 07:06:40 UTC,500839742,500829742,false,10000,0
a21cd15c3221e8f962e4051536085d3c1b440bfeb4c2d7bedb94837a6d79d333,987657,2020-09-28 07:06:40 UTC,500485000,500475000,false,10000,0
84af4346c184022ff25abfa20682341496163941189ed03300b324d81a26efb7,987657,2020-09-28 07:06:40 UTC,500048352,500038352,false,10000,0
6b6e91464cb81d5c56e81cc9edaa2724cf1f4cbc9ad48e8e0184c5e12476e5a8,987657,2020-09-28 07:06:40 UTC,237156480312,237156470312,false,10000,0
ac824957fb7f03a67e912caa49a546ce8f8c9dfbe6bb30d8e2b47f9a341b3d55,987657,2020-09-28 07:06:40 UTC,2500382677,2500372677,false,10000,0
6204a03906487a2d1f321c3d68a89a0894188271809d6a5ccc3296a60dbdaa99,987657,2020-09-28 07:06:40 UTC,1000002450,999992450,false,10000,0
ff8c6ce4f9d9eb7f2199b2cbb3e81e9336954f4732e5cce201c7ef628e544e5b,987657,2020-09-28 07:06:40 UTC,3001706500,3001696500,false,10000,0
df7fe9743c4be6368caee75d8ca970df13224d036797cc000c49816855ff6d7c,987656,2020-09-28 07:03:55 UTC,1643322444039,1643322441946,false,2093,987645
c362918000cbdf7276fa49540b01eb00b5b4fa635f77074ba257c7c8f66832c6,987656,2020-09-28 07:03:55 UTC,17890414193,17890411707,false,2486,0
541dffd320d1d92416a1b44e9b35bfbab070756967b0a751e8de0445d76991bf,987656,2020-09-28 07:03:55 UTC,86321824,86306095,false,15729,987645
aa77d79bc1d4a0608b2a833ca5b60607ec6206b5275a8a9bbd19ca32d889b288,987656,2020-09-28 07:03:55 UTC,80915980,80855856,false,60124,987645
e43e3a48681fc8ecbaea64f9ebdd1ab6d3ac27191feb1bea6ba5f3a082f6609c,987656,2020-09-28 07:03:55 UTC,611822887,611820627,false,2260,0
109fe10c5dec0a1ef74e9a4d289c5946e68a5b5d90343bc2bd4f2f05cf3890f9,987656,2020-09-28 07:03:55 UTC,1000079224,1000077140,false,2084,987645
2e73bc46d117377502e0b09d547bae669ea67d75976041cd3a2439ff4d835d17,987656,2020-09-28 07:03:55 UTC,1963984651,1963980824,false,3827,987645
cf23aa71f1607316d8095b8d60266c19d5a549a6133074a092ccfeb1e17f273f,987656,2020-09-28 07:03:55 UTC,1504590243,1504490243,false,100000,0
8d8c644be1e9d1125c7eb650d024dce73f84236ce96d903cfcf262b44a22993a,987656,2020-09-28 07:03:55 UTC,855425638,855421898,false,3740,0
e5565b1e013496f82449f3b5fa1c43ae830e01e67bbb73706f74371aba0b2808,987656,2020-09-28 07:03:55 UTC,64639894212,64639894112,false,100,987645
87a4f17947a92d646ff928de3b144fcc2da934c8adb8698c43bde2abdac806fd,987656,2020-09-28 07:03:55 UTC,80276712,80274619,false,2093,987645
084af851bf3891a47a0dbfa01ba675e07b98b0955a4a89b85aadc8bf352d95b0,987656,2020-09-28 07:03:55 UTC,213027839,213025174,false,2665,987645
e1d7a7614d809c1a2c23cac7b87024f8113ae74bb718435dcaac6c09a3e35437,987656,2020-09-28 07:03:55 UTC,219909437,219906477,false,2960,0
020bb5e7874f910570eb17f3e9eb06088ce2ec43662564c207b544507ab6ad33,987655,2020-09-28 06:57:16 UTC,8270576137,8270572087,false,4050,0
8ae22778468de94578e5f489ade6cd6d430cd758243d339f144adf55813b5e27,987655,2020-09-28 06:57:16 UTC,332438993,332370641,false,68352,0
09dbd7d84eb6687dbbdf896ccc319d7163f16f9d8c828c0c61cf8e32d41fa70c,987655,2020-09-28 06:57:16 UTC,810637,800000,false,10637,987644
258333d1b0b409356d3a30c536b831461f82857ce1ef2a8c04b1e783795b38f3,987654,2020-09-28 06:55:41 UTC,112769999629,112769997279,false,2350,0
acddd838059aa9426549ba01a69d8e852fc4a3fd83b0cbe0001ef365ef14228f,987654,2020-09-28 06:55:41 UTC,500000100,499990100,false,10000,0
794ae451e49fc320d5d323eec0fdcab0b0372369fd2056744b5246ebb5c5a914,987653,2020-09-28 06:53:17 UTC,4059905537,4059899537,false,6000,0
264b9350b086e1b3c2f8623699e45d2ee4440fcea6d7b5e441fe9fcb4be8d193,987653,2020-09-28 06:53:17 UTC,18200935,18197975,false,2960,0
054bc2622fff4360f3eb767eb66a8d2ba07920ffbb480adc1f8a48a33b7b00db,987651,2020-09-28 06:50:38 UTC,399100000,399098080,false,1920,0
ef8df5488b9cedc2a3b0c5c684b387c6cd38c0c68494db61cb698b1995b418a4,987651,2020-09-28 06:50:38 UTC,81812449,81761066,false,51383,987640
db567617de37259c010c9699c0e43bb504e23a569a13d5744192b45d87987e70,987651,2020-09-28 06:50:38 UTC,86913295,86896114,false,17181,987640
216f1b12d4c785f65e3931037e8ea56acbffe205c4ee4a20630efdbcaa835169,987651,2020-09-28 06:50:38 UTC,52813105,52779685,false,33420,0
33cced15a012cff1af0a62d8ebd6604fba714181e956e0c42b5bf65ef254d13b,987650,2020-09-28 06:49:08 UTC,93087409,93078865,false,8544,0
69f71880c2008045d28d072dda3c88b6876088151c7d6354009d71702fa89345,987649,2020-09-28 06:48:05 UTC,500058352,500048352,false,10000,0
7998112fa240c20d47431cf463db0621b368d14b69b9d432212d86fce9b3b6eb,987649,2020-09-28 06:48:05 UTC,61084158682,61084058682,false,100000,987638
032395a0a858453057f2fdd3d4c1a0df0d078778158dd7b5ff47068d78bd8b77,987649,2020-09-28 06:48:05 UTC,78054000,78051740,false,2260,0
aca485f7e80a222d6602a5067dc9ffc86576409bd4817296ac5c7efbf035005d,987649,2020-09-28 06:48:05 UTC,119281304,119280304,false,1000,0
3f7c6b92ecdf2d2fc21b6f1c9df5d7367ee3a3fb6669c460679c033f356712c5,987648,2020-09-28 06:47:00 UTC,1104613,1100000,false,4613,987631
3c95b503cc526df0d48481ab412e8554344c827417340496e5a1153f3543237c,987648,2020-09-28 06:47:00 UTC,251915089,251912129,false,2960,0
2c89d42890362d9ffb09b111d6577160e3f5905b934343ecdb6b6c8aa2fa19a3,987648,2020-09-28 06:47:00 UTC,1469799474,1469787389,false,12085,0
ca87069cd651d46c51e8396198299cb9acb075cc661e9fcc4c936dabe7904122,987648,2020-09-28 06:47:00 UTC,160015,157565,false,2450,0
0bab46eeebe6e68c7a17df7453911e3c27c420abd2b9fd018f08269015c729a1,987648,2020-09-28 06:47:00 UTC,38293400000,38293390000,false,10000,0
3d2d71b3c18415f439ccd60122b297ab2776ea289e0140b53caba9a84f716b11,987647,2020-09-28 06:46:02 UTC,500068352,500058352,false,10000,0
ce7862eca831bf7498fbc7aaf268cd3755baa0b23fdd306f8be967f33f1c20b1,987647,2020-09-28 06:46:02 UTC,35898,25898,false,10000,0
245d715df570c7d27a7e00687ff68d9bf4020cb658a7d53d8e7597069b6987d7,987647,2020-09-28 06:46:02 UTC,100000000,99997550,false,2450,0
2a4c1e5a6774f84a878950d3581326732664ec6484cfcb6c841b99bb7334d8fd,987647,2020-09-28 06:46:02 UTC,20037500120,20037482120,false,18000,0
816b74b5acfcfe0c2df5f1bd3159bfe15d696031b26b969da3ef7c58f158fe57,987645,2020-09-28 06:44:14 UTC,212187175,212184725,false,2450,0
d4a430e1be61e2af2131e81049e635fc80acac464f6e85cd535d3e41e6a9fa3d,987643,2020-09-28 06:43:24 UTC,93319953,93311409,false,8544,0
9a289f2a960a79d9ae98d2f98fbb49ff78a23c3a8299580b806580c2455ffa7f,987643,2020-09-28 06:43:24 UTC,93145902,93137358,false,8544,0
b6727cdcee0ae95e12994cb041cadbd1bb84c6e98734c12896ec910463d78673,987642,2020-09-28 06:42:38 UTC,1704690243,1704590243,false,100000,0
e8f8616c79297edd1a63a73d1454d4201d9401c9fa0da31e742c66fd5c5e6e2e,987642,2020-09-28 06:42:38 UTC,4100000,4094500,false,5500,0
7fe1b8dc27ee6ce879021db8ca1a4d40ea6b9ea916268e3cc381ccebcee14852,987642,2020-09-28 06:42:38 UTC,674889079,674883079,false,6000,0
f37372c5d671a38e8e0626fc3787a7daf124ec1ecaf0bf47723d7abf8ce0d9be,987641,2020-09-28 06:40:37 UTC,720568405,720500053,false,68352,0
a4471d506674fd2a85d63d37f65afcee4b25474b270105c9893fd97cb4da9a50,987641,2020-09-28 06:40:37 UTC,87428081,87409720,false,18361,987630
c771871497212306aa74264b486b9de90a502b06ceb13895cb2c77c593a07c37,987641,2020-09-28 06:40:37 UTC,64681822245,64681822145,false,100,987629
39d98a7dcd03050a63feb4502d52c6795cc67f0350897589e60c847c73a72096,987641,2020-09-28 06:40:37 UTC,5104613,5100008,false,4605,987630
a60ec2ce828781397db861a27434ea7abe0072bfc6a9fc6ca163bc0f8aa94827,987641,2020-09-28 06:40:37 UTC,48072210,48065210,false,7000,0
6957dd18d4b03f42e1e4afbad9dbc98512d13cd4ec39022d13f049a43e0d3085,987641,2020-09-28 06:40:37 UTC,82921209,82866554,false,54655,987630
6720e236072f012e1af40bb846db2a8e2360ad4d1f9d67e3ba08b77af7024c6c,987641,2020-09-28 06:40:37 UTC,220089383,220086423,false,2960,0
e8ac722e5ae9068f45c5c72f5ee489d54159167ab8692d8180d70db071ac7482,987640,2020-09-28 06:38:03 UTC,1000041100,1000031100,false,10000,0
3e71bc69bdfe924d3f7c39540769cd48e99690791ed02dfc0d6457a9d7896d52,987640,2020-09-28 06:38:03 UTC,48075120,48072210,false,2910,0
6215e59a76ec5ba0d9ed779441a210d888d9f13bab7137515223cad5db149372,987640,2020-09-28 06:38:03 UTC,59980211,59978118,false,2093,987629
f2814c442b903368ce36c92a6c6dce74c2b625914b9a325bc7e3805ec1ae94d9,987640,2020-09-28 06:38:03 UTC,11620559,11619413,false,1146,0
4ef9c866d32b72bd6e0000c095faaf30644cb387e6716235f8f33b19e8a6ca94,987639,2020-09-28 06:35:19 UTC,18849898697,18849888697,false,10000,0
b7dcd129436a6b5faaadbc618f5db65685d74eaee7ed1c8e2add412013620eb3,987639,2020-09-28 06:35:19 UTC,1457280000,1457270000,false,10000,0
808df1ba608b3a60be5c4fcbd7e5ef71b14bb10986a43a5b5271f7eda52ee060,987639,2020-09-28 06:35:19 UTC,56612,52820,false,3792,0
a9589b682dccf8b55a0b2469ad6e24c310d7754c8c94ed7da9fcd12e27c7718b,987638,2020-09-28 06:34:39 UTC,93366954,93358410,false,8544,0
6f5c0cabcb6e52a49f334fdc3759031541182d5c83f7125732c0c42c24dc2f2c,987638,2020-09-28 06:34:39 UTC,84162395,84109551,false,52844,987626
282d3e63a8a450d87b8fd7685f539d94f08e9457ea4aa96eded0a85c913c1abd,987638,2020-09-28 06:34:39 UTC,40164478,40154478,false,10000,0
7886e61f6df8bb121a62995adf062d9e592f008fb2eacddbf164fa4934b3e67b,987638,2020-09-28 06:34:39 UTC,12600000000,12599997916,false,2084,987627
ace14749bff6bc776c86822d34374f60ee9f5913c396f313e57f358bcf613f57,987638,2020-09-28 06:34:39 UTC,28953733,28944754,false,8979,987627
43b8c4b8353b1a5cc5fa48954a9282e2d047fb3c5e9ee0f55b7de404f360d7dc,987638,2020-09-28 06:34:39 UTC,87931934,87913309,false,18625,987626
f3180c29e345afe12cbcf2e4c773f702fc3fe6f41534b9757429f40968af3554,987638,2020-09-28 06:34:39 UTC,499990000,499980000,false,10000,0
43f328ed09b8cb8c2bff5ffb76cd99b04be36c3314935042ab0676d480625a43,987638,2020-09-28 06:34:39 UTC,125507709,125505449,false,2260,0
817a661f581545c0769b7d4535cf53bff095efed9c3604e56f8dd2a48978d7a4,987638,2020-09-28 06:34:39 UTC,18356606,18353646,false,2960,0
f029b8eef129f224f31075627b09afd7f42d7c31f0f578a3bf911f69d3f9e1d8,987638,2020-09-28 06:34:39 UTC,93555538,93546994,false,8544,0
076fb495351ed9acb28f58b377d1c98dc0f766ccacd06185e7a00cdb3310c38a,987638,2020-09-28 06:34:39 UTC,93703118,93694574,false,8544,0
62dc28648b71d8c8aee692dec4ae50ea8c92eb697a2ba9ae6479551069fcae00,987638,2020-09-28 06:34:39 UTC,43646630,43636630,false,10000,0
2e97ed99fddd6c51250994074503344c53b4c7c371d57a02e32c29ead7f84335,987635,2020-09-28 06:28:47 UTC,78513061,78510968,false,2093,987623
075a980cfce19a70854f427799fe01e9f6cfbcf6f5374e21ef4977abe25ad373,987634,2020-09-28 06:28:21 UTC,125676336,125666336,false,10000,0
20d97d2c58397ec84c0726c2e5de5deceadf3321bf920e7420c552cfcaca11a3,987634,2020-09-28 06:28:21 UTC,1266470270,1266466530,false,3740,0
0216a243e5fc80dceb6a3777480b329bd7db71071cae1b75c049e9a86839c066,987634,2020-09-28 06:28:21 UTC,10000,,false,10000,0
f72f790ee2a932adfa000c3b554e4ee78833ff37aa2c49fbc215b0cb44bbbf0e,987634,2020-09-28 06:28:21 UTC,390850,380850,false,10000,0
3a16c50c686c1e09dff5cfc2cc820c3563d534818d100ac998d33e0d8417e6a3,987633,2020-09-28 06:26:48 UTC,1644567077716,1644567075632,false,2084,987622
e193a3d277ece79c2e5a2259e77d268003b0bc51186e1c8bf627d28071801335,987633,2020-09-28 06:26:48 UTC,901509163,901233041,false,276122,0
7f1675ce1a8d4e4bc83fcb6d8ec5857fe961c0ede51821ffa520aac886722db2,987633,2020-09-28 06:26:48 UTC,3781977120677,3781977099766,false,20911,0
24dc54b58388ddff4b911dbe16e3d2614f67bc663673d9a34733c2966b934598,987632,2020-09-28 06:24:33 UTC,93754972,93746428,false,8544,0
633c72edf7b74a767ea6e7ca91ebfe55a0eaff75b756397ae1e1752954b7cdca,987632,2020-09-28 06:24:33 UTC,745548300,745546718,false,1582,0
516e5307ccc3298f8fcf028f775b9e67a48f2910f17d49406bff9379c4bd100d,987632,2020-09-28 06:24:33 UTC,306264776,306254776,false,10000,0
46f531553dcddf34a5ed9bcd5bcedd7afc2257811bdd376bfc5a83b0c747f2e2,987632,2020-09-28 06:24:33 UTC,157173318,157171058,false,2260,0
350856b7017b692fed12794684181106ab2d1e1d67e3b7ffa41a58c68b665b28,987631,2020-09-28 06:23:15 UTC,252169205,252165938,false,3267,0
95adac97e5da49f3e2a7b9e4c3b314f988df35778846df0f0f21bc81b343f20b,987630,2020-09-28 06:21:39 UTC,39572689,39562865,false,9824,0
5bfded340e94671f0b60f153ca8eab273fee8d8c8b1e8092ec656ada768ab8e8,987630,2020-09-28 06:21:39 UTC,144000000,143931648,false,68352,0
fb3a955501719e5325c2555a4205f134ea2320a889c34e0a01cc7a0e674accde,987629,2020-09-28 06:21:10 UTC,457178538,457173318,false,5220,0
268f47859450c677f31dada187e8f9250441cb40a48ce52a4fbcfa6ee7643cb6,987628,2020-09-28 06:20:20 UTC,53799991756,53799989695,false,2061,0
3f8c6273f48e108df07bdd54d2f56e4aff21035b451f64a7e5dbaa7efaaba93b,987628,2020-09-28 06:20:20 UTC,93784718,93776174,false,8544,0
bf03ad2b8c5b457be48a1aa43532f40272679a2475deb93ea51de5b59e853a0b,987628,2020-09-28 06:20:20 UTC,25115306,25110106,false,5200,0
15f6a6b11814889c130b7075b4f13ae72775ad9c86c2fc72906455fe1c215ab9,987628,2020-09-28 06:20:20 UTC,166980157,166962530,false,17627,0
ec04e83584459d2b04ff56c9e0afe363d13265f944e61aad3bbfc8b070dcd104,987628,2020-09-28 06:20:20 UTC,1644898888159,1644898886066,false,2093,987617
84721717ea40510059fb11af0d510bc58f204de9d6e5c292d6e7f706ebd773dd,987628,2020-09-28 06:20:20 UTC,85233648,85176993,false,56655,987617
09e2f7bddc44a4872b53820da7de42fcbedc736b8699080d1ce1aef49b2ab39a,987628,2020-09-28 06:20:20 UTC,88491227,88471414,false,19813,987617
42634711e158a01812081651a4e3916bb2e04b4098157b888318337d6954d4ea,987627,2020-09-28 06:17:44 UTC,500000000,499990000,false,10000,0
c0f5ed22c7ef5b01d99e180c78cda60ed73964eac3960f52c79d2124c3ec0d5c,987627,2020-09-28 06:17:44 UTC,1031801,1029351,false,2450,0
3e09acc1c31577c2d618cf21d067eb475276f6bec22c08da5812dde23a827c4d,987627,2020-09-28 06:17:44 UTC,79872632885,79872617305,false,15580,0
71a2b3669826653dd11027c5bdb382a91fe812a8d364624f80b2bd09db9619d8,987627,2020-09-28 06:17:44 UTC,10000,,false,10000,0
428b75d65789da3e0f3deb1c1b8fd4df13e16d8f6a26b4c24a9d444bd107e06e,987627,2020-09-28 06:17:44 UTC,731067368,730967368,false,100000,0
e5cc22b400a18e9af9b339d5dc82b2bfe9cf640b9c6827ab579e8e5cdf1b2b30,987627,2020-09-28 06:17:44 UTC,61112919104,61112819104,false,100000,987616
a2daa1459fcfadd2f255595f5f04af8f16be685bd3c67e0f00f15c7ff129834f,987627,2020-09-28 06:17:44 UTC,82052016,82049923,false,2093,987616
483326f92fa637a57dc9ad5d7eeb1f99aa8e382c9d392568dfbcfbace19f7cbc,987627,2020-09-28 06:17:44 UTC,18546364,18543097,false,3267,0
56b85b0bb24bb34c51fc64d2335d96aa04f3b639d9c30fe82aaaef133f698425,987627,2020-09-28 06:17:44 UTC,146458540,146457540,false,1000,0
f415e4731a48afa461d1146039c0c56bac9938740e20978d5f5421f696d3eca2,987627,2020-09-28 06:17:44 UTC,220240440,220237480,false,2960,0
0b9812c6a8f3d83a959985091497ea1f2ec29181ff99b9d853c70e29e851b472,987627,2020-09-28 06:17:44 UTC,2365924,2363474,false,2450,0
c6a8ff8a3b7b5855f9e84311016a5b2ca215d9362691b0576f84829658a3c8a6,987626,2020-09-28 06:13:17 UTC,94036319,94027775,false,8544,0
0fe6af68c556ba5004a9718773d80a9e4b1c579b6bcac439ba3a0e67fff6e210,987626,2020-09-28 06:13:17 UTC,500010000,500000000,false,10000,0
755553071f4d471c4543e5f1844ed54dcf1e2ce36526aac406fb44e4055f2465,987626,2020-09-28 06:13:17 UTC,478578,468578,false,10000,0
49f22e86d0a495285d32b990d1550bd5e283f4c920904ba11dfbaf0c9b8b5078,987626,2020-09-28 06:13:17 UTC,11007312128,11007308771,false,3357,987615
0a69882105a545a248f643f1931a5d7edca7161faee4d18f90211c9bdd220bc4,987623,2020-09-28 06:10:45 UTC,24905269,24897836,false,7433,987611
43daffd2b0524763e5b0438cfc38c38671b07e84d19f44575cec14728242f9f9,987622,2020-09-28 06:10:24 UTC,86551899,86495518,false,56381,987611
3282ec6dd37b5757c80c6af6424f7d0fe123e98f83b81d066475c12439b35a72,987622,2020-09-28 06:10:24 UTC,18710387561,18710377561,false,10000,0
6bb23d2b71177596a367e1c7f2698281a693083dbcb93d6f6f86e77d4fdba0c4,987622,2020-09-28 06:10:24 UTC,67048027,67038027,false,10000,0
190771b29df53f07b2154ee8ee7e8e855a93e1941585f3cce6cbaa93462157ad,987622,2020-09-28 06:10:24 UTC,1645644438543,1645644436459,false,2084,987610
32013e4dc6049f509648752c6fbaa3a8a67d85a2268d932fafee9c3e42c201e2,987622,2020-09-28 06:10:24 UTC,88982738,88964087,false,18651,987577
c1d31d88b8e320608ed722e008227a85c8922d84b803c11a99ed31a3cae6b002,987621,2020-09-28 06:09:34 UTC,463020693,463000000,false,20693,987607
6b44b44cda01900e69842a17d74ce003967945f18c52ebbf26d7e0d82192513c,987620,2020-09-28 06:09:25 UTC,66047006,66042006,false,5000,0
a72314ef39cd9e528b960ee81f8c48ece1807e5ef451f59a19e9b15d56b7a516,987620,2020-09-28 06:09:25 UTC,100000000,99997464,false,2536,0
09aaee08beeeadc41c3dce08f75158e1a82efb4c2f1945d71dfc35548ea53b4a,987620,2020-09-28 06:09:25 UTC,66057006,66047006,false,10000,0
83b56d2a962372ab026b34d26567622c418d30fe8c92dffc234d7c2c3de92c93,987620,2020-09-28 06:09:25 UTC,477712150,477703970,false,8180,0
e42ade9ef39fad487ee20737952433112fa3de54d3407db31d5fc3a1bed128ea,987617,2020-09-28 06:08:18 UTC,308821,298821,false,10000,0
0bf1f6ac22e14bc22195eb5547290c6b719b2ce97dbb0091525174a81a2b736a,987617,2020-09-28 06:08:18 UTC,252354919,252351652,false,3267,0
fed2fea50efdc2e3136406ba668688153c35fef5e1f3c291f2d2c5432f7516fc,987617,2020-09-28 06:08:18 UTC,499993267,499983267,false,10000,0
f4cc7d2e6ee0ef77db49109ea505b5f4786c618e93d70eb192902a5333da632d,987617,2020-09-28 06:08:18 UTC,625529437,625527344,false,2093,987605
14d79b622b448e94d5365197af9f2b7b2583f64d0e2e285e167b108bea605324,987617,2020-09-28 06:08:18 UTC,500043340,500033340,false,10000,0
787e25335f543c66d41e183dd8d7b2d61500354b809fe59d63ab98f6c02fc44e,987617,2020-09-28 06:08:18 UTC,8319888797,8319879977,false,8820,0
26439f5e231263474a746ab08fe6b9834c0f0900cec99da3b02df1cfc67ab89a,987617,2020-09-28 06:08:18 UTC,64784887738,64784887638,false,100,987606
c5884d5c31125a6420ca67e5646a252cae5772be276bc79f2dec3a4614ddceed,987617,2020-09-28 06:08:18 UTC,122383160,122377160,false,6000,0
ad1d467541f7b4a1a63f0879e28bf65fc340a9499d09dee84f89c975bb4519f8,987616,2020-09-28 06:05:45 UTC,117014358,117012265,false,2093,987605
ac18d0a2de55e1e80e90f5a6868381d3ba766114fc66d6d895149c0c7bddd4aa,987613,2020-09-28 06:04:59 UTC,2000005143,1999995143,false,10000,0
76409c143fccc87ffde53072668f13e9d3af91010c3431ba101794fc63bd99cc,987613,2020-09-28 06:04:59 UTC,2500392677,2500382677,false,10000,0
47bc78c01f5d18b197ded5fb3979ca118aef3bcb0b30634ff5f16aba9a8e340e,987613,2020-09-28 06:04:59 UTC,2552319999,2552309999,false,10000,0
ea12fb4bcfda69f75f03e65ccb57ee113362637abaa2be24affbab619517fa7f,987613,2020-09-28 06:04:59 UTC,1457300000,1457290000,false,10000,0
21daf72b0cd615d6984dd36b02c40ec00a74cb0f21ef2c52e4e6e5c8dba28489,987612,2020-09-28 06:04:30 UTC,499990000,499980000,false,10000,0
53d8493d8f11f3c4c06474e57c2d3f6016d6010cdba0eb2aacfa5c283901852d,987612,2020-09-28 06:04:30 UTC,235666733140,235666723140,false,10000,0
49c50b3a20df55c277bcc4a83b3e7db3b9a7a0bbf9961240dcf0a4590931c1d3,987612,2020-09-28 06:04:30 UTC,571488361,571420009,false,68352,0
4b3cc3b8b40e7accbc01db85e42d311eaa3003daeb315b4ba689993e251faecc,987612,2020-09-28 06:04:30 UTC,1645790899176,1645790897083,false,2093,987601
7b6af54225607bb9916ec74be36b2772fc1436154da0ebbfc2733394141b26b5,987612,2020-09-28 06:04:30 UTC,500500000,500490000,false,10000,0
92a4e5e162eab09368edbcaed05a8d2b62795cc80a0d1cc9e510b202b4996056,987612,2020-09-28 06:04:30 UTC,2552329999,2552319999,false,10000,0
330cbd18fed403ac37ad20dc1107be183da05bd1ef689001c0226a92eeafc32b,987612,2020-09-28 06:04:30 UTC,222561809,222558542,false,3267,0
f8552b7c7a94bb0a19d0744aa9d5547fe5a6b38dae0760bfe7273c640f38c823,987612,2020-09-28 06:04:30 UTC,552708438,552698438,false,10000,0
8b6909966243566d19a819c3a3c42e8d1c83a5b8d9d6ed5c06b2f8aff2825e4f,987612,2020-09-28 06:04:30 UTC,1900222431,1900220338,false,2093,987601
b20c6f8704163f36bd0f7d0a0e4c7501ef3fb915a2e839fa81211b5961540405,987611,2020-09-28 06:02:53 UTC,1996260,1994340,false,1920,0
bd0e316c13dbc0e36179bc5f2fd546767e7cbc8188db6f02faf78f24583a5a2d,987611,2020-09-28 06:02:53 UTC,19351467209,19351456069,false,11140,0
b8a24f12de30ee859865ab0b5378a7fcd5497819ee64760f65019591e3f40871,987610,2020-09-28 06:01:44 UTC,130856614,130854521,false,2093,987599
00f4b11e270d6e2add837417b03238dbe499dad027b3f5c0c42731ae7c598f63,987609,2020-09-28 06:01:17 UTC,1460034543,1460030043,false,4500,0
b8b1e9d017986b13181f9dc5f479857969d6f0556ab7027bb183c0189a0743c2,987609,2020-09-28 06:01:17 UTC,18848300,18844421,false,3879,0
eaf895bae9c5ee5c90530dd60b6e3d4e6d699c344b23af9e2ae79b271023e8ea,987609,2020-09-28 06:01:17 UTC,2000108551,2000106168,false,2383,987597
75fbf20e1df433a0cda721b888c125cb8227d8e7c074a0f264eb3ba5ab0c7d58,987608,2020-09-28 06:00:57 UTC,1646590745382,1646590743289,false,2093,987596
e68f0d047e176c3c3a276b0e2b3b9ddad457db8927d77a723fa6fc10b616e03c,987608,2020-09-28 06:00:57 UTC,500003267,499993267,false,10000,0
dd8d76effb7477b13fa1063500be90626131319e829ded4e2ff51e68ffa6715f,987608,2020-09-28 06:00:57 UTC,237653135,237650752,false,2383,987597
16ca4756147dddce5a44260ccf6309b7d599c1588a6f0cab7250afd45f6d7e60,987608,2020-09-28 06:00:57 UTC,89585674,89560384,false,25290,987597
72d03a1f5cc80bd1c7846024d7dad21922b65ff24ec702f2d823916dcbf6b9d3,987608,2020-09-28 06:00:57 UTC,87801480,87745150,false,56330,987597
6b19d76d80a4e3ec73cb86753eac4b85a7b6e2338bba15a451f6daf09249af10,987608,2020-09-28 06:00:57 UTC,4260,3210,false,1050,0
f65f05f59feedd496652a04201e3cd41c2ac24a351076fc7e716f58214449181,987607,2020-09-28 05:59:13 UTC,207191613,207005613,false,186000,0
a290fbd94a23df2a40800329477bf30c55ea9c34bae51b4209e8c91b302ce4ce,987607,2020-09-28 05:59:13 UTC,45040988,45035768,false,5220,0
d3cf548ed9bc28dfc1ec08f8144ff942426bbf62e1d6ce97f3fb8b661a0b5b2e,987607,2020-09-28 05:59:13 UTC,23391364912,23391362992,false,1920,0
d1709876a49a425ce19f2b664de20cb5b25e9cba27fa5f299091dbc84b7ba4e7,987606,2020-09-28 05:57:32 UTC,500013267,500003267,false,10000,0
8015c122852b0b38ba891be2f26e0179101ee4820bebf4b81fa81936ab522f34,987606,2020-09-28 05:57:32 UTC,151891438,151881438,false,10000,0
bb41f3eec12af7f475f2f59c39eb404c771972920aa908413374739cf8c9299a,987603,2020-09-28 05:56:33 UTC,252538941,252535981,false,2960,0
d18d4c8f6cf9ac44ccb162de43b3aa5a1055338cf850e9712e7c3d7646ae01e0,987603,2020-09-28 05:56:33 UTC,10000,,false,10000,0
538acadc4911805ea54a5cf498e9ca1eaa65c1e19562b6126e677e73e2b42eaa,987603,2020-09-28 05:56:33 UTC,172908454,168230494,false,4677960,987602
b37e199719c74e92609cbc1b333442aaa1a05f57f80d9e683c7a5980bfff43c2,987603,2020-09-28 05:56:33 UTC,640010000,640000000,false,10000,0
ba3bb6a0260217fd26fa7c9c46b46cb4316f956f42b22244b48376b90e0a5837,987603,2020-09-28 05:56:33 UTC,1646754590675,1646754588582,false,2093,987592
1ebd21776a42cd5e5073d66a60e7cf154ae9d5fdd92561926a970b238e15c435,987600,2020-09-28 05:53:21 UTC,10000,,false,10000,0
5d889ff08bc3cd65765a8c01685b7b3bbc04fd02d528cb4a9db521be21be55d7,987600,2020-09-28 05:53:21 UTC,23971367172,23971364912,false,2260,0
1cd89d0088d504d1fdaddf609478f888cc0b501dd2c1a6060bc264f4e3f46d11,987599,2020-09-28 05:52:26 UTC,148102707,148100614,false,2093,987588
6e9b6646338b4e2bc4ec6b17db11445c32dce8bef262e79a77841ff5e50ac8e6,987599,2020-09-28 05:52:26 UTC,47921370912,47921367172,false,3740,0
14d79f418eb2c29cf488dadaf4ad0d7bf8869b271d998de1df6f10afc43bbead,987599,2020-09-28 05:52:26 UTC,222739036,222736076,false,2960,0
af97d18b789489c13bcbe1dc4c0c5714dba25ef69147d5111d9d756f7932dca7,987599,2020-09-28 05:52:26 UTC,638533523,638133523,false,400000,0
ee04b5525ef1ffa1129809388fff070bef6d23b5658940c1cc98310715d77eb7,987599,2020-09-28 05:52:26 UTC,100000000,99997550,false,2450,0
089941596520290e6eb6867111b198e91deccb3bc30a53c72a63ce49dcb55a15,987598,2020-09-28 05:50:11 UTC,90079489,90059104,false,20385,987587
15da5d0c30a6c141d4e69153769f196dfee7565d5bf0444bdeef0d930f0fd0b0,987598,2020-09-28 05:50:11 UTC,6077875294,6076599391,false,1275903,0
1b579ac053577d2a56932d81e01bee6356587ab1e06411bb9d4046f6e4d7b6dd,987598,2020-09-28 05:50:11 UTC,113417333,113399551,false,17782,0
0458d94f7180723703b211d91b758aacbb48df86adddfd22828e34d216fb11ac,987598,2020-09-28 05:50:11 UTC,7811731394,7811723220,false,8174,0
9d439e81077dc5a9063b197686f7fa83730c1b7f94980b93637fdac12b9f2461,987598,2020-09-28 05:50:11 UTC,89134680,89074198,false,60482,987587
f22ee62043e8bb3fd2152dd3984ce88453e4d66de2e1b42317a41e91cd1d9990,987598,2020-09-28 05:50:11 UTC,15585017605,15584987605,false,30000,0
0df1dc9ba2803e36b0f5c25c0d0ab9816c8e08d2d125134d185586920115d7a4,987595,2020-09-28 05:48:41 UTC,500000000,499990000,false,10000,0
586bea1dee21a018c4bf2ac7333c6d14bee098df0442dd49fe65352f5b53c62c,987595,2020-09-28 05:48:41 UTC,12106442,12105296,false,1146,0
ac114779bb3f419301c554bdbdc385f95c8f857b9b49f9b7cae20c2051433821,987595,2020-09-28 05:48:41 UTC,106919055,106817975,false,101080,0
6ebe76c94eb0b5ab09abe296d9717bdbfee6470c15af4bf7e53132b4660e093c,987595,2020-09-28 05:48:41 UTC,137624777,137622684,false,2093,987491
329d0e4866ef4ef3810953d8aeb08ed5135ab2f7895537d2fa077563cdf5d9af,987595,2020-09-28 05:48:41 UTC,29185923,29155122,false,30801,987584
1f54f4ad0d3e30e4ac7fe326a7f7e348c5cd58e56c108f2e47ff94f1e779e598,987594,2020-09-28 05:46:25 UTC,287263919,287195567,false,68352,0
57db401a302c37c2817de6bab4bf518f22713b6c968549e44faf0152cc0c53ff,987594,2020-09-28 05:46:25 UTC,5000000,4951200,false,48800,0
b33acd8892c9a7f1268998d07b0358e790c5aef0379fd17e3ab0186b530df5f2,987594,2020-09-28 05:46:25 UTC,5050964,5049382,false,1582,0
a4195f7d91dfa35c2ba65b494d0fc131da78db7d81b1d97852fcb91e596a99be,987594,2020-09-28 05:46:25 UTC,19075597,19072637,false,2960,0
f2fb92e2f79d82ea75a5f14954b4b83e7923861348b24a7c6e3e4209b70f7bec,987594,2020-09-28 05:46:25 UTC,348830000,348820000,false,10000,0
78c3b43eb0446770d70435d90e51bb8f13ea0b39aba396b998d1c635cb0b3336,987594,2020-09-28 05:46:25 UTC,13680,11230,false,2450,0
a47e9252425f5d42f8d1d6c3057b5ca0905f8f4d8710b57b24b3b574d0bf4be8,987593,2020-09-28 05:45:48 UTC,12312,2312,false,10000,0
f8b2f5b71411cd41cbe6fbdcb8cc52aa5625ed041d2dd6f8612303da3cd5a339,987591,2020-09-28 05:44:26 UTC,172581277,172577537,false,3740,0
11b3c064d8fae3a57c6812dcdf9826257f5125db5912817f01183f8680e1b76d,987591,2020-09-28 05:44:26 UTC,252686466,252683506,false,2960,0
31aab2f26888fdc273ba6395e1e83eb2befd2be0bbde2c1091b7374fc4d2e9f1,987588,2020-09-28 05:43:01 UTC,90440166,90426479,false,13687,987575
45908580475840ee396c76573415230ea34fc2eb38ee166b99ca28aec10f6fda,987588,2020-09-28 05:43:01 UTC,1646974872768,1646974870675,false,2093,987577
573ddd12064d6e87c8ab96572786f694b9a196929b075a9558e33074cf2ccf6a,987588,2020-09-28 05:43:01 UTC,104378049,101517729,false,2860320,987586
f845c6bde3f9eb8c82affe1a43f49020b122d519acbb2a72c55568f42f5c0f17,987588,2020-09-28 05:43:01 UTC,4957901478,4957891478,false,10000,0
ab36fd80432c5f97344aa028cf273346f27b59ce0850f862e46353b444aefabc,987588,2020-09-28 05:43:01 UTC,85068972,85058972,false,10000,0
9f726649823825c40c0ab4bba7009e08e8b17c9b3f556528f8a09ec4e69453b3,987588,2020-09-28 05:43:01 UTC,272789095225,272789089935,false,5290,0
14c488c79e64dbd4d7a13a018a3d27b988a69f69c1473d591e1a659eecebedad,987588,2020-09-28 05:43:01 UTC,90172086,90116038,false,56048,987575
bdd4a81dd8e806de7bb1a4496f10f19606eed052a8a914931d62edd99e3a4d22,987588,2020-09-28 05:43:01 UTC,1503463261,1503451261,false,12000,0
3a6f5c9a61c0cbb61c3bbff3a88c208a77eda9dcd8553bc284a63649ad3b3d73,987588,2020-09-28 05:43:01 UTC,238550372,238546632,false,3740,0
bed61444d6974ab83e3136bade49170c297446de97da906a530fdd22828ab6c7,987586,2020-09-28 05:39:34 UTC,100000000,99997550,false,2450,0
6cd59d26ea6ad5bcd026a06052c5197c10e9251a9deb13d2319a9e6552f6b117,987586,2020-09-28 05:39:34 UTC,92604649,92600909,false,3740,0
a38ba4e3e96b89e68973279e553542d291f31c30b18b98b9478d515db4c6da6b,987584,2020-09-28 05:38:55 UTC,59774136,59757211,false,16925,987573
a0e9ea1c465f3331aa83f672535dc1f785c70ed6d846eba4486394cddcf3ddea,987584,2020-09-28 05:38:55 UTC,29997740,29995820,false,1920,0
fa1397b87c45f59e1d778bbf8b6ea4b48a08285fd1ee02f2465d2435f628df60,987584,2020-09-28 05:38:55 UTC,1500533223,1500523223,false,10000,0
202475ef9593149a99d76b39118c6111ff1465f0f14e2cb5b824587e349d50f7,987584,2020-09-28 05:38:55 UTC,94210256,94201712,false,8544,0
730b411701384000857c3a2f03dabaf622dc09cd0cf6705b69472e25ef4e5754,987584,2020-09-28 05:38:55 UTC,178104800,178102707,false,2093,987573
2d7814d8fd62f84d84a4637e0d0125e07656c9adf481128a4278188bd1ca13cc,987584,2020-09-28 05:38:55 UTC,17645991,17639991,false,6000,0
363fb9cc48339396e96ab40f94e545603a219075f4d3324207e080c041b52fe1,987584,2020-09-28 05:38:55 UTC,222894470,222891510,false,2960,0
6b5196b7530a5f30be929ba446b2114ded6e2fb2e414efb3ee7f3fba7ad84d2a,987584,2020-09-28 05:38:55 UTC,53346104,53234542,false,111562,0
618ba01fb7b22763326e857662b6343c491e60c2d0433ba4b2599b7ee09a2511,987584,2020-09-28 05:38:55 UTC,226170,216170,false,10000,0
039e8026ac5857dc4bfcca7faa94a3c3eab29fcd01e9b920084aa79fe0543376,987583,2020-09-28 05:34:36 UTC,2357245771,2357239771,false,6000,0
4aaec97bacf907f412fb6715d1cbfde6e18efe53ab04c46b9b5ee3e30ccc3dda,987582,2020-09-28 05:33:06 UTC,19266496,19263229,false,3267,0
65526a327e22ca824424830973c1280caf7e04f0a3746eb356c4302dd5727cdf,987581,2020-09-28 05:32:21 UTC,17684804855,17684799855,false,5000,0
9b1b4ff20bb0ec581ae67a431f4a37d06703e0bd11dfc83141a809bc6a0650fc,987581,2020-09-28 05:32:21 UTC,51111105,51101105,false,10000,0
1d327e17c21e950c35d1c1fdd07ab496ed09cf3b33b67e2e17b0468b21b0f7c8,987581,2020-09-28 05:32:21 UTC,91784650,91713496,false,71154,987568
f692fc4aecfd054cae2d51b2c0a3e7fb2d6ab056d91b1b673eb0b76a9ee151be,987581,2020-09-28 05:32:21 UTC,5601023919,5601014902,false,9017,0
25d3426850292b3ae8acdd9be684babbb3ae4780ca759e69812081b60b345425,987581,2020-09-28 05:32:21 UTC,51101105,51096105,false,5000,0
0299f106ceda570eca6622c88b37e245aec3b86641c90525d475a1fd987a7b9e,987580,2020-09-28 05:30:12 UTC,90832999,90813476,false,19523,987568
7fd0345f5d99ce179ea2cac01bc3eef03de9c8a6ba7459a4ee2b7ff5e2b01b2e,987579,2020-09-28 05:30:06 UTC,10198939,10192159,false,6780,0
f658be6a174a33fdfd0d88d204f938522c1e85de70d2e368599a8316bfec230f,987579,2020-09-28 05:30:06 UTC,18483548926,18483538926,false,10000,0
b20fdc4347e347a9cbee729c2b0eb92cea4d91b6e4423d430b49dde7c602e490,987579,2020-09-28 05:30:06 UTC,34125068467,34125065677,false,2790,0
1e012f5ed4c64eedd7706afef59dbb87c635cdf78fd0d80b82689adaa9970683,987579,2020-09-28 05:30:06 UTC,252862484,252859524,false,2960,0
2b8c198336f91c2713a73575e509ad8cbc67b15db9ffe471432e8b4982838491,987579,2020-09-28 05:30:06 UTC,1860992128,1860983345,false,8783,0
969be19cb400fe2d784dfe5614a7ab6152dbaeb9858b6813d1c7928e572c4cde,987579,2020-09-28 05:30:06 UTC,498062097,498052097,false,10000,0
827a3fb869916d4edb66895f47f93d572e4d6b32da137cd61005e470b5175558,987579,2020-09-28 05:30:06 UTC,126593526,126583526,false,10000,0
9f18c4ac3935a7fb380115b2de77b3fdf267594b0538275daa0faf5e680b4257,987579,2020-09-28 05:30:06 UTC,477606884,477604800,false,2084,987568
1329a29abd6146bdaec04ac87f14edc739c9c9ae130a3de310b026fc525f6f54,987579,2020-09-28 05:30:06 UTC,146121146,146052794,false,68352,0
5988cfb6a907ac825a75659d729caab326ea51ee9a73caa20279fe03d56c3406,987577,2020-09-28 05:25:24 UTC,223109588,223106015,false,3573,0
223cc9acb72c88c6cbffa9f6b6a95c0f07c73fb38022e274c0ef40b7bafaa463,987576,2020-09-28 05:25:02 UTC,10862228821,10862218821,false,10000,0
47a0ee5832743d5e6f0265e62cc06ee7f1ecd3c5d8f4cc626e80fc85f60995eb,987576,2020-09-28 05:25:02 UTC,19219606856,19219596856,false,10000,0
32a574bc651b1606614c0d107b10c4faa3d597f9dee535c5e7bb9b8d47edf7e0,987576,2020-09-28 05:25:02 UTC,1735540000,1735530000,false,10000,0
54237af02fa29bb9943ea85bce25a6ac487279ec487b8c75b13677c4c7042466,987573,2020-09-28 05:21:03 UTC,641884907,641872907,false,12000,0
99dffbd1e1661af04a74a8b605e15d40b990375812d56c3340484fc989e93aa7,987573,2020-09-28 05:21:03 UTC,92420411,92401187,false,19224,987561
85c634bdb61b6e549d1c59dbe42f33afc567c4cba534bbcd332950ea5015bc6a,987573,2020-09-28 05:21:03 UTC,92830724,92778375,false,52349,987561
c33928ff2f936d923998d124684713e3daff4cf413fdf231363b4b36a074bab3,987573,2020-09-28 05:21:03 UTC,361686184,361666226,false,19958,0
2c4f7c95497e59453fc65f5969cf4682494758be5660ed5f75924cfeaaa97611,987572,2020-09-28 05:19:39 UTC,19219616856,19219606856,false,10000,0
bbdeb950aade33cf0491a292bf21991684f463b71be86bc0195380aeb3ed94ae,987572,2020-09-28 05:19:39 UTC,112197644,112000000,false,197644,0
d28f35d0d7231b204895b65adbcb59d44ecbad7cd566ea54130bf0e67f541b68,987571,2020-09-28 05:19:04 UTC,30928177,30924437,false,3740,0
01680de317266807faa3466b403e0d9a1b3d30e4535b1c79c9ffaabe0416c6af,987570,2020-09-28 05:18:57 UTC,20537923575,20537913575,false,10000,0
25ab97e3dca515f591f9a4955ae80d1e0f7713013c696fab1c5a3695f65b6f87,987570,2020-09-28 05:18:57 UTC,94426131,94417587,false,8544,0
18df5d3198dbb96332bcab8352567055c66af4f1735335994825155a5c001d85,987569,2020-09-28 05:18:16 UTC,55675047,55659369,false,15678,987558
7137a855bcaef17e31ea037bf3bf001790bff666474408a4eee962bb751addb4,987569,2020-09-28 05:18:16 UTC,502496334,502485722,false,10612,987551
e771e1014971a41a0b3733c1fab01612d2ddb516dfde7cb819fa4084dd397f86,987569,2020-09-28 05:18:16 UTC,95367132021,95367129671,false,2350,0
f72c1c4382f2c914530454a4baf1af2b2619468fab51f1a568dc49ba86e8c7e7,987569,2020-09-28 05:18:16 UTC,212861898,212859515,false,2383,987514
fa276ee7cf03fe678b273f8002e2797e17879aed40d2a0c84310805b5547a0c5,987569,2020-09-28 05:18:16 UTC,61118402875,61118302875,false,100000,987558
3e42d5462f8c03b10d25406fc1b324e6672435ab56634466f3b87083a3d16583,987569,2020-09-28 05:18:16 UTC,715291130,715289037,false,2093,987558
3d7d9af4ac9da7e3caf6f8829697cf5b2c0998400c201aa2af923e109298107e,987567,2020-09-28 05:16:06 UTC,19672466,19667669,false,4797,0
a176800536612f2e793aec490c6aebd69d1b64a59134ed7dea1a4b83da999824,987566,2020-09-28 05:15:05 UTC,10010000,10000000,false,10000,0
a094090be5af808d79d994a9517f6a2ec160cbcd19664e0144a18f3971f84b86,987564,2020-09-28 05:14:33 UTC,144000000,143931648,false,68352,0
2cb7a4d79a05280672e2e1b1780f2fb945fdfb58a42fa6113954c49e23e3b5b1,987564,2020-09-28 05:14:33 UTC,110920847,110420847,false,500000,0
5e638beed3b6c6f6f188caa45dffaa2c06d3473cb1d3cf0b071f56ad08473d36,987564,2020-09-28 05:14:33 UTC,1647727874861,1647727872768,false,2093,987553
c91b1e6b4996b5c2f924872bd7f2d85ea0fa27b8648b05a695e77890953556e5,987564,2020-09-28 05:14:33 UTC,92981358,92956641,false,24717,987553
46c1ce5428b34d7ae98a08917af13635b6c8d64787d772e8596e0b57f607ceae,987564,2020-09-28 05:14:33 UTC,3790755066667,3790755034506,false,32161,0
bcd75ba69817e52d5cb29a7bba461565586ccf65d562e93f9b0c822e6aaf2b93,987564,2020-09-28 05:14:33 UTC,1020941,1013816,false,7125,987553
7940cd609daa73871886581d7a5bff8ef4bdea0927747625623ac025bab94dc7,987564,2020-09-28 05:14:33 UTC,20036575874,20036565874,false,10000,0
9bab4249e5b8410718e68616696386296f318f42d9baa729409e546764c8337a,987564,2020-09-28 05:14:33 UTC,1668847,1600000,false,68847,987553
a40393ec4cff9a1012911fea22ac5db0c7f76d63d04b8c07d3fd70cf309e3f2e,987564,2020-09-28 05:14:33 UTC,501367701,501357701,false,10000,0
5018810654d6981be814d7f76330a45eb94d47f84c0a0a25256672f5b92efb9f,987564,2020-09-28 05:14:33 UTC,94206891,94143290,false,63601,987553
a1e558e34b85dc01f7a0cde6a2f899af6bf53373d924d2911e0b2aad64ee1131,987564,2020-09-28 05:14:33 UTC,41203997,41196872,false,7125,987463
73abcae95753135fe6932daf84f9370d82fa5a36aeac417e484251cf113b5ff9,987564,2020-09-28 05:14:33 UTC,15601655,15597042,false,4613,987553
da9e17c416a9a3e25f8ee088278ab5b41a1560f914fd825ac96c3256c0ca1030,987563,2020-09-28 05:07:51 UTC,94779049,94770505,false,8544,0
9b07bfdba2bbad10468be3c4dc53af7310761537a049794b957b55f3695ec585,987563,2020-09-28 05:07:51 UTC,501377701,501367701,false,10000,0
a87c9f38baa49d991f51be1afcc36cedcdc7cdeb33b692d524db5ec84302ac93,987562,2020-09-28 05:06:51 UTC,61124466857,61124366857,false,100000,987551
13da4afa6c5cee4353c4d8477d541a441151cb6287d45904701c40bbb529ac68,987562,2020-09-28 05:06:51 UTC,19244602701,19244592701,false,10000,0
8925ecae95ab8e951625ddb4c5f78a573f7d1d1dd466a2c21e722930038f072d,987562,2020-09-28 05:06:51 UTC,184384,174384,false,10000,0
2ab2c8ffd766baeda84867deabc069d215286fca5a78f2e4548e13b09f36e128,987562,2020-09-28 05:06:51 UTC,2000118551,2000108551,false,10000,0
a85e95d8d1eefecd8828904d97302f578ac5291d593d86d2277b062b86a9a131,987562,2020-09-28 05:06:51 UTC,253323001,253319734,false,3267,0
f31390dfe58fe417cf5c0ed21c52052460278a3b14cd33a13e52e3ee2d18ccff,987562,2020-09-28 05:06:51 UTC,1000000245,999990245,false,10000,0
5fca8e12b86f2cafc92f7c8501bf3c82206cdbd3b4b30b6c59c3ccac0b0cee88,987562,2020-09-28 05:06:51 UTC,500027183,500017183,false,10000,0
7ed805da3d117c17fb70de7dbaebf36de360fe7c33d7f5ef04d6bd0c5c987f0b,987561,2020-09-28 05:05:17 UTC,2000234418,2000224418,false,10000,0
710dc85b20c7d76b3465f33eea99bf1c67854287475e605061652887b677e2d9,987560,2020-09-28 05:04:39 UTC,91165590,91163497,false,2093,987549
3294a659f40718e0055c1e6e07ed390859123facc7d8258df978b1c53cd628dd,987560,2020-09-28 05:04:39 UTC,2887350688,2887347143,false,3545,987548
6dc73b37dddb2fdb4a03ebf3880ed502ed2a8d94ad13573c7f92ca97abf52ba7,987560,2020-09-28 05:04:39 UTC,127850144,127832144,false,18000,0
2c2e1951edde627ce4fbeff74c458cc021551dbefe396a73fec5363650711aa5,987560,2020-09-28 05:04:39 UTC,31872481,31860396,false,12085,0
62d849b84a1ec835e03f1963c04f7d7d5a5404e7406ec466f3ed02bc83c6d5c7,987560,2020-09-28 05:04:39 UTC,1649468776604,1649468774511,false,2093,987549
dff71a65166bd650ab0cad65780025160c3f6cbd1afdd6297520af7b31d1d1be,987560,2020-09-28 05:04:39 UTC,243125498,243123405,false,2093,987549
c56b82ffa61f2c10876849b968068c9577441cae3b0e977b45c14bba8f1fb402,987560,2020-09-28 05:04:39 UTC,1000010245,1000000245,false,10000,0
31cf3f6ebcdac4c39a5c848fc999ef97b1dfb33079d9f09a90c9e95535a5ebf6,987560,2020-09-28 05:04:39 UTC,2000015143,2000005143,false,10000,0
95fdbdf8163963c35f219e857d8600f4bab3ef1437655c5e34e64134ecb66641,987560,2020-09-28 05:04:39 UTC,244441128132,244441118132,false,10000,0
eaf3befa4a7cf26d637649fcba41f3c0c90f5cfea6b4a6d0296b764c7238ac87,987559,2020-09-28 05:00:27 UTC,298441867,298439492,false,2375,987547
2a4305b6e0e116500045eac142e616b71c9a237c95f4981785bb4096f56e38f2,987558,2020-09-28 05:00:07 UTC,93489967,93472478,false,17489,987546
c0d53900dd8e5d242aa7be3c19a6f3f28e68bd3dfcd1a6cd9e532ce5e6989aa4,987558,2020-09-28 05:00:07 UTC,95497533,95435410,false,62123,987546
d41cd54925e1dcd69ca11087334beba4f13045f50712c0c57803c8f7d7622139,987557,2020-09-28 04:59:49 UTC,13707295,13695146,false,12149,987545
ae8a6ab15163e11eb345f7e3ab4b25265f11e9ea2f4c2f8fe0a996a26ad71b0a,987557,2020-09-28 04:59:49 UTC,223340662,223337089,false,3573,0
1b8b23f6e675be61bce2c0d6b119df0c12bb041c1ea507a710e16fcc5c7867dd,987557,2020-09-28 04:59:49 UTC,94808036,94799492,false,8544,0
fab4bcb55233dbfefe1c1c5361ed24945d11c9999d6465a89312674e33b2f46c,987556,2020-09-28 04:58:54 UTC,162020164653,162020064653,false,100000,0
4a63769801fbab59697f46209288d44719e752f19ae68a55840ada087d4d4478,987556,2020-09-28 04:58:54 UTC,20110724,20105927,false,4797,0
ace124f3d62698090c81291cf73334a04cc8986600f20d657ccc6a0838ae0b3a,987556,2020-09-28 04:58:54 UTC,100000000,99997570,false,2430,0
57cbfd2e223c3e16f2212de388929851c784a25c6eef521fb757d6335ed0bcc9,987556,2020-09-28 04:58:54 UTC,100000000,99997570,false,2430,0
d596557f1b13a31f06b1a18527cab1e7bab7149ab3fdbecf23779ce6fc835c51,987556,2020-09-28 04:58:54 UTC,414121394,414111394,false,10000,0
808f96fb8ce46b617d83ff04e8021965588f8cf9fec0ce141397fa49e6fe9468,987556,2020-09-28 04:58:54 UTC,1231202699,1231134347,false,68352,0
0bdcc5befeaa8b69f4cb01a9cfdcd155f9539d2ebf017b43bd23560d7249f188,987556,2020-09-28 04:58:54 UTC,148364,143690,false,4674,0
73dea7621ef0062606d5a8ef531320458d4017e6543a385ceb7b2427754c77c6,987556,2020-09-28 04:58:54 UTC,94838185,94829641,false,8544,0
9c0ae9c64f52c64ec1a11969fcb50179c50ca6bd421e0b2172566143aac45210,987556,2020-09-28 04:58:54 UTC,50000000,49997740,false,2260,0
b6573bd8dced1491a3c704f514a34a64055c19333127b42c791545658b692a10,987556,2020-09-28 04:58:54 UTC,10000,,false,10000,0
eb2bf7c0e36c75c0954135590b6fc7a900a7823b9a9acd79a04f45e877506578,987556,2020-09-28 04:58:54 UTC,1000000000,999997550,false,2450,0
7e43457ec2e6d3c4b4b370adb13573adf8ab8087d2e4138a7fa39fcc4d7dec5b,987554,2020-09-28 04:54:02 UTC,40484042,40468373,false,15669,987543
23a64a8d22b8211fcff53ac0e275ba096601ef12142f23919be7ade0931e4b68,987553,2020-09-28 04:53:17 UTC,16710000000,16709980000,false,20000,0
58a63d89f1a59ac580d4556a1a352d3af189a61c5ef8afe2c53faeb774b5ac40,987553,2020-09-28 04:53:17 UTC,195262490,195256490,false,6000,0
b7d76585da4cc3f4c8f6eac2dda0a577ce14e6335163a9c7ebbe7edc3f064de7,987553,2020-09-28 04:53:17 UTC,607582721,607580184,false,2537,0
20b782356a67af9fed5bf51c412e8fe7ba31b49c97276993f5097dd68f46a653,987553,2020-09-28 04:53:17 UTC,21622391502,21622355806,false,35696,0
d9b7c3e6a8d107f16f3d227f2e5cafb46d967c4eb49613fc50e541375814cae4,987553,2020-09-28 04:53:17 UTC,19244612701,19244602701,false,10000,0
622d1adcc7a5971eee7f8300adebc8f01ca631d6797297f31e4e605c11fd4d07,987552,2020-09-28 04:51:16 UTC,2689083,2686990,false,2093,987541
c389fcc2b97c2bd5c7959089820579a4ec80964532fc00313e8082cace15baf6,987552,2020-09-28 04:51:16 UTC,499991224,499981224,false,10000,0
8d8319b5344e048a5abcd43339dcfa62c081e1d7820d7994d7fefae79f96f939,987552,2020-09-28 04:51:16 UTC,19104101757,19104091757,false,10000,0
7cd330619e60d7671377ae45dff89b1f9c7b9c0ecdffef46bb1cacc587df8c9b,987552,2020-09-28 04:51:16 UTC,2278732940,2278707938,false,25002,0
431325870df5c4b2036f2233c77d09424232936bffdd5237d22aad893e0c8860,987552,2020-09-28 04:51:16 UTC,607592041,607582721,false,9320,0
6601c31134266c0a91f95402d3811a9fbc2c3294247c06699c224cf83de903a5,987552,2020-09-28 04:51:16 UTC,97024315,96964772,false,59543,987510
a69a41dcb57a5ecaa9544054420fdb4114d3fedfad4b49f0a96c7d9a33435e85,987552,2020-09-28 04:51:16 UTC,93988765,93965757,false,23008,987541
aae8ff92774d51dc663b02b4642016e836f14d7351ebf300ab273d2484678b5a,987552,2020-09-28 04:51:16 UTC,241510,195190,false,46320,0
69d8e069d94cba46dc687c926266a2396a80ee35c71563c7d7675cdbbab7a4e6,987552,2020-09-28 04:51:16 UTC,1650268778697,1650268776604,false,2093,987540
45560e236ca5ec6c6c0dc34f79763f038310ddc8060ccf03121c2292e29f0f2b,987552,2020-09-28 04:51:16 UTC,290655568,290634056,false,21512,0
a708621a9dd374ccaee3bb964eb4b31d5b3ee5bbba18f88271912ad6eea53572,987552,2020-09-28 04:51:16 UTC,1061755,1058398,false,3357,987541
f033cb45b1859dc92efc8f987066c30eb466bcb02bff4eb078b49f4c16cef50a,987551,2020-09-28 04:48:42 UTC,411843517,411837517,false,6000,0
bff4aa5a0d1f11a83c216f48cb0b95842690f9a48f6797c5ea1b7a925fe03821,987551,2020-09-28 04:48:42 UTC,64810157063,64810127063,false,30000,0
8dac2c84ade63b00d4eb0df3c5fad63800542cc0832f0d8526974d8db32baf6e,987551,2020-09-28 04:48:42 UTC,500001224,499991224,false,10000,0
ae18bc7f26d608d6b92d47076ef67937ec6f27fc0abcdd4701025ee38800e0f1,987549,2020-09-28 04:46:46 UTC,19104111757,19104101757,false,10000,0
b85a72e232369944ca57c961e1b3388c63cc78dcd49191b9802356ddf31c6e4a,987548,2020-09-28 04:44:56 UTC,94923886,94896264,false,27622,987537
af80341bf3ede89bb206c9ad00ffb5030096d494bce804c9d032b41c4e4f8e61,987548,2020-09-28 04:44:56 UTC,69089096723,69089081143,false,15580,0
127cb40f92c9c9dec9b11fb41eb4c75ed5065ccf92488611d40687eaa51edbc4,987548,2020-09-28 04:44:56 UTC,9578054084,9577435725,false,618359,0
03d9583548a35f33894b77ef82e00ecce3771ada5059833cf0fc01b2cb525942,987548,2020-09-28 04:44:56 UTC,169225236,169215236,false,10000,0
86c0ccfd6b60b394b0e64e06df97d1fd7b2045a621a7ddb1d78aaafca2039c42,987548,2020-09-28 04:44:56 UTC,56778431,56768431,false,10000,0
7211b2d9a3ecfe6b7767ee0dda2cfa0645b9df2996a59b36be75d08a20e393e2,987548,2020-09-28 04:44:56 UTC,94869060,94860516,false,8544,0
497d9f6a6b587c0b09ff8f2e3ba4769f03bf039289cd9c22cd3aeca211268bbd,987548,2020-09-28 04:44:56 UTC,101795258,101789258,false,6000,0
71368d96dd1c391669f6a4a516b13487fe7ff7864b941c88e892e0ce2ca2c331,987548,2020-09-28 04:44:56 UTC,5000000000,4999998245,false,1755,0
b2af9b3fcedf0a9966fb76dcdb50e689a2a1c7aaae65c60b2f90757d6fabc241,987548,2020-09-28 04:44:56 UTC,94924833,94916289,false,8544,0
11288c0ce040203d211cb3a0c365a349105be762026ad13d34dc8bde857cf62a,987548,2020-09-28 04:44:56 UTC,98276003,98218238,false,57765,987537
04b466f9e7702619597c87f20b1694c5dab37d53807febbe2f2de7b357540e8b,987548,2020-09-28 04:44:56 UTC,499988372,499978372,false,10000,0
e4e49b932d7fd4e9c3ac2d0d09936f1abfb65016f6841d04d9fbc6d3ff1f4317,987548,2020-09-28 04:44:56 UTC,253471971,253469011,false,2960,0
7d5d2d20692170b3165d81b8f48b016b8de1f32cab963a16dc02e2a6f92d5c92,987548,2020-09-28 04:44:56 UTC,223504162,223501202,false,2960,0
0398ba58e1bb755a6c1790350ae1231f81e49a87f27ec02eb7f9d53484a62cb0,987547,2020-09-28 04:38:49 UTC,2000044900,2000042450,false,2450,0
6405ae7433ae0b53bdad1de89587d15be540e97f15220eaca04fc76ff3a64856,987547,2020-09-28 04:38:49 UTC,20340110,20337150,false,2960,0
31b0e8b3e04b813a1f57db7e185c0c611ad55bae4994fd35c5e775fb96f116c1,987547,2020-09-28 04:38:49 UTC,64786878778,64786878678,false,100,987535
377199a872b8d3f013f12a13dfb27ce86dcd5f68b440bf87a8ba2f2b1734542c,987546,2020-09-28 04:38:01 UTC,266983164,266981071,false,2093,987535
e747344af14705a9a88fe13f81f01027b580be53b892ff2826c642cf1f41d62b,987546,2020-09-28 04:38:01 UTC,499998372,499988372,false,10000,0
ea7f52522e004b8d7a748fc0b5c32514194f8f12bd0c4aeb1b5d08cda4b2aa63,987545,2020-09-28 04:37:06 UTC,191249938,191181586,false,68352,0
1d8a5dd0f13d2ba6e16478bd1521eda00984e90bd784f87f03ab21d6263f17d0,987544,2020-09-28 04:36:55 UTC,169260250,169257800,false,2450,0
f9b38b04c7a7353a1958ffe5f34a9ccce38625f3854edfee94aa1fe135df220a,987543,2020-09-28 04:36:34 UTC,2500000000,2499995968,false,4032,987492
4f036f6c142f449795eae8b8341bb59c2b9297aff54fd0cec16a1fc3302fa5f8,987543,2020-09-28 04:36:34 UTC,1000028097,1000018097,false,10000,0
1735fc55cd6d07f9a972729a003b2a591d181505deb7c406ff6beeafc08cbb57,987542,2020-09-28 04:35:56 UTC,223905037,223900546,false,4491,0
98a51703783435284219b75f2b43e6cd94811ea2775e7337f7e1a4dccb965eb3,987542,2020-09-28 04:35:56 UTC,1103195539,1103193089,false,2450,0
057d2c5cab5d6c284904abbb15ce43778298bbda56f15bb7f67865f5513753fc,987542,2020-09-28 04:35:56 UTC,87029596,87016165,false,13431,987516
4087ccf0a82a9f7e3b1b196c1bb52e977d172ebad6811e86cd74f7584ad10ea0,987542,2020-09-28 04:35:56 UTC,500008372,499998372,false,10000,0
41dde75148321b3dc4b0b705da53845bd14a1c4a69fa30db082d96842ebd352a,987542,2020-09-28 04:35:56 UTC,2000010000,2000000000,false,10000,0
52fc84d19cde49aecbd2ae508087c7f4c9d947f2fac979cd3b1978c2b134252d,987539,2020-09-28 04:32:31 UTC,2000147858,2000047858,false,100000,0
1acaa29e037253fb2ae45979e502e6bbdf1412871863b96b37d726f85945d5a8,987539,2020-09-28 04:32:31 UTC,500005872,499995872,false,10000,0
5ad85617124b0496be59eb4fa56e77010a1858fa74a2f74d2c9a8d91f06b554d,987538,2020-09-28 04:32:18 UTC,94954862,94946318,false,8544,0
e5e18762bd3b4508d483ddd1042330f6dc81e733aa86a386a9920c362e4dde4e,987538,2020-09-28 04:32:18 UTC,73002953,72997953,false,5000,0
9e9c99387f7fb7c4dca208daa0603ee0db59bbd71396bf7b3330588dd13cf598,987537,2020-09-28 04:30:55 UTC,94986358,94977814,false,8544,0
6136b996f206672cc89afc2ea6615359b4a89b5e225f761585bc828318e2d178,987537,2020-09-28 04:30:55 UTC,254703405,253471971,false,1231434,0
6ff3dc671b59f8ec5f0df35441e983a7229cc0e4ab4237e8234cc1dc4249a9b1,987536,2020-09-28 04:30:20 UTC,73012953,73002953,false,10000,0
0aee12096e100553283c44fd8e1c8df3bebda4b3a5268d49d1449ab5c0beb18d,987536,2020-09-28 04:30:20 UTC,95588391,95564238,false,24153,987525
9b837ba13a5061bffb6053e280c08396c7817d6b07206d5cc014fcfe39436dc9,987536,2020-09-28 04:30:20 UTC,99901920,99841232,false,60688,987525
f359cd7ae61a310d0008861353ac2e75cde3f97c37b8f2ab2f387cce648d5fb3,987536,2020-09-28 04:30:20 UTC,500015872,500005872,false,10000,0
5f1148fa1748ccd09e7bb84a55dffaeaf7f92ead9b3b276c01190afca4fb4ebb,987535,2020-09-28 04:29:39 UTC,91673497650,91673495300,false,2350,0
b104e5cb7a93af0daa6ddcfadcee6639cac527cf9b6d5dcb276cf456f840301b,987535,2020-09-28 04:29:39 UTC,95025559,95017015,false,8544,0
f0cf533bd7191b51ebeead6882a19b163282476a9d5357e87f0eb8b176d9c004,987533,2020-09-28 04:27:18 UTC,16984376,16983376,false,1000,0
1c5ac866d204490f0032bf0ac74407662dd95701cd1f21db3c392e9c778155fa,987533,2020-09-28 04:27:18 UTC,57938933,57930753,false,8180,0
5b2ad1ec55ad96fb5c5bebe59a81809a41993c43bb7f9d179cfa37897412e11b,987531,2020-09-28 04:26:04 UTC,20490599,20487639,false,2960,0
b4c9b5813b03b973ba19ed1ae7bbece7e71829e9cdfdc4566fa86fed95b750db,987531,2020-09-28 04:26:04 UTC,27146084,27130133,false,15951,987519
bf0896dbc91eafe92902c063973db9b73ec0b72be2a5658e31f2b1f6afdaeffb,987528,2020-09-28 04:23:46 UTC,1902160956,1901222431,false,938525,987516
44e0315aebb241ddfe79e7864a90644be8f25bc36da56bc94c3cd54477508b3a,987528,2020-09-28 04:23:46 UTC,926750638,926740638,false,10000,0
1304832011c922e7c067ddc57ceed3f66d83a26ae254d93f25d2ad7587aedbbd,987528,2020-09-28 04:23:46 UTC,53024,43024,false,10000,0
01923e3e48e6d430e6346bc2cdaeac2ae854a0ffdee86b3a16e4d7cb361caeef,987528,2020-09-28 04:23:46 UTC,4350418723,4350416463,false,2260,0
735fe67c98e6954796e18957492c55539f4b1836e7b5b7b1452b2ecc4a8e09f4,987528,2020-09-28 04:23:46 UTC,533715198,533434725,false,280473,0
22cc2aa2a55b646ae7e9b78b2aa248e844e2065ea44f015dbf744eeea356db23,987528,2020-09-28 04:23:46 UTC,224061688,224058728,false,2960,0
efc8e8610b7964dd68f9fc19f9047aeb3818708819533362569b7c347a60fd25,987528,2020-09-28 04:23:46 UTC,25900001140,25899997740,false,3400,0
c57f2a8d59e88a1f31689e178f3f416fc135ba1dc905fdf3aebe23d0dea717b0,987528,2020-09-28 04:23:46 UTC,3434873051,3434869721,false,3330,0
6da77610eeb297a7c81aabadfe2b78db528a8f7a9cb16469c30f416df41f7d32,987527,2020-09-28 04:20:08 UTC,901849457,901781113,false,68344,0
cd75a0c33d9813e31137569020b557ff94e79911babfee69c27eed9fc5370ca1,987527,2020-09-28 04:20:08 UTC,471616978,471606978,false,10000,0
787e0b4cfb2ef12fb82cd06e36f0a9a8fc8b50eb1eefeff98410ad1a8e85f366,987527,2020-09-28 04:20:08 UTC,295085174,295083081,false,2093,987516
3f2a030d056b44ee08be1e534b7b1d880062502e535457148aeb63f690f221d5,987527,2020-09-28 04:20:08 UTC,7117281,7105133,false,12148,987516
2053769c42e58d120a7c2f7320ea51f568958f4240f54d241c40828eb380e96b,987527,2020-09-28 04:20:08 UTC,100996780,100943686,false,53094,987516
b112b368c2d632902d109759523fa58775f4f06c9a290cd701b751ca7b9e8e9f,987527,2020-09-28 04:20:08 UTC,96099285,96078330,false,20955,987516
9a337d56cf1d10a08b4950e2cd35dd8bc0997031737a7d6309debca719a11c81,987526,2020-09-28 04:17:16 UTC,100000000,99997570,false,2430,0
6159b57b39580da7fbbfe80d754de0be316ae4371bea5112f9b28bfa5c603181,987526,2020-09-28 04:17:16 UTC,499990000,499980000,false,10000,0
274e986f885653719bdcf4601225a53d31db73c4991633a4dddc1915118cbc5c,987526,2020-09-28 04:17:16 UTC,20785072,20781193,false,3879,0
8f6013a094e8ad290c7e35e1407d8dd7f800c5d5b0a0ed4928a2bf59467e1e74,987525,2020-09-28 04:14:45 UTC,177926162,177923712,false,2450,0
fb94348f0f8d9bfb7973b3adbc24fdc07987ce8828fa37d8cece74586893e5c4,987524,2020-09-28 04:14:40 UTC,275541848,275513809,false,28039,0
24dba5912bbeb958259ecaac104cdbdbf6e030c567732672664b57591c93db59,987524,2020-09-28 04:14:40 UTC,96512551,96496557,false,15994,987460
a64855947ddfa407444cbfc823cf46dc6975a05c9b9e30c8f9bf7fbfa850c1ce,987524,2020-09-28 04:14:40 UTC,102016439,101960126,false,56313,987512
b6d3c5494d6bc581c7c0d89eede36b57d3e33a521069a80ca4ae9f8f6f49c3e7,987524,2020-09-28 04:14:40 UTC,224216517,224213557,false,2960,0
f22037f5b6a6aa8cce5609c5b18293534963d5373115be36dcc1ce766fc7dfb2,987524,2020-09-28 04:14:40 UTC,2114310000,2114300000,false,10000,0
f2c947b0f8d4c764bee18dcf10b37ed24c21f68380ebb86b87856e4964daa9c4,987523,2020-09-28 04:08:58 UTC,62857661,62847661,false,10000,0
e2156c6c241ef791f2960cc57c92f9302dd25b319e73dfd4866da183ff63e19f,987520,2020-09-28 04:06:25 UTC,10000,,false,10000,0
fc61c9181b054bc21cc67e123a5bb132c94f6258c8c6b1dbe1596bbd57efb495,987519,2020-09-28 04:05:49 UTC,2000170897,2000160897,false,10000,0
df8577eba45106f55b4db07b28b80e9f975e119d00be8211193b380a76737f53,987519,2020-09-28 04:05:49 UTC,2000244418,2000234418,false,10000,0
bcbc228932a323f39d2b756e99eeeb687118bbcbf860114e7c003e97c2121d7f,987519,2020-09-28 04:05:49 UTC,20956942,20953982,false,2960,0
96b65651154442d39bd616b7a16ead3e309e4aabd3569d83ac9aeef7b154e278,987519,2020-09-28 04:05:49 UTC,3000095877,3000085877,false,10000,0
398f13e214b874a1f9d92bcc5074617eb2bbc84a68b747526220e565dd9f36b5,987519,2020-09-28 04:05:49 UTC,18534996740,18534986740,false,10000,0
219a9ab7b4d3edac09a9692c53cfe66c70dfa3389b570c7b7037999d9450648e,987518,2020-09-28 04:04:32 UTC,500030981,500020981,false,10000,0
ac46e5065410b389b13255adeae76539ede97c3e1f8e1acdb822b002cf58fa1a,987518,2020-09-28 04:04:32 UTC,500000000,499991456,false,8544,0
9c50fb3fe5d23cc89697fbd80833dbdb6e5f91088ff9d1744ab0ef6e9e4dd388,987518,2020-09-28 04:04:32 UTC,241913504625,241913494625,false,10000,0
451ec4048a32e140edca26f3da6e6acdf093d82bc2e1f0b40c4210cf44491427,987518,2020-09-28 04:04:32 UTC,1978210000,1978200000,false,10000,0
3de815a611b48c642441e610a9bb689e8978230de8bed29b0aecd2dd648f7ba2,987517,2020-09-28 04:02:47 UTC,17498957976,17498947976,false,10000,0
72bd91209831c0927ce0507c173a21aa8ec1d45134e0149ffbac1b3183e26475,987517,2020-09-28 04:02:47 UTC,100000000,99997570,false,2430,0
f680b369eee15a95c52d546740a46e856a9c73b30ed66028aac606cd5dc9a3e8,987517,2020-09-28 04:02:47 UTC,408087126,408084453,false,2673,987506
9ba9e859c53dee696f234f8650b0389bab402fc5f88860b1979b8ac06374e191,987517,2020-09-28 04:02:47 UTC,95149499,95140956,false,8543,0
d61a920f67cb7ba3ca63cdb6c7a4aa027b2a3fb45f36012496c49dfcc739b4cf,987516,2020-09-28 04:01:13 UTC,2930112102,2930109429,false,2673,987505
b1392784c4792dcc0ad587d3639688498898311c038498dd96a208057f726eec,987516,2020-09-28 04:01:13 UTC,500000000,499990000,false,10000,0
a4895c2cd69ee25f9da4b600782d0aa1611aed894eb251bbbc820d6a4d500d88,987516,2020-09-28 04:01:13 UTC,6864627761,6864621696,false,6065,987425
f14f77d481ccfabe49dc65a5040e98519c3d93b5ed57c98056af6b5f2c5c5ef0,987516,2020-09-28 04:01:13 UTC,1652518900790,1652518898697,false,2093,987471
2ebc18dc52ca1e0391353c02f44918c5c175bf2f1c9c0cf888e0f2a359792653,987516,2020-09-28 04:01:13 UTC,723038023,723035930,false,2093,987505
cd1698c9f8566b77028f76dece9515b3e78f27840a3cea3cdfeb7bab4030558b,987516,2020-09-28 04:01:13 UTC,612481332,612412988,false,68344,0
2b4b2f1c2df2ee905a76d6047b4f9e4bce40e18145cf8138bde8666fc6227572,987516,2020-09-28 04:01:13 UTC,103108101,103050821,false,57280,987453
821242af99515efa5743d99fd3b1fa4b2cf0967fd8bd585c666d3c3307b8ac08,987516,2020-09-28 04:01:13 UTC,224519375,224515802,false,3573,0
30cb4260ea590c7a04b694c7a263ccb584635ca18a6dd96d6daec0fef45bf427,987516,2020-09-28 04:01:13 UTC,53494493,53487343,false,7150,987505
aae493b99e5846d456b0107e8760b4f71d600e8dc6d4ea1c0641995b08b2e86c,987516,2020-09-28 04:01:13 UTC,253920989,253910989,false,10000,0
13e48fb14f7023bdcab594d7a3251f79a04c5bd6861659bf532cf976a7a0504e,987516,2020-09-28 04:01:13 UTC,97094744,97074694,false,20050,987505
17061ca3594a4b421836a4e632823a623028a7f2334af26b874b0da9775ffe3f,987515,2020-09-28 03:58:09 UTC,13639308898,13638178727,false,1130171,0
a522e4c9120b020645685b623bd45fb4cd4f53983ad1369cee321406dcf53b2f,987514,2020-09-28 03:57:58 UTC,126497125,126487125,false,10000,0
0e7f2ed57ce5542efe184e2900832645cfad9c7e29337bdeef726b67c5626562,987514,2020-09-28 03:57:58 UTC,20090891,20084891,false,6000,0
90a152f496cb75b22123549a11d13e9514c01477132f215bccbc32884433720e,987514,2020-09-28 03:57:58 UTC,21154784,21151517,false,3267,0
6776ce2a3b2825bcd832e15e059fcff85ad621835cb085b8c5dccfdbf80195b1,987514,2020-09-28 03:57:58 UTC,106194834,106188834,false,6000,0
af3f68698d90197ab96d672632961cdca7de60aa22122650b8ff084b88695d84,987514,2020-09-28 03:57:58 UTC,95201700,95193157,false,8543,0
20c819e61de35776bd35fcf42ac2e115f1bfef08e3dc0c38acfa3cdc6fd15884,987513,2020-09-28 03:55:57 UTC,10010038,10000038,false,10000,0
d9d434908851aa81638ab1fadde4df540cbad8c8c6bdc79393b7c37dbc7bdf98,987512,2020-09-28 03:54:42 UTC,2403040116,2403038023,false,2093,987500
f40f05749b805a4148449305fd5a70428693432bbda121cf276cba09f00ed0b8,987512,2020-09-28 03:54:42 UTC,6344324500,6344314500,false,10000,0
be11b5bd6be1ba5521d61f96eafc4913e6a85c5fdbc79d47eaa98fbc2d7b7532,987511,2020-09-28 03:53:23 UTC,13690474,13690374,false,100,987499
5caf9e614b9d67642622d2a1faab9ce99fdfe1d393094ebc99eafe59f77354a3,987510,2020-09-28 03:53:14 UTC,138609,137027,false,1582,0
c25703f94f182e303b27100422fff45577b82f03374d56d06bc7e3040d36e10d,987510,2020-09-28 03:53:14 UTC,500040981,500030981,false,10000,0
97691226b4a1eb8ade45260508c20f046d88909cc1668e285f000a8333836e49,987510,2020-09-28 03:53:14 UTC,6316525,6314095,false,2430,0
684f25e95c8987ce52f501b9d66b636101dfa4a3906a94725410aa68df3e7fb1,987510,2020-09-28 03:53:14 UTC,540930795,540920795,false,10000,0
83ed6607278def07b9ffcdd36357e61b3d90f4318aff285ee29180b77ab7ac43,987510,2020-09-28 03:53:14 UTC,15838968594,15838938594,false,30000,0
c38c799b751a933f2659adda66ab2dcaa8b6bb18471017fdab60f1ffbe195e32,987510,2020-09-28 03:53:14 UTC,2509323009,2509320916,false,2093,987499
10c6a26d3924e90cfcd91a7b08e17c3a71006be8b6cdbf8d40f01d1cea4a27de,987509,2020-09-28 03:51:28 UTC,104886976,104822443,false,64533,987497
802f231a45cae3e74e7ba5050c7f575d470897d82bff305b09aca9c1a9e9ca59,987509,2020-09-28 03:51:28 UTC,500050981,500040981,false,10000,0
261f57afe2469b8b19d80c8f7b1488a83354a9fe128896acd68f20a7e028441a,987509,2020-09-28 03:51:28 UTC,500000000,499990000,false,10000,0
a138f6ed7b109faaaa96575c4ee8974f645271a1080decf4db4c29599095d05c,987509,2020-09-28 03:51:28 UTC,287765505,287762969,false,2536,0
dfbd9255e843744427c21d44a74377b01c70ab2169c06be549ca4489fbf52a2f,987509,2020-09-28 03:51:28 UTC,103077921,103071921,false,6000,0
c8cb31a7d3ff23b8ec55427def02f805c1a7be474e83b3702366cd25be65108a,987509,2020-09-28 03:51:28 UTC,2548879999,2548869999,false,10000,0
6b9d1f796b4b7a6ade875d91b76ab4e250e6e7727d6a3f8a2c9b1cbbfbb0669f,987509,2020-09-28 03:51:28 UTC,95431739,95423196,false,8543,0
a618fcfc166cd7e16240bfedf3150647f2caf9946babf36613bd7df62b049b5f,987509,2020-09-28 03:51:28 UTC,97618786,97597813,false,20973,987497
afad15b533fa843d826514d2b39c2b4eabc9c4f2308d5447e7715d23d389a019,987509,2020-09-28 03:51:28 UTC,5195340,5192910,false,2430,0
32d8c13da8c5ca863683eff4c84f11aef1b9d23bd111f5b5f3859d2a904574ab,987509,2020-09-28 03:51:28 UTC,10318955,10316525,false,2430,0
8e68ea9405ef873f94315258d8eb9999d05aea72860ff9f207c0a6b952809571,987509,2020-09-28 03:51:28 UTC,436212122,436210029,false,2093,987497
1d91fd5fa2cd3e327fdb1e75ec65f27a1150efd3d4188ef66f2ac54396fc8f36,987509,2020-09-28 03:51:28 UTC,287771865,287765505,false,6360,0
04f7454ba432eac61e0170110a81bd2172c63be732efb6b3fcd54458cb4d244c,987508,2020-09-28 03:48:49 UTC,102843303741,102842803741,false,500000,0
1180c605c3fa08805780ea094a18f404702107aab2d9a400504c5e76954ad57f,987506,2020-09-28 03:47:27 UTC,84807960,84804855,false,3105,0
44d53eb18bfa95189241dbcb18ddcae8d4d7be1bff0682d9a464ce114e655a29,987506,2020-09-28 03:47:27 UTC,95468364,95459821,false,8543,0
46b09765bf209b445a9df405090b92641e53a52a5d04f72a8aaa7c482794dc57,987505,2020-09-28 03:47:06 UTC,10436930399,10436920399,false,10000,0
d62affe86db9b1e8129c39813cfad3608b4f44fd3a299d6e79180223674cdce0,987505,2020-09-28 03:47:06 UTC,224711126,224707859,false,3267,0
8cdb7fd6191121ffbd43e7193fde397eb6756e4b3dec8b58df0544b0e8bfe6b5,987504,2020-09-28 03:46:25 UTC,60170,54170,false,6000,0
1d52d76be073dd47725f60ca2acef86a53845195c3c78152d4237d69a8ee0b79,987503,2020-09-28 03:44:15 UTC,144004706,143936362,false,68344,0
e26b19fb51d9f11db7dc80f146e501a69850162dc93fcf434fd6c2841594b050,987503,2020-09-28 03:44:15 UTC,39264433,39260693,false,3740,0
579d1bc3ce4ef295579c1ff60521a23df3ff6e7697d41af57cba2e7e1331f404,987502,2020-09-28 03:42:39 UTC,69028625,69023625,false,5000,0
18004a530024cf7bdace90112d2df2c3d60e2d7bc69d7284ae1614e233993dc0,987501,2020-09-28 03:42:29 UTC,65198031,65188031,false,10000,0
abb14a4241ef1a85d3a6f02a669c030a88c2371a00e340848158a1095bc07d36,987501,2020-09-28 03:42:29 UTC,21361211,21358251,false,2960,0
ac4a1a7cd0e19ed23706ca67be8a504efda715617a2a98156c66ef82571c5f55,987501,2020-09-28 03:42:29 UTC,69038625,69028625,false,10000,0
da2a240508998648ab1b2447f26ab245bc071d771683e977ff8a67cddf45b6d6,987501,2020-09-28 03:42:29 UTC,47500,41500,false,6000,0
7046ec2a678071123902b867bd06d224e6961c7dc8280775b330904de5bda403,987500,2020-09-28 03:41:25 UTC,225001744,224997865,false,3879,0
b2695bc0eea2bba0ca13beff49888b8facc14be66afdc3db3e535643ef5f3530,987500,2020-09-28 03:41:25 UTC,18413523719,18413513719,false,10000,0
5ad0df759aeb10a85f11f8bd774c4f4fb966f0d7fa41a8b4761b03da35968fce,987500,2020-09-28 03:41:25 UTC,5471820,5461820,false,10000,0
d524cdb50ba927b4b43d5a803eb92f70f410b419f8f8fc1b561dbed2e285ccfa,987499,2020-09-28 03:40:37 UTC,19158558238,19158548238,false,10000,0
6440e88ada12bc329043da9a342c035b1d1488eaff712acff65c2144d1c89fa7,987499,2020-09-28 03:40:37 UTC,63516624,63506624,false,10000,0
72bcb337f1dd5a18fca2019b364ff68d8039f7396d9be40ba09490f82c7bc2ed,987498,2020-09-28 03:40:17 UTC,106282325,106227403,false,54922,987487
87f776e44adb08030fc4a4a61e4e020b4f74b9f5d39db95da166ae19eb07068d,987498,2020-09-28 03:40:17 UTC,3860208578,3858114985,false,2093593,0
5637f9f32fb4434a917ed9f973f6a53c81b7a18505e51bb755e02d9365b72bb8,987498,2020-09-28 03:40:17 UTC,98177299,98156036,false,21263,987487
02dc1f3cf156fbcfbaaab1c6d1b87f716d124ad1c398d1524f215f52d559650f,987498,2020-09-28 03:40:17 UTC,155664058,155564058,false,100000,0
914760b273af3d5375abacfc6eae3f49c0e585fcbc1515baeab0d2d16b838f82,987497,2020-09-28 03:39:40 UTC,75533806,75513706,false,20100,0
24c55d078c2e7dbd20947a69e0bcb82fe71bcca7cef345c1f296aa3d427836bd,987497,2020-09-28 03:39:40 UTC,2548889999,2548879999,false,10000,0
f76531deddab0727c98b48dbdf33183f50138f0a8ba9a762f1e2b2d8fd66f5df,987497,2020-09-28 03:39:40 UTC,399624120,399618120,false,6000,0
660048121e4622d81b65165a4c64ce86b19ec44aad887a1b98b866bb4ac5ae2a,987495,2020-09-28 03:38:00 UTC,18215521960,18215511760,false,10200,0
5776378016ddb1a1dbf41489fa63b5e98dcef2df805378278312ddc109ddea99,987495,2020-09-28 03:38:00 UTC,95497793,95489250,false,8543,0
f06bf3cf9d8e176b6b97049a2d1c6e6d401d928d213f637e66643c2e01ac6148,987495,2020-09-28 03:38:00 UTC,151004710,150990008,false,14702,987484
8ca09fa7942d85d9552f457295b9dd6c6df2741eb27e4ef796f74e9abeb7a4ea,987494,2020-09-28 03:36:24 UTC,3814981366,3814977340,false,4026,0
d9023d63f7b28a04b407f89da40f3329ab0e5ec68795adb992984a2744fd2add,987494,2020-09-28 03:36:24 UTC,61137366857,61137266857,false,100000,987482
ff40d982634acea7ac4d964a2e566e845eab23550998b29e690f8fb7d94546d8,987494,2020-09-28 03:36:24 UTC,1000110454,1000100454,false,10000,0
bdf5193c442bda784acadbba0cfe7e418a91e88af5179d6fa239ac3023498de4,987494,2020-09-28 03:36:24 UTC,61655900,61645100,false,10800,0
eb9fa05a8971651c206d7dcbd6d10b31a2fa637bbcd3e0eb3142dba9d42b5cb8,987491,2020-09-28 03:34:00 UTC,499980716,499968631,false,12085,0
f98e3041c6039bcd634c2826e3a26006ab46da6bcd0d880a546ead0e4c867796,987491,2020-09-28 03:34:00 UTC,21568214,21565254,false,2960,0
08736a75fd825bcf0d6c5f8ccd6f676b501349c30e7128701c6f4be6a3971bb4,987491,2020-09-28 03:34:00 UTC,98725716,98703872,false,21844,987479
24999960d9c2867323c9f572bec2782bff6b64d92afd9c387c0ebe8dff15cd48,987491,2020-09-28 03:34:00 UTC,3864794321,3864792237,false,2084,987479
9cb32c0f3de4c7ab44586c1e2d4f4993a970002fdb29090c3b9c6f6b724188aa,987491,2020-09-28 03:34:00 UTC,75724302,75718302,false,6000,0
70e994abe844a79e43accc035b8b8dec93d1e8e79e04f91a65a78eeec21256a0,987491,2020-09-28 03:34:00 UTC,10000,,false,10000,0
11a966870bcdf3d4533ca9db7711dcb9cbeea2e0533f823aa2dd91213b18e9f7,987491,2020-09-28 03:34:00 UTC,107334201,107279279,false,54922,987479
9b46faffc6447c3ff0f8ac14e6441d237a8b0a191173834c11c9db57689c569e,987491,2020-09-28 03:34:00 UTC,16007142,16000001,false,7141,987479
c12658ce011b27f9826d2e1750ecb203d3697910bec76995907bf5ae06617e9c,987491,2020-09-28 03:34:00 UTC,899369114,899348690,false,20424,0
bb707fbf6d7f5953e75f9f55cdb0a09ccf7c7de03d02a3255bcf0835241e2766,987491,2020-09-28 03:34:00 UTC,17751351082,17751079170,false,271912,0
7eecc289e8383a2c5fd0129452565058ec6668627c64fe2ded6aa7c32301d618,987488,2020-09-28 03:29:13 UTC,200360726,200354726,false,6000,0
bab40c1b0d13d4372d06fd0144aa0ffbc01e1a43a8795c8e66fab08277c3b7de,987488,2020-09-28 03:29:13 UTC,499992674,499982674,false,10000,0
d55507d2bf4cb2c08330dd225e7310f24897915460c84a1877b8b1895e9c0241,987488,2020-09-28 03:29:13 UTC,111655045,111614645,false,40400,0
9eb5b8a25d3a71858ccfce23a72f147316f5412d0b197b55227031fe0d861b03,987488,2020-09-28 03:29:13 UTC,225319622,225315437,false,4185,0
e1da59285788a9abe025c01fe1a50648ad4e867695a779e6fd8ab94f603d6087,987488,2020-09-28 03:29:13 UTC,36869,34419,false,2450,0
9fd17364c8c17db2908800380c7cef477684ee6ef6a4a3db27ef3e5db4c1e1d0,987486,2020-09-28 03:26:09 UTC,136553190,136533190,false,20000,0
b3a00c1a773beafa0aa0dac4b8af62619184e7140417adf3109bb8d8c35295f0,987486,2020-09-28 03:26:09 UTC,95650061,95641518,false,8543,0
1e7b97951ae63c35192726b8a9612319b2385715b6241db1f6a52a3075679807,987486,2020-09-28 03:26:09 UTC,100118118,100087738,false,30380,0
bfcabde0a127a4af6050bdf32aa55b225f0deba3d75b946a2458786d43bc0ca8,987486,2020-09-28 03:26:09 UTC,500002674,499992674,false,10000,0
db8ad3ef7955bdda8e8d3ac04c13cfb7e9e3cf90643a31deb3fc11948ac64522,987486,2020-09-28 03:26:09 UTC,2374501,2372051,false,2450,0
9fe1d5fd11a7e593d74aa27a48517cdc10a5d68ac078245dd92ef2a4e0bcc270,987486,2020-09-28 03:26:09 UTC,183770607065,183770307065,false,300000,0
f3f07858df53a0233ad2369ce47bc9890ea82580f0c783c86267177c5ed3d33e,987486,2020-09-28 03:26:09 UTC,432918370,432916277,false,2093,987475
b9583bb436f99de330693ab92f7ad7117e16d821872e846082cfc618ffa9084d,987486,2020-09-28 03:26:09 UTC,17015248,17012798,false,2450,0
5c5b44f75122e05a5dc6249e96d57d0089c015e5141235e45fe1f0a3f23edded,987486,2020-09-28 03:26:09 UTC,8501198949,8501196856,false,2093,987475
ef6bfb5afd53b9e778a3adde083eabe032cc0b79b6bd590ceb7e28edda3587d8,987486,2020-09-28 03:26:09 UTC,289249122,289245382,false,3740,0
cfcbec55f9422745cf4ddb44ad2dc40e941fb298acad2e8f15ceb9631d8679e2,987486,2020-09-28 03:26:09 UTC,2552930636,2552922456,false,8180,0
703f473a713473565f837b253669bff9f8ca7dff4b552830e8a108bb4463b775,987486,2020-09-28 03:26:09 UTC,381645618,381577274,false,68344,0
cbbeaba41f53e6418c25cae6eada0eecf16115227a262bf39bb071120e553d46,987486,2020-09-28 03:26:09 UTC,47887950,47879770,false,8180,0
299470900ced1a6761a9dece553f582e6e369faf425f3b0460342e5c93514893,987484,2020-09-28 03:21:46 UTC,95754909,95746366,false,8543,0
056ad8209d8151ebf228265b123ab73e0ab0c6257b1db293d91c30698f2fb771,987484,2020-09-28 03:21:46 UTC,99221407,99202194,false,19213,987473
26b664e3a6752c4495681a6a30f5c176c98004aea5052ad2326358ae699c2114,987484,2020-09-28 03:21:46 UTC,236035406434,236035396434,false,10000,0
f82b6531f3a1c89fa6c5ef8588597bbbc03e43fd657da55df81276c55612c38f,987484,2020-09-28 03:21:46 UTC,1074774527,1074772434,false,2093,987473
6a12312f66e1ce400ec2e5b443b85267c0678cefa5c2e034cfff8ba6e50e3baf,987484,2020-09-28 03:21:46 UTC,18658585564,18658575564,false,10000,0
efec3d48ac24481b4bc12e5945fff06ac5d47bdc5fe097341a27c029517f4894,987484,2020-09-28 03:21:46 UTC,108446375,108397296,false,49079,987473
960eafe7125e9965960d6fb60530e78464fbe0a9fd394b07e06340e4591a8696,987484,2020-09-28 03:21:46 UTC,25897108,25894198,false,2910,0
910a598eb24c578ac04d272d0f2ef0a2727427c3746e57f37e285f57d1a2da58,987483,2020-09-28 03:18:03 UTC,20827842,20825749,false,2093,987391
9e712a3d7b162514cae4d79117f7964d1ba51ff9a885f1d77d052e46b53a0533,987482,2020-09-28 03:17:50 UTC,18782883928,18782873928,false,10000,0
a3e3413752c01d9f9f2695d1b184eb54bf5262c106dd772f1e887d3ef433fe5e,987482,2020-09-28 03:17:50 UTC,100196006,100165626,false,30380,0
2e145ff1cf8896cdbe9feaa6f5ef16e4e880c33de6479d8d30e3e4f81cb209f8,987482,2020-09-28 03:17:50 UTC,21734481,21731521,false,2960,0
5278021e2c2993432b4300adfe6c8493abefd624527b58fca13d0f367ee2bf23,987481,2020-09-28 03:16:58 UTC,102582605,102578865,false,3740,0
af3c778e4b3a8370b82fe2041aa79f45dd3189521135f11497fb377a9b92bfe3,987480,2020-09-28 03:15:39 UTC,95784034,95775491,false,8543,0
1fd12f2ad48067677b8b57d4dc9ab62fcffe5f49ac5326f708c611760297a879,987480,2020-09-28 03:15:39 UTC,22199443144,22198943144,false,500000,0
02edb01bf593a05d49750930b89895af7b410a586375c2d27d647505804ef86a,987479,2020-09-28 03:14:45 UTC,999994000,999988000,false,6000,0
e83fdab0b2172361e5e85561dbcee88e33cd23428af050d0e75f34a582c3fcd7,987479,2020-09-28 03:14:45 UTC,2604030960,2604020960,false,10000,0
ec5d2062940b8f38031b7a359217b7465361315a1380b3b3f7310b11fdafc7fc,987478,2020-09-28 03:13:23 UTC,96089613,96081070,false,8543,0
d7d44a6e2a031248db1bbee4c353c89f54042f86a100dabbe81cf00f75e65a4c,987477,2020-09-28 03:13:46 UTC,6301497867,6301428730,false,69137,0
4767e0aefd4e383a3a0ad40afe9a3fef3e77fa43365fa58dc6531130fe0cd7d1,987477,2020-09-28 03:13:46 UTC,292451899,292409599,false,42300,0
74a1b3fa39e637d209f72521308b15200059054ac063053ad4252f6501a88fe3,987476,2020-09-28 03:13:12 UTC,5701683831,5701676830,false,7001,0
7e55b2fb1f43c4b9ab8b7310b29c8fb88d8f89d92f590057ac820ddfcc437db3,987476,2020-09-28 03:13:12 UTC,10655582553,10655580170,false,2383,987465
0e858bb3ba3e06c0d78753a8488437967f2a38ecdb4fb9a93afddd3e1a379c8f,987476,2020-09-28 03:13:12 UTC,225877241,225874281,false,2960,0
7c5c323b6aba8f97caa7578c03ead97b07a3237cde464de67532333f3dca3f8c,987475,2020-09-28 03:12:29 UTC,21909537,21906577,false,2960,0
1db7528093fa8fc71fabb15f6c22e939955405f9c708c2256d3840777e9053e8,987475,2020-09-28 03:12:29 UTC,236035416434,236035406434,false,10000,0
f9208c072d7a46e1ea7bd401283a7d88231dce32f643d904feb5d2c3a1dd6276,987474,2020-09-28 03:12:00 UTC,4457010000,4457000000,false,10000,0
474132ab93811dcb45be70f81dc1221f2631bb59c134549ab2616eb2f9d7ed15,987474,2020-09-28 03:12:00 UTC,49440706,49431053,false,9653,987462
94d7e33bd149e377af2121dbe17ffded1cd9b9a50eb1304ec0c0a147e8ca798b,987473,2020-09-28 03:11:01 UTC,109528495,109475913,false,52582,987461
ed20dd3212f022c0b9b3ee6b663745c2ee28f16fac5d8ce41cbfe06b433f5901,987473,2020-09-28 03:11:01 UTC,99578524,99562797,false,15727,987461
38b9768f16cfb3e4551bcc3c25b5f1ddbfd1c271c9f6ebfa9bedc710290898bb,987472,2020-09-28 03:09:54 UTC,107083520,107073520,false,10000,0
f1f6937c14210f5a04d38e02e9be73870a1d65f2b77eb70f813a9bb8185b95d2,987472,2020-09-28 03:09:54 UTC,197038756123,197038752303,false,3820,0
ec35e7dd3ad5f6be44b9c1c5791e1ef319a0afd92d03f7c13be03d1fdb994528,987472,2020-09-28 03:09:54 UTC,3147349,3142849,false,4500,0
36c10312f28389a2b4ef9034063dbf30cc3bca9089fe197eedbe8df9ce48750c,987472,2020-09-28 03:09:54 UTC,107073520,107068520,false,5000,0
f99218502022916087287fdc72f24da12e38709ffd060a520a4d21099a2d628e,987472,2020-09-28 03:09:54 UTC,155744058,155664058,false,80000,0
b4dd110914db8f11963d06d0bc9c1cd7eed2e9cdac494bb575795b756d1c5874,987472,2020-09-28 03:09:54 UTC,18782893928,18782883928,false,10000,0
b57490de89d1c6f9191e6d11cffcefbc9b25bff09aa97932c2e33547efe32b03,987472,2020-09-28 03:09:54 UTC,2000203905,2000193905,false,10000,0
31303065887fa283f261ee1392d8889267ace29eb79f31633ef14f9ca71bcee7,987472,2020-09-28 03:09:54 UTC,226028950,226025990,false,2960,0
8cfc61a54c9ae059eff91419086ef2184ca1e153174a82967eaeaeac53f467d7,987472,2020-09-28 03:09:54 UTC,96307029,96298486,false,8543,0
ccec71266c55dd12949780608f1f89efd978b74d04472f9a8af0fa3dbf589fdf,987472,2020-09-28 03:09:54 UTC,100272794,100257604,false,15190,0
a107aa2a21ebfc9ea66063f8f867011633f8b1a69babf129dc714806b1f9264c,987471,2020-09-28 03:06:06 UTC,3000105877,3000095877,false,10000,0
df44e4b10cce230e1fa4f1df73d3d324f91ea4d8879b754836458a0f60d085e2,987471,2020-09-28 03:06:06 UTC,1500051602,1500041602,false,10000,0
60029c9093d177c4d5d0a1d82cd97d786f8e8d39399bcce1348c2df10677e14e,987471,2020-09-28 03:06:06 UTC,469374709,469372616,false,2093,987460
35566be8664c1d572d2032cec9bba3f782a80449f688e69de6a1a3a3ce2029f0,987471,2020-09-28 03:06:06 UTC,99998528,99988528,false,10000,0
1974b37866bf07a5244a3df244c429a7b44058dbfa45f38df40194b4d8ae0364,987471,2020-09-28 03:06:06 UTC,5722683831,5722676831,false,7000,0
38bbd1dfd601f364aba9c43c0dfc0b7108ed73d19e1baa7bd0aaaded2780592d,987471,2020-09-28 03:06:06 UTC,99954500000,99954497650,false,2350,0
b98dd5324e4a628aab9924fdea5eeb12c24edeee92eb71422679685ad62abd2f,987471,2020-09-28 03:06:06 UTC,285090,283170,false,1920,0
eee11281760cd977221d98ca9ad9bda8b8eaff53079dbb541822747a881cb203,987471,2020-09-28 03:06:06 UTC,1000532960,1000522960,false,10000,0
93c1a441f885c74c39a24bfd562aa4fb25943cd34c00a4d4a46a756ce87867a3,987471,2020-09-28 03:06:06 UTC,21755084646,21755082553,false,2093,987460
709039ab3509e90df8d976ebf9c1f6a74eb6439db3e7afbb56ecb2d6f56e60ce,987471,2020-09-28 03:06:06 UTC,48002568606,48002563386,false,5220,0
11378d1884f9be02250bc8a10ef186a068d1e6c2572f3b2185aaa97179ea8677,987471,2020-09-28 03:06:06 UTC,96432299,96423756,false,8543,0
03c3a8a8dd9f91e573d9103ef904c874619d5766e23a6f3fcc60ec1432242f3b,987471,2020-09-28 03:06:06 UTC,226184238,226181278,false,2960,0
b05543563286da4108c49a3c33c7283bc04fdae208053b9483515f3c752dec26,987471,2020-09-28 03:06:06 UTC,22092513,22089553,false,2960,0
90f2dfb5b4e0d9015f2cccca138833970b1983ad833c5e1e1bf92f0802451c42,987471,2020-09-28 03:06:06 UTC,240987029242,240987019242,false,10000,0
d9e8e031b73e817498b462d9fd1611380d6d8bb2dcc26358c18dc845b22cd058,987471,2020-09-28 03:06:06 UTC,30421078,30051718,false,369360,987470
d8c32c64308da7c5957c4fb368934d68dde1a2c65e7921daec300aa7b6870a6a,987471,2020-09-28 03:06:06 UTC,1051849866,1051749866,false,100000,0
e3913bcfa05692a691eace04275dfb22fccdb2270581ed6d8025c2aa07798c82,987471,2020-09-28 03:06:06 UTC,18832976722,18832966722,false,10000,0
d679819a2cfffd788598124b2874b40e26584d9bff3a6d98deeb5b923cc07e86,987471,2020-09-28 03:06:06 UTC,162544465125,162544164181,false,300944,987457
e9acff91df5b529288022f8ba63a0a7e288e2683a37a5c63b9040d8373756b7a,987471,2020-09-28 03:06:06 UTC,3742604230,3742372658,false,231572,0
18ab68b68fb4d3c1440efca0230ffc3131afabc5d0e42f885f008e83360709d0,987469,2020-09-28 03:01:46 UTC,186117554,186115294,false,2260,0
3105b19d99236236872389a1112368e87a51fc38975ee64745b124d649560136,987469,2020-09-28 03:01:46 UTC,494089748,494079748,false,10000,0
bbf475032ee42821e1aa9f717e895bc4f4e5c30d177f372aa06a1ab638e780c3,987469,2020-09-28 03:01:46 UTC,15594545,15589941,false,4604,987457
3a9db8b84460cdf4ebeb335672db36574aee378d2c262e8889795dd303d80868,987469,2020-09-28 03:01:46 UTC,49734123,49732993,false,1130,0
c3aef10772b11c7a92c644a34afad6ce0b99df4f18831fb4278e4c85cfc349f1,987469,2020-09-28 03:01:46 UTC,93060294,93058374,false,1920,0
3ddbfe2cd398f922b0e8e502fd80f342f609caf7a36c681c44c79300393d73a8,987469,2020-09-28 03:01:46 UTC,7094330,7092237,false,2093,987457
4bf38613562475580beceededeef653f05272bcb84cfa8dffedf2ed940509104,987469,2020-09-28 03:01:46 UTC,405015679,405013006,false,2673,987458
44f3fc3cd26307dc73cc6d30bb36f8df11cb002ce55c2d69e7636c323a0504fb,987468,2020-09-28 03:00:32 UTC,491564792,491561828,false,2964,987457
447b7161dba7dfd6138ca3b9e414870998663c665db27f83cbb2613f3d1a5204,987468,2020-09-28 03:00:32 UTC,499990005,499980005,false,10000,0
1335881bffc9809d4002ab2f4d49adce9a9ab4f98efed44afa203cc8e476fe61,987468,2020-09-28 03:00:32 UTC,110588675,110537810,false,50865,987457
a96c0fa61350fda1c6e1b2db30f4749f4e2ce2b3e5cef6de4a2880c5e5493b7f,987468,2020-09-28 03:00:32 UTC,17599445991,17599442661,false,3330,0
fde0b0cb12bf9c6a2bce7b65f655e4a247ed21ca0840f965ad41fd7cbe814e5f,987468,2020-09-28 03:00:32 UTC,18832986722,18832976722,false,10000,0
25643880d898929a37ddccc86e5a2fa8d1895914772e1224892c963305d6ccf7,987468,2020-09-28 03:00:32 UTC,2750653350,2750638853,false,14497,987457
f94de185079158d63e4596baf4b5a952919d1d1f0d763a7164ef653dfb6c90dd,987468,2020-09-28 03:00:32 UTC,100092611,100071374,false,21237,987457
a693b10b1d04ec55f810a6ef3a56822425212f7fba5c5e84557af043d73083c7,987468,2020-09-28 03:00:32 UTC,215612386,215590719,false,21667,0
1a6eee6b2e40761018c387433b6ba06778570c2a5296644991308566d02b2998,987468,2020-09-28 03:00:32 UTC,10000,,false,10000,0
619cedbcfef061603cdd7caafcb3ae7a821653cc951baf6b32c582a9124df4c4,987468,2020-09-28 03:00:32 UTC,610767182,609491279,false,1275903,0
0879b645a5d1317acc43e4db8a219f0f70639b1a3af721161332986e8fc829cd,987468,2020-09-28 03:00:32 UTC,22290390,22287123,false,3267,0
40e713cc5177e584100f2d0d397fbf4d4100d0bfc3efde2208b3a89b7107854b,987468,2020-09-28 03:00:32 UTC,4478010000,4478000000,false,10000,0
4d20c9f62a1b1e6591f8320bdb9e1ef42c1880e71a77ff3858be0cd9add7ac61,987467,2020-09-28 02:57:15 UTC,11140996185,11140992774,false,3411,0
2672c9ffb3ede1ba58bd020b0f48a2c6b664a935a3b03f3f3c55c1a624efeafe,987467,2020-09-28 02:57:15 UTC,10000,,false,10000,0
d7da40ca5649190077cd6dccaa9e5655a9b69aefa0aad43f53df96dcfda9adfc,987467,2020-09-28 02:57:15 UTC,114568751,114565351,false,3400,0
dc489c6bac5f22a9d885208a7c6905e0f199a59cc72e0cc8f9f0b4306f2a8335,987467,2020-09-28 02:57:15 UTC,284159,274289,false,9870,0
cf16bd95cf118d888f7b6550606a8109b7dbd74c709209c4a769b285d5a536b8,987467,2020-09-28 02:57:15 UTC,10000,,false,10000,0
9d866eaea7ca542cdcd6381108249a6c3a05d2b35e06e65598d7be696dbd7066,987467,2020-09-28 02:57:15 UTC,19379710095,19379700095,false,10000,0
86711efce2ed0715c4fdc02f7c14fe6d72f6525e3282e5a87d63f7c8f5ea8057,987467,2020-09-28 02:57:15 UTC,226447223,226443650,false,3573,0
3188664a33852e32d0c4025f5ba31fd5c7cf5ffdab1f01f7067527cedd4181e7,987465,2020-09-28 02:53:36 UTC,684426516,684353136,false,73380,0
a50f9d9c93b7bf8ecbf9bf8489ddaf3c74a54df270909357a8190ab6cc8e7653,987463,2020-09-28 02:52:51 UTC,500000000,499990000,false,10000,0
b7b56a7f424f96bc54afe40014e672b9b3bc719063841dd31786b117157f7882,987463,2020-09-28 02:52:51 UTC,10000,,false,10000,0
029fcb1bea30431b6ef683e4d20f161b8a8b5618f7e68626677f78d0779f84a3,987463,2020-09-28 02:52:51 UTC,96489866,96481323,false,8543,0
83b17954231d2020a31109ce488e209d367f56e138a990494460ff82cd61cbc9,987463,2020-09-28 02:52:51 UTC,10000,,false,10000,0
7d27593872d567e4de5ea517089d37003ac82c58287b38ea02f06b358488feef,987463,2020-09-28 02:52:51 UTC,21764106989,21764104905,false,2084,987452
7d8f00a74680d6cf40bbc4fe11471d2f505a7972fb3419bc77bf786d07c2d96b,987463,2020-09-28 02:52:51 UTC,232732600,232728100,false,4500,0
9b2dbaec170ff1a03fb181c8757c583a2adc50c3d9e30efe69317525fd6b9bd8,987463,2020-09-28 02:52:51 UTC,9305096,9303006,false,2090,0
90c826bf2ac5d29411373e39762a21e1340e2cd1a9fc4b2d6725ceb549d628cd,987463,2020-09-28 02:52:51 UTC,112088438,112032097,false,56341,987452
3e51640f957205929365621f2ee4902f3a88e7121a97eba625b2ba63a28bce05,987463,2020-09-28 02:52:51 UTC,100662295,100643680,false,18615,987452
879dd4f4c2007b8cc83cbaf7e79cb25417184d89d07bedbfa5506161a9b08380,987463,2020-09-28 02:52:51 UTC,10000,,false,10000,0
7b3d510760c5b7c528f2119cb45ea89ddbaeb8104069f641fc7110ea2ada4603,987462,2020-09-28 02:49:10 UTC,10000,,false,10000,0
a7e17342871b26f42653cacbb0ec0b1f71073857f1992d1a513d0f317b16c979,987462,2020-09-28 02:49:10 UTC,22472737,22469777,false,2960,0
e257cfa595bc95173ae057f3560f516092155b573fd2791df8798b843b0674f6,987462,2020-09-28 02:49:10 UTC,226722729,226719462,false,3267,0
a13774cfa497af142d7c907bb56ef09178ccf64ec101ad4df0caae8d16573948,987462,2020-09-28 02:49:10 UTC,100400416,100376112,false,24304,0
2f8e86eb5f14854fab0a0c8c1824a16b89edca20b68acf0a271ef633c768c983,987462,2020-09-28 02:49:10 UTC,1364651466,1364571466,false,80000,0
0529e422044f4c69638bb0ca9f2f5cd8c699e07687b35217a178030c3af21d22,987462,2020-09-28 02:49:10 UTC,22502609082,22502606989,false,2093,987389
8fc124dd43728f35f1115a6f1b39016f7905895d09ec84b2f11a2b219f4a6157,987461,2020-09-28 02:45:55 UTC,10000,,false,10000,0
0c3f06109addec4268352eca91af563db4497ce76322ffd56ad85789d037659e,987461,2020-09-28 02:45:55 UTC,10000,,false,10000,0
022827025e60bbed8cb61fc8a528a36fe6e520becb215048836a4c8caa52e34e,987461,2020-09-28 02:45:55 UTC,97164927,97163007,false,1920,0
ffa5a611a65410dfc445ef67fbb3fef832f5d00835e83515856f58eb3d2752df,987461,2020-09-28 02:45:55 UTC,5601936401,5600590620,false,1345781,0
c48b90ec01c46a0ebe304837b4eeae24a2de298a4cf4a2fb54bf51cf754a908c,987461,2020-09-28 02:45:55 UTC,19379720095,19379710095,false,10000,0
5b1f15f40375cf6272e68865124797e703c9cee2ca1f7bf830dde2461f8add08,987460,2020-09-28 02:44:06 UTC,22635256,22632296,false,2960,0
49408476c98773a063fc078a0b5dbf4bb40e78a0f9616adad9d3726f11a22cf2,987460,2020-09-28 02:44:06 UTC,226886860,226883900,false,2960,0
7fabe7968365cb03d56f0cc401d59d6cdb9e543132ac8ee174d9d6fcacb7b0a4,987460,2020-09-28 02:44:06 UTC,500024836,500014836,false,10000,0
50d78a73cefffda97dca651df4071bb00b9c73451335af3c244d66582d085fad,987460,2020-09-28 02:44:06 UTC,2045170920,2045070920,false,100000,0
908c3b1d87c26c50819e52eb71055f5558aefe3f2c3c5d44e6383e919c4ba3d7,987460,2020-09-28 02:44:06 UTC,500000000,499990000,false,10000,0
2cc03f8ebfc527f4858283fe717823a0fc491da4f7fb497be92707020bc408e7,987460,2020-09-28 02:44:06 UTC,33986537,33976537,false,10000,0
2be4ecdc9dae54d62abc74fbed11905e9c9503d1987953d36889339cb649b0ee,987459,2020-09-28 02:42:18 UTC,500080945,500070945,false,10000,0
e1138c32d9b78bc7852d656bb7dad4a5c767e9d738a44664e5a7578a354cb270,987459,2020-09-28 02:42:18 UTC,10000,,false,10000,0
b6f3337628e8336719eb7f246003384e1662d7b5bc48ff8535583946aa3d8eb9,987459,2020-09-28 02:42:18 UTC,10000,,false,10000,0
7cb443442c0bc10fd4a291e7c3577f5f5f1660f0bd72816fc62650ff6d2ff90a,987459,2020-09-28 02:42:18 UTC,101082118,101080276,false,1842,987448
e01942c7ac8ab3d931fd27941ba86a392688a9b99152d46890fdaec5915d8197,987459,2020-09-28 02:42:18 UTC,99900000,99880000,false,20000,0
602cd42769179a88f07ca4e87c7fc7933d430aa371f646910626e0d4b7969d9a,987459,2020-09-28 02:42:18 UTC,22816601,22813334,false,3267,0
2df2a737a64217a9848308f1d2b69912edb35eea7cb14b523556c5a5125547cc,987459,2020-09-28 02:42:18 UTC,19234435736,19234425736,false,10000,0
b2d7a561a2dff66be8d83c4bae639c794535a6128b767c74b31afd479e52bd81,987459,2020-09-28 02:42:18 UTC,541743234,541735251,false,7983,0
0c3cc09d61f5412b93ebd900670bc3a86baa3b508b95131629f6a470401fbc87,987459,2020-09-28 02:42:18 UTC,5849775353,5849595938,false,179415,0
4ba7d87ff1336110d6a56fa7b37348a71b3180596c9c6b0c0959274cfa61ad57,987459,2020-09-28 02:42:18 UTC,227073296,227070029,false,3267,0
f458ebcbcbf75cce04b5c326a105c04ede9ca77a922a311fb20b39586a4d2b8c,987459,2020-09-28 02:42:18 UTC,10000,,false,10000,0
1e80ade26ed4d0bdc2cc88b4ffa4664f1cfb2a983bf93f1872dffb0980c332b5,987459,2020-09-28 02:42:18 UTC,500034836,500024836,false,10000,0
d9396bc24cbabcff8690dcd748ab431aad055d44b5760dba8f3c4fa9345a05f6,987459,2020-09-28 02:42:18 UTC,113159472,113153487,false,5985,987448
cfe5bd8f84693dc41647c3807f654a62b283de81dd3d69cfa25d1d7ac8b5d8db,987459,2020-09-28 02:42:18 UTC,499990000,499989756,false,244,987448
c8e093b4be696f6bd053b6763dbfc67b7e2ed0af48e88d04602f41bf721f8004,987459,2020-09-28 02:42:18 UTC,87464,73970,false,13494,0
804ced92bb9ee3047dbf5d684cafcb2e7450636233d5e2d1365e3aeb6486c825,987459,2020-09-28 02:42:18 UTC,2000393,2000000,false,393,987448
1b917ccdf67e78a9d9885b2c2b77f78aff5a11c45ed654e30d7a390fe35824d7,987459,2020-09-28 02:42:18 UTC,107798423,107788423,false,10000,0
125edf94193a2371a88afa612d5930cb59fe34c01bd341c5a58e64560db67ea9,987459,2020-09-28 02:42:18 UTC,4400000000,4399997550,false,2450,0
7ac9800ec08f69e6450c16287dc628d20a3d1f3ed40dfa07c3755aaa73b9001b,987459,2020-09-28 02:42:18 UTC,977360535,977358060,false,2475,0
163cf1dbd454e3986817284501dc6256dc286f1a4c252953ba63869149fba29b,987459,2020-09-28 02:42:18 UTC,20000000000,19999905140,false,94860,0
2f51a73384796f8fca60719bf525c0356fffb7b3008cfdd5b98115f6b71fe063,987457,2020-09-28 02:35:22 UTC,499980000,499970000,false,10000,0
a67814dbb3c5ba8d7a23049e71656e79198e4d550ce9de1a639954f22c1977c7,987457,2020-09-28 02:35:22 UTC,10000,,false,10000,0
15e8b133be69f0816872a65aa321f6668c902ee38c5d1da783a1fd93e1a4c524,987457,2020-09-28 02:35:22 UTC,114518019021,114518016331,false,2690,0
d40cdeb5fd7cecb5efe14a98e6bc619f94c4c389814cc5116f51cc4772e174c5,987456,2020-09-28 02:34:13 UTC,500044836,500034836,false,10000,0
63662f040ec31937e5ea6b8fa8a037f0e8e12927776a2bd0af5df0495340c2e3,987456,2020-09-28 02:34:13 UTC,36365599327,36365599082,false,245,987445
57425f1ed6b608af82ab0f5192744c486fc9f828aea6f61995817f3228c1b3b4,987455,2020-09-28 02:32:36 UTC,66156,62756,false,3400,0
a0c41a46b7bf03f25eb7132a2e05547ee3da28f0d3d21b6bfb337b8570349969,987454,2020-09-28 02:32:34 UTC,337321367,337301367,false,20000,0
04b4e2558e442d2b9be09767079f9c73569c6d2d6278d8fb56654cc69f3732dc,987454,2020-09-28 02:32:34 UTC,10000,,false,10000,0
5bfb15dbc8c57b98cbc01151b2abcf1273e509c21bbb2c7b54a609a213d7c154,987454,2020-09-28 02:32:34 UTC,227226885,227223925,false,2960,0
664e2c3639ffd4bd0185c469c1b78fae27bde76c46f244f06cf0df062883963b,987454,2020-09-28 02:32:34 UTC,100000000,99998080,false,1920,0
e281e6e87fd17e9b84f268b2705735e863edb454dc258f94aa7f14fd51bc9e08,987454,2020-09-28 02:32:34 UTC,316090991,316070991,false,20000,0
b81ba244b75191dff0f69fd7e18f8dde2353631414bad653e67b9b388db9a2f2,987454,2020-09-28 02:32:34 UTC,100761235,100733893,false,27342,0
2e3430ac43236bf56bfaff2a055883b6aa91ef1eaeeee59fda9fee3010a0414b,987453,2020-09-28 02:31:19 UTC,10000,,false,10000,0
0e0ea66b49a99f86d55eb2cbe6cd8e3e17c32564186eb257e62da241d4a4214c,987453,2020-09-28 02:31:19 UTC,101634066,101631647,false,2419,987441
296a4e356b38456303a680482ffd25f3fb84d50ddb000a9a443a5747235a4910,987453,2020-09-28 02:31:19 UTC,6703130022,6703127518,false,2504,0
a2be9546cff3c847608e6104485d86aefb44337a0e019b113e0bdbf01e814950,987453,2020-09-28 02:31:19 UTC,499990000,499980000,false,10000,0
e7c400e0bf7c857784ebfb579ce75acf9eac90aa298683c9c9ede79ad8ab64fd,987453,2020-09-28 02:31:19 UTC,1706341473464,1706341473185,false,279,987428
3f0ea63b45b5b9c795506bd6d336533b2321799dac6d834bb4db4580fd0cb63e,987453,2020-09-28 02:31:19 UTC,114346414,114340731,false,5683,987441
81c41c37daf0355d228a1e5b09cb02ba5c4a5889ded3b576c8ac7a7860ba1878,987453,2020-09-28 02:31:19 UTC,1529800960,1529776962,false,23998,0
745af55c64624967f5f165b92ae2f80ef8629d15429d158bcf505bb4c4389466,987453,2020-09-28 02:31:19 UTC,3698728,3698449,false,279,987442
521a10c936d6a141d8460350c479df9283915e058a509ddceb43e031068d3349,987453,2020-09-28 02:31:19 UTC,285145432,285065432,false,80000,0
a23a2b64b294be4300f3db6136a2662502f5f4ac291ad1b23bf989648cce40aa,987452,2020-09-28 02:30:03 UTC,19963475270,19962056677,false,1418593,0
6a4c8546cd622f65e4767f71ac1dc8bda8a3b9eed79e65a8bda1186944ba56fe,987451,2020-09-28 02:29:18 UTC,23005350,23002083,false,3267,0
23e090bf15a10edca5894d95b46b4a127ffe3f7468e045b1489c2fd932d3c126,987450,2020-09-28 02:29:14 UTC,2940000,2930000,false,10000,0
91ccf9d4dbe20d8f4167b594a07f0e1442684ab779e71ae3540874d109792f6a,987450,2020-09-28 02:29:14 UTC,500000000,499990000,false,10000,0
49e8310fc900bc9637134096b89de86ea432bd7ee00ad5fca8155dc08240af5a,987450,2020-09-28 02:29:14 UTC,444347644,444347400,false,244,987438
8f24255e16aabf7a1105d121157b6d21c44d135c9d02aecee9de99323bdb4c72,987450,2020-09-28 02:29:14 UTC,440509553,440509309,false,244,987438
967af9474392056eb13dae515f0a9e568f2d57bac89eec33747a808762d2ee8e,987450,2020-09-28 02:29:14 UTC,48865386771,48865386527,false,244,987438
a2ada81a06dc628f7b9c1c4d26e77f124d5921c8c20fb27e7eac564cab5e7589,987450,2020-09-28 02:29:14 UTC,488228922,488228677,false,245,987438
a6d21a8e877eb7150984e55321554694c44bb5d6d85861bcd3ab342aa864af37,987450,2020-09-28 02:29:14 UTC,480517093,480516849,false,244,987438
e9485481593efbe4a55a680e721a8f645bf2158866bea0c1e471e505ec95872c,987450,2020-09-28 02:29:14 UTC,484370485,484370240,false,245,987438
34c45c539908f2123afdae0712e7985d0fa690640f155d2222e7c8c812d72c1b,987450,2020-09-28 02:29:14 UTC,436687458,436687214,false,244,987349
cd2411daafeb5b3ec274958c0ce64bc298e3ff95aa4d89a6d0fcc98e2de089c6,987449,2020-09-28 02:27:33 UTC,8577857557,8577857312,false,245,987437
d32bcaa3b8d4b12b181accae3bf56a8fcbef72947a48ff444fe94810f80a0f7a,987449,2020-09-28 02:27:33 UTC,492046416,492046171,false,245,987437
d04a3095aa67db610d04713f03905220b7f91e1b2e731fcc876bcc649c088aee,987449,2020-09-28 02:27:33 UTC,57514316247,57514316002,false,245,987437
7756e53c600987b3ad64784fc21fdb4643513423b15ab58a60c9ab82a8376717,987449,2020-09-28 02:27:33 UTC,495851187,495850942,false,245,987436
e8bfebea3fb37b9123bc158a46000863c591a870ad7e305db2f5ee73b240c266,987449,2020-09-28 02:27:33 UTC,8522829123,8522828879,false,244,987437
bcebab8fc1bc50b106ee39a0a33d53286f49a0eef25d98aedb5c1ad92ba8175c,987448,2020-09-28 02:27:21 UTC,533075376,533075132,false,244,987436
28158fa35a8d2989f1bcb7bde053e4a67b73a636b24722ebdad72d09ac54b90c,987448,2020-09-28 02:27:21 UTC,722664120,722663875,false,245,987435
571d9f2c7dec922d3316e64570007b9985ab6818c02d13e50dd1b0d19bb5405e,987448,2020-09-28 02:27:21 UTC,10000,,false,10000,0
d9b8694bf991c0a6b2b85eb71571f6605c8a6fe5ea4c64eee19552cbb664b647,987447,2020-09-28 02:27:19 UTC,57518203202,57518202957,false,245,987435
0309eee63b2004f72896ebdcff437f7c200b2dae56f02c0f0f698911a9d524c4,987447,2020-09-28 02:27:19 UTC,8581765614,8581765369,false,245,987435
a4907691f3021886b1007fe5d3ff449088c1861a8fa590e90cfeec536eaa4b61,987447,2020-09-28 02:27:19 UTC,778568719,778568474,false,245,987435
a98c5fd870bac5bcfbc97114b0d74cda5085685bd90810af860fa0d3fec04a77,987447,2020-09-28 02:27:19 UTC,782413454,782413209,false,245,987435
a22211c4b48f19daed56dcc141e253e3d88f185af3c62878f870d64448135e2f,987447,2020-09-28 02:27:19 UTC,740744146,740743799,false,347,987435
f635f3b80c92b465fec983f82658c96066ecc4be545006cbbd6a4367035b4049,987447,2020-09-28 02:27:19 UTC,500000000,499990000,false,10000,0
b604ae6e657239ee0cc52caa0f3484b7243985f3fbd0e4c6d9da8d19ece1e462,987447,2020-09-28 02:27:19 UTC,8526724750,8526724505,false,245,987435
70d363a2fd90b1da4aa5da344ca286446d5ba326df2316a3a5245d9f73cf2217,987445,2020-09-28 02:26:32 UTC,48634918844,48633618844,false,1300000,0
8f30167000a439a6eb4cc774cb26e111b6b762780444381cd7c73c8b958ccb1f,987445,2020-09-28 02:26:32 UTC,884572578,884072578,false,500000,0
4f5b7280fd38c13a39c7a00a2ac67221123d629217779a903c9d0b8a696771a1,987445,2020-09-28 02:26:32 UTC,11541795,11531737,false,10058,0
5ae45ec4414a8bf1f756500702eea81bc2c8b63efee75960f3a1a35e0a842516,987445,2020-09-28 02:26:32 UTC,10000,,false,10000,0
e98f135a6503b9ce520a4a40768bfe3bb0cb0573bf4e1ddf1234be9373521f07,987445,2020-09-28 02:26:32 UTC,11551795,11541795,false,10000,0
309c870ac4f3dbb5ac91a1b07568e03b55296b88fa6c4fdacca85df9ef6a79be,987444,2020-09-28 02:25:14 UTC,227376184,227373224,false,2960,0
6814d2358111fb66622753f42892038374527252d56e5da9b9bd4c6dae2d3472,987444,2020-09-28 02:25:14 UTC,38724047888,38724032308,false,15580,0
64f05b2b880e26273e7c1db2e29e1ab22660d9df0b990a3c3a1ca9955fb3c5c3,987444,2020-09-28 02:25:14 UTC,801861242,801860997,false,245,987432
0299252b88f1472646edb505f21837108b4ef9268597b498a816866f156a53b7,987444,2020-09-28 02:25:14 UTC,57555930849,57555930604,false,245,987432
2c595a9b0e576a8dfe3d0042419d594b4a7aec59d19932a84c8f798810577195,987444,2020-09-28 02:25:14 UTC,157100000000,157098200000,false,1800000,0
4526f5211bc9378608a2bc9db260673f00cd221b2cb5f36be8bc44021abc5296,987444,2020-09-28 02:25:14 UTC,17706276,17696631,false,9645,987432
1b62a8b8c3e446dfc651c65ec129e74e68c14bfdbfece9a473931b5f378ed2c2,987443,2020-09-28 02:24:47 UTC,8927751159,8927750438,false,721,987431
e541f2c1d8463585635e9abee9b93509219d606b7e1ea0fdf5f6c4948f6cd2bf,987443,2020-09-28 02:24:47 UTC,8585598276,8585598031,false,245,987431
5289628a120a3b86bd36782f6ef4e548ed55be3cf2f79481b9dd5dbb3d3bc1cf,987443,2020-09-28 02:24:47 UTC,805733931,805731847,false,2084,987376
d1d637da1813a67e7a819712dd3443892fd4bab774e10eb269ce356693b46222,987442,2020-09-28 02:24:40 UTC,813501292,813499199,false,2093,987382
6b94c32378789a42d2f01ef891e1578525f49618021736c5f3df8111568b5f6c,987442,2020-09-28 02:24:40 UTC,817330886,817328802,false,2084,987430
71c871f4e58596a60852c686316c311e13982a3e234dfaf20a9805384fab6d52,987442,2020-09-28 02:24:40 UTC,809606958,809604865,false,2093,987430
77c7c6fb5a4055899f3b18176f92ff19587516f0444a2ecf6c445e4ec8b7864b,987441,2020-09-28 02:24:34 UTC,885921832,885919739,false,2093,987430
893161eb085e7e1dce6acbd5d587209f5322d7b1ca8147ecad0afa4e742920f4,987441,2020-09-28 02:24:34 UTC,1082280396,1082275980,false,4416,987332
56f7f42c8fd1e15035b11800fb686f16e1efbb185de49463744e3083ebbc30f3,987441,2020-09-28 02:24:34 UTC,858271714,858269630,false,2084,987409
26e30bcad54171a08295def56a538f67eec163a601a68d0309e5b2d7a8dcc41b,987441,2020-09-28 02:24:34 UTC,854378200,854376107,false,2093,987430
7e20d4947042b478a7358e9ba35a148e790e456cc0d0984d2602264314c63446,987441,2020-09-28 02:24:34 UTC,8931630715,8931628631,false,2084,987429
3d248a574ecdbc8d342ddfd7c1bd1d9ed94b32b7532a14c250a571124109b50b,987441,2020-09-28 02:24:34 UTC,850429772,850427688,false,2084,987430
d691d27031c2460a58bfa78c63663adeebd2eca4aeb12a842b03627841a6524f,987441,2020-09-28 02:24:34 UTC,57138441910,57138429535,false,12375,0
3aa77ef045fedc4aef8c6259390ecdf1e28f91d4e33bdca1dc9a39769ca54759,987441,2020-09-28 02:24:34 UTC,846660413,846658320,false,2093,987430
3d1bb1affc448e38b70a97e943384f83d3c87ebece3f1121d04b5d9578f6f274,987441,2020-09-28 02:24:34 UTC,926724310,926722217,false,2093,987429
7e2723161f174e6600c9631f1bcdc1fa7e2b6be2e3610f7a3a551bb41eff6540,987441,2020-09-28 02:24:34 UTC,889835332,889833239,false,2093,987429
b35cc363ee6b2cbf91e116daeaa33cfbdafec3c65ac79fac830a84f9e6ba4622,987441,2020-09-28 02:24:34 UTC,878386977,878384884,false,2093,987430
6af4866959c3b0598caa4e3ea9facbbe0380ec21ccf18f45b8cd2427ef41ad5c,987441,2020-09-28 02:24:34 UTC,839013042,839010958,false,2084,987430
06bb7f128c698887371de089d740e7604f9743000a300a5fe608b26e6e2781fd,987441,2020-09-28 02:24:34 UTC,842748551,842746458,false,2093,987430
1e653bb2f20253c02001156084dd9f59d459494a80a3323f25fda9a35e1b3954,987441,2020-09-28 02:24:34 UTC,835060492,835058399,false,2093,987430
beaa80cce102fbca458eed9afbe7c1f92dca9a716f1d5c98a418509896b3eaf7,987441,2020-09-28 02:24:34 UTC,8589374427,8589372343,false,2084,987429
f08fce4507a944c9741897313a3d98918d2315f3f46ed6030b0f5b2b18aeb51a,987441,2020-09-28 02:24:34 UTC,946639817,946637733,false,2084,987429
7fe683178adf7f98e870b1301702a734d57a8d8bcef46b26136f9657a3e235e9,987441,2020-09-28 02:24:34 UTC,862137854,862135770,false,2084,987430
4570a3afcafb9246f04902f0a1ee2ecdad00d27f76bc0c8f8d807e8d610ad200,987441,2020-09-28 02:24:34 UTC,57573798014,57573795921,false,2093,987429
b15a5bfaac80ff212f3722066a5097cf8303d6d42f87f63bf312855dbbd14d74,987441,2020-09-28 02:24:34 UTC,882163970,882161886,false,2084,987430
d397fb8f82678a53a1536476a50ea0276b9a8607d697cf7e1c468fb509568f9a,987441,2020-09-28 02:24:34 UTC,1086229269,1086227176,false,2093,987428
4cb1269b42e88dc116e60c3b9386474bf308756225efc48f9c5a3886664117f6,987441,2020-09-28 02:24:34 UTC,930495061,930492977,false,2084,987429
5fad4c0a10269ba2d3d340e159f112b204137c765e63690b834e79793c4b693c,987440,2020-09-28 02:23:46 UTC,1142686171,1142684087,false,2084,987428
a8d686f31cb7c985b9bfb288e4d75d5c6ae1990adfc2adaee704da4a0b019419,987440,2020-09-28 02:23:46 UTC,1105300922,1105298829,false,2093,987428
7b1fac2d0daadbf90b961558107e87321f7668bd4d89d04cfd6a1b612e9ba2d9,987440,2020-09-28 02:23:46 UTC,1146488146,1146486062,false,2084,987428
bd401bfe20e16e3cd4010a95a0c62c70ebc061189e8da0fbda307a974c52f94b,987440,2020-09-28 02:23:46 UTC,1158100442,1158098349,false,2093,987428
8747c8a1586708bbc530bc0a805594c8f54427a47514032d46828f5c405b42c9,987440,2020-09-28 02:23:46 UTC,1150421524,1150419431,false,2093,987394
92d8aa44feef5cb49559b3cc58890fc700aba0a374deaf3d6567e2c68c15bf93,987440,2020-09-28 02:23:46 UTC,1154216882,1154214789,false,2093,987428
32fbfc13c10c08d973a0a245e72e1ee1e602ef6172dd1dd26b1ec7bbcd9478be,987440,2020-09-28 02:23:46 UTC,1161865513,1161863420,false,2093,987428
ea61ec59dd5c610a8df8d8ff1ff9d4b9721b520a62174381e2d517bee06d62bc,987440,2020-09-28 02:23:46 UTC,1180856903,1180854810,false,2093,987427
b522e75978621f139982a3779c871b2fec4629ca73ac138bb95f0461277d2c67,987439,2020-09-28 02:23:25 UTC,10000,,false,10000,0
4aa27133a3117b90a6c9e0f9057f82734724f156dbe8b0c71542cbab929700a3,987439,2020-09-28 02:23:25 UTC,8777692266,8777690173,false,2093,987427
74f7c16b9f4e1a5b61de6cdbc33af6dff81d7c0c02e40b4260c2a145d224cca7,987439,2020-09-28 02:23:25 UTC,8949528572,8949526488,false,2084,987427
cf2eb27a93b0eb43a91d4b599ac6a6e09cf60a2b733a3837a79e6998d0fe6951,987439,2020-09-28 02:23:25 UTC,57592679172,57592677088,false,2084,987427
a10a5b29687af584b0dcc4806e223a9f4870b612d865d27728ecff35e52e92aa,987438,2020-09-28 02:23:11 UTC,1206552789,1206550696,false,2093,987426
5b854fd392e5fb78e87f45e538b38dbe8404f7f71a706a9c94c3355012fd5793,987438,2020-09-28 02:23:11 UTC,1210354683,1210352590,false,2093,987426
65703ea94d617b18d9bf2e2e4076ddcc7f423569664a6d111b4653f57a236aac,987438,2020-09-28 02:23:11 UTC,1198907466,1198905373,false,2093,987426
5ca292b1a904ea1556e5c3986d20179ddb65e92e4ba73671225c6cb9652afcab,987438,2020-09-28 02:23:11 UTC,1202693267,1202691174,false,2093,987426
4b893b24adb978c9ee52cefe7c4781f54d23f39bd41492192934904d866ee44b,987437,2020-09-28 02:23:01 UTC,2084996476,2084994383,false,2093,987425
ba4b9e2598e67f1045f092ff60120a3639fe73c6829a27698253929354b124f2,987437,2020-09-28 02:23:01 UTC,2021313103,2021311010,false,2093,987426
33a29441a73d6ba1e4240fce4cc960660bb1a0067caf3f32706561c892ec3a65,987437,2020-09-28 02:23:01 UTC,1571714433,1571712340,false,2093,987407
51ad07088dacd73715a7f782b8dd8941fc8cbbc802fb020db300e9d0771daaa7,987437,2020-09-28 02:23:01 UTC,1615796108,1615794024,false,2084,987426
b084d51b814eea71bfea61453e2f40b4be129ac28d3f80ca25ce6d469cb4ccf7,987437,2020-09-28 02:23:01 UTC,2134133562,2134131469,false,2093,987425
68ee1a4885b2d68ace1a70f79a99333998040a158736577fe8e9a6bc59e217f1,987437,2020-09-28 02:23:01 UTC,1604303323,1604301230,false,2093,987426
28623908f22fcc28c487b5069cdb55b603155faff16cde9525889fabf2e7f69e,987437,2020-09-28 02:23:01 UTC,1319342432,1319339759,false,2673,987419
35122f81e161dbdfdc51e0b5b0b91178fa1cec9965717656628e6097d1ae38e1,987437,2020-09-28 02:23:01 UTC,1323265598,1323263505,false,2093,987426
5da83f234ba0e428880cf249384211b9cfc42a2ecc388b125b6f3f950400eaa2,987437,2020-09-28 02:23:01 UTC,96815222,96806679,false,8543,0
ac6af42295309da88fa49ea5d7aa24ed55ec3a9b42a28b0b26674bebfa97dce1,987437,2020-09-28 02:23:01 UTC,2171783518,2171781425,false,2093,987425
684bd1c2470482e548de07e5d520b63b6aa981f41ef5fa40613e47ee960a400c,987437,2020-09-28 02:23:01 UTC,2017477976,2017475883,false,2093,987426
a85406dc512bf1bbcfb851d88d97dcaa4bb1c73cd6e9619c171362542e5e59e2,987437,2020-09-28 02:23:01 UTC,1338589575,1338587482,false,2093,987426
59c0f9613d9b2a82a68266378cac69698b7e4ee15edafc1d585911e8985a53c2,987437,2020-09-28 02:23:01 UTC,2130350347,2130348254,false,2093,987425
21a8e32bd66d918cd36869493c2e0b143eb2bdf41cf827ab6892850e8b42101f,987437,2020-09-28 02:23:01 UTC,96731653,96723110,false,8543,0
134f048ca8fc8107d126ae87d2faee58fd92647580e4fc3a1a571b3ba7938a83,987437,2020-09-28 02:23:01 UTC,2243300661,2243298568,false,2093,987425
56e6407ce3db45691b29df3fbebccdb7e2c091f16f5307a60684a44833668f06,987437,2020-09-28 02:23:01 UTC,1233316599,1233314506,false,2093,987426
b4ba8844ec52b6b59664f42fb28f92b6e8d5fb01c77bfe7e2e9472574a687360,987437,2020-09-28 02:23:01 UTC,2235467561,2235465468,false,2093,987425
e5c7abdae12b415a5849fda15915f9afdec41592718cda2c3fd88ede4f102f59,987437,2020-09-28 02:23:01 UTC,2061543922,2061541829,false,2093,987425
ef0c55521250471c1c18a4ec0f3f29c5c37003fed4f6d20a697592e17db54337,987437,2020-09-28 02:23:01 UTC,2239337416,2239335332,false,2084,987425
a945ff387d57aecee041777429dd1c5b9bac9b5ba8488a7a8364ccfb0043bde5,987437,2020-09-28 02:23:01 UTC,1612032115,1612030022,false,2093,987426
7eb7a54b7f085689f50e9872f557a7e4caa3b43eea98b359e9aa20527b7401e5,987437,2020-09-28 02:23:01 UTC,1551036375,1551034291,false,2084,987426
780c15b9c61cecd07e300308216cf96e6c791e0ac3a8be0e4ee1231dbcbc554b,987437,2020-09-28 02:23:01 UTC,219802936,219792936,false,10000,0
b4a5652cd718726b6e978515b331cbcf766784711f32909ae06662d01e309ade,987437,2020-09-28 02:23:01 UTC,1237116233,1237114140,false,2093,987426
cf3921a3b9d0ec24a02280207894bd9c6d242397854fa93afce563577bc1798f,987437,2020-09-28 02:23:01 UTC,1583125235,1583123142,false,2093,987426
ab165eec2645c057819ab98ad5edb08948ee48634bcae6904c2633b95d368d78,987437,2020-09-28 02:23:01 UTC,1567875378,1567873285,false,2093,987426
be665a81607e5a10f03e4c771c12f94c2dfd5c82b9697642392acaf425266f7e,987437,2020-09-28 02:23:01 UTC,8781577051,8781574958,false,2093,987426
d83c0d9fd4fa3377a97913579ab0efd4d994d8b52ba2fd3a9b423c5ccd0f1426,987437,2020-09-28 02:23:01 UTC,1225653159,1225651075,false,2084,987392
14243f3f4c7c9d02e9b6208c732c3ad5537802e152c180b441e8f0d26388b2d9,987437,2020-09-28 02:23:01 UTC,1221841297,1221839213,false,2084,987426
21f66122a7d79121065dd241d673c0965df5311256ebcde465f20eabf58e3b88,987437,2020-09-28 02:23:01 UTC,2194231866,2194229773,false,2093,987425
6f6627daf40cb71233bcb9fa8cbe7286b1c55c13e5b05712523a7aae475006d0,987437,2020-09-28 02:23:01 UTC,1342568932,1342566839,false,2093,987426
44fc72003a9876b15f383a58f9d339c8ea9fd54f0cd36caf27dce9907c89e458,987437,2020-09-28 02:23:01 UTC,263561162311,263560162311,false,1000000,0
d2b9e02770b1260ff025dcbb1bb6b7a5f3bb6de0980c479b5989ba3585712113,987437,2020-09-28 02:23:01 UTC,1240851460,1240849367,false,2093,987426
7236e52e8f97b6dd813976b436f1baa584f379857ae4aa02db7851ed5fa88dbd,987437,2020-09-28 02:23:01 UTC,2122654432,2122652348,false,2084,987425
5ddcfd615b3687436423fe51b7f98b8c300e25b711ea2ad393a9382bd42f7ae9,987437,2020-09-28 02:23:01 UTC,1229517408,1229515315,false,2093,987335
4e0bc2135f9f5279aa62dd11bd1f22ba9b1bad10bdeda7fcbf2cbe4e18838bf0,987437,2020-09-28 02:23:01 UTC,2231576542,2231574449,false,2093,987425
2d181d6785ff0e35eb6715ef4edec099d41fe3a7f9577d233ab3280177dd4b83,987437,2020-09-28 02:23:01 UTC,2175691700,2175689607,false,2093,987425
deb29d4ab14371bd526e5d229571157cfd8bb167559e45b53535c8264b9e0ae5,987437,2020-09-28 02:23:01 UTC,1587020061,1587017968,false,2093,987426
69308f74aad7b3a708d4483f429713ea6855df9d37d9a706f3cfaa9d4d8f334d,987437,2020-09-28 02:23:01 UTC,1975717512,1975707304,false,10208,987426
0b4c0648140686a8a91af64710806a6ca83bab9fc291364d11a55a958046c24c,987437,2020-09-28 02:23:01 UTC,57596574843,57596572750,false,2093,987426
ba71a1f595a0b970fc8dc4fe6619599181c9336e7d9d8e074dc907eff619b2a6,987437,2020-09-28 02:23:01 UTC,1218046007,1218043914,false,2093,987426
393bd286c98ac7a02f21d57cca500c647c19c04f909a02d1de4f53e73f7a416c,987437,2020-09-28 02:23:01 UTC,1327099982,1327097889,false,2093,987426
b84d4821fcd882e972e7b412fe8a3d3e89f0f845d70e6850edda2c5aa1c0eed2,987437,2020-09-28 02:23:01 UTC,2126569802,2126567709,false,2093,987425
403570b4162c092e8ac8b98a47924f24af2b89275e8e10137005a823d83f8544,987437,2020-09-28 02:23:01 UTC,1575545255,1575543162,false,2093,987426
aa1855d7487fa82986b0469bc4f027de66ae547a74ae886ff3bf2c4f80123b14,987437,2020-09-28 02:23:01 UTC,23171208,23168248,false,2960,0
55a37cecd5e55a171a426f0da3fd58521e7c9fd56b872e6afa7b1ccc191d2d27,987437,2020-09-28 02:23:01 UTC,1547147758,1547145674,false,2084,987392
79c8e2c047b28f7ff37da67fdd61bad189cd58f3e7e82dd87944dd1bbb5ca692,987437,2020-09-28 02:23:01 UTC,10000,,false,10000,0
2a34813abdfb7a7fa3f2713d794af9004fed18c880f1532b60775ea7e8ade47b,987437,2020-09-28 02:23:01 UTC,8953393263,8953391170,false,2093,987426
a21dff2abab00b2fe2467a74986f0f9ed0fc5deaf8b38b686da3cf0e8b3e5f4c,987437,2020-09-28 02:23:01 UTC,2025110324,2025108240,false,2084,987426
cb80843796aa40792397b533fc53c1cd0bd7ba0b9b280e3cd1777e4c96707bda,987437,2020-09-28 02:23:01 UTC,1979567496,1979565403,false,2093,987426
99cd6d4603fbae11cccddec02bc29a508250bed3b85861ac7e839367e71ec282,987437,2020-09-28 02:23:01 UTC,2065416160,2065414067,false,2093,987425
6fbf4662c04650bd5768ffdfb8b1888aca418436557ea8c488c9562d0d28b561,987437,2020-09-28 02:23:01 UTC,1334767748,1334765664,false,2084,987426
c706e87aea54132ea15bb0ecaf1b057460a053c290204e74535dd174ac6360fd,987437,2020-09-28 02:23:01 UTC,1608188297,1608186204,false,2093,987426
2e429cd1fe3e5cfaa5c903a5fa23b669913f1ea6b8ae4ccdafca38f5a8dd2ec9,987437,2020-09-28 02:23:01 UTC,1579352727,1579350643,false,2084,987426
18d9bb35dc2831f30c40b147fab598dcecc79bbc3a93d3a1e5c9ebb0c75bb98b,987437,2020-09-28 02:23:01 UTC,1528166028,1528163944,false,2084,987426
f1c5658584b4d60e55330cad99dc304b7d8590aefa3dd8fe9374f863c8ef3409,987437,2020-09-28 02:23:01 UTC,1330944141,1330942048,false,2093,987426
2fe238269d547e576a7cc9e667344fc43c1daa548eb5c64cbc31e52ea6d134f0,987437,2020-09-28 02:23:01 UTC,1214213081,1214210988,false,2093,987426
ff52b61034a86a76eeafeb6e93237d955c802a4f0766fafec94e20f9857b8428,987436,2020-09-28 02:20:50 UTC,57618114050,57618113805,false,245,987424
894a89bce0a7e76564f8b285c6dbd60fb1f3f6df5df770ce1f16015769a6e10f,987436,2020-09-28 02:20:50 UTC,8957278101,8957277857,false,244,987424
74ee1f8ad31e90db3595e21f0856436b52b3121d4632cf725d43e5795446de20,987436,2020-09-28 02:20:50 UTC,2272812823,2272810730,false,2093,987425
81791c7ff6217dfa0dc929cd92ef4a13fd0dd8dd14c2c5cad5dd221998edd8fa,987436,2020-09-28 02:20:50 UTC,2251075889,2251073796,false,2093,987425
f0fbde7711a6dc3ab12644775e0814f828f616757e38aad8b0d8027636da4653,987436,2020-09-28 02:20:50 UTC,2254851786,2254849702,false,2084,987425
db29fddae2dd9e9e4b0a2c2587be515ad442d7fddd59862c642a9d12208ee8ed,987436,2020-09-28 02:20:50 UTC,2276562979,2276562734,false,245,987424
e39d50d339a9095985e166f353adc699c3d4b7ed3d01cf0fa56cf1205b5b1edf,987436,2020-09-28 02:20:50 UTC,2247137227,2247135134,false,2093,987425
39f08e370baa65870e5cc5e8bdb6bbd07bfcd8bb751ea2cf77f96ba1aab51dc3,987436,2020-09-28 02:20:50 UTC,8800639321,8800639076,false,245,987424
d9d05524429f56e0db0fd127e7abeacf66fe9fe9d947fe803c247f3253f828c2,987435,2020-09-28 02:20:28 UTC,2329465085,2329464840,false,245,987423
09268993658dc44cebeef0521f3202862d9474c34dc2125d0c3089f56383bd20,987435,2020-09-28 02:20:28 UTC,3146952,3141732,false,5220,0
ae9793abb8a20bc6cf5926928673f00949748ba5944642d9b9316f4bb8e0e3dc,987435,2020-09-28 02:20:28 UTC,2619106941,2619106696,false,245,987423
f834fd78e535148e5f0a1e3b3fb2d1307bd17e42f2f9929cd67ee28acf220dea,987435,2020-09-28 02:20:28 UTC,2295577594,2295577349,false,245,987392
69bc6958ed434787e96702bca71a326ef028a8cc140d20026fb7c07f2c0cd68f,987435,2020-09-28 02:20:28 UTC,2536204915,2536204671,false,244,987423
a5eef683146ab3702b573944aad972b61a43823d9efa70a2d08b33dd2b48dd5d,987435,2020-09-28 02:20:28 UTC,227522413,227519453,false,2960,0
cf2d986c12bcad490d777611c0aed3c4d081a34922f9e7f714b5c015c62f5152,987435,2020-09-28 02:20:28 UTC,2710216224,2710215980,false,244,987423
5186ff84e6cb57e01468d423246e110d5defa0a7e14bec9bf577ed6a9b7a85f9,987435,2020-09-28 02:20:28 UTC,96995202,96994926,false,276,0
1ad0c9f21b7539135adccc2af9ee41b2f9c434381aa9ee2ba6a9421ec98fd38a,987435,2020-09-28 02:20:28 UTC,2581241208,2581240963,false,245,987423
bf534427fed54bf2478476b23e1c95e8989b740a0aaa620c9a7524952ba15007,987435,2020-09-28 02:20:28 UTC,2496311893,2496311648,false,245,987423
0531a121f43c92e8547de7b26a908e4966fd300d99cce3fd87600538bc218754,987435,2020-09-28 02:20:28 UTC,2492486851,2492486606,false,245,987391
562c82003e019322c2a371141a51f7674cb3cb0413886384c502c5401d53a8f7,987435,2020-09-28 02:20:28 UTC,2500174765,2500174520,false,245,987423
29d53fd73df73a2ce4c71f5334e30ff5f839fc1a9eb40f631dab3c7a8fe68d3b,987435,2020-09-28 02:20:28 UTC,2303254213,2303253968,false,245,987423
691c57c4f8c28823c1f6ea32420b10e7480cca770f07e096d1a4ae6271baf3d5,987435,2020-09-28 02:20:28 UTC,2386181258,2386181013,false,245,987423
ec61cb69ce8deed50ffcc5fa0c3cabfa745cc9f187de7c73f82238038328b7cf,987435,2020-09-28 02:20:28 UTC,2409855713,2409855468,false,245,987423
344231463b1f7a9eee76b3dc47d80c6a7ad7d2fc93102ed9d29a048321bc56fc,987435,2020-09-28 02:20:28 UTC,2755712392,2755712147,false,245,987423
e4804e91a4b808c390b2a02a25637536be20f8f4e5bb205b8e9038c08d0ea6b0,987435,2020-09-28 02:20:28 UTC,2417495977,2417495733,false,244,987423
05dd889a0f453d5f9259518f85f0ac927235f3bad45a097faf8f22cdcae5851a,987435,2020-09-28 02:20:28 UTC,115419798,115413743,false,6055,987423
4899222c22494955630f329a3e545e8a0e32a2db6852b76a34759baab32be1ac,987435,2020-09-28 02:20:28 UTC,23240815,23238787,false,2028,0
2bdf60769d802380ea724b1bb1f42826686cdfc831cad9d383d7e52ac31427c6,987435,2020-09-28 02:20:28 UTC,5130420983,5130418723,false,2260,0
f4c99873a000e64b79e83095a1fa2bc8d7009cebae6e07c46a912c9b03900123,987435,2020-09-28 02:20:28 UTC,2577465221,2577464976,false,245,987423
c7d5bac9110a688687728ecee7f9eb7032eb5f2237464b7b28fa0084768dbf6b,987435,2020-09-28 02:20:28 UTC,2660739173,2660738928,false,245,987423
b349261dcecad83d97a035dbca1053719079409ab97646b6ebb00fb3ce4ef062,987435,2020-09-28 02:20:28 UTC,10000,,false,10000,0
f198dce277166cd9269a2e84e83cb8695713389e8cf2a6867528ae9eac225936,987435,2020-09-28 02:20:28 UTC,2321806009,2321805764,false,245,987423
5299aae4ada4db518a468ad21a5e5e8266a946a14c3d5ba26cb93d1be95b78c8,987435,2020-09-28 02:20:28 UTC,2706336611,2706336367,false,244,987423
76e2ad40265b0e1df0cab9c27b28278f85e4754cc694460c21b4600f32f699a6,987435,2020-09-28 02:20:28 UTC,102097773,102095626,false,2147,987423
3f8e5e8e816d700a4e81e70ba91b972aa56a2b49a9c3de90abead7fecf68d375,987435,2020-09-28 02:20:28 UTC,2454687907,2454687662,false,245,987423
3d5c8ca9fa755d1954e9cfbfdcb9f2801b0e4c0cbbccfc2ba1fe9a96620e0262,987435,2020-09-28 02:20:28 UTC,2366717756,2366717511,false,245,987423
bcbf2c05e4b63475d0eb3b41c53885182167924778f46b4c72f77bf77facdf98,987435,2020-09-28 02:20:28 UTC,2751866088,2751865843,false,245,987423
d763c2c5131cc07f1aa7ee664f26d57b135a37de35b7f984c8a1a97ae65519f6,987435,2020-09-28 02:20:28 UTC,2413666521,2413666276,false,245,987423
9534247dfada05cd775dd05f5f497a73be6d731152d18df877705e9ae20d85ae,987435,2020-09-28 02:20:28 UTC,2573689512,2573689267,false,245,987423
0e8d0d774c61f439d95c49485085b67f8c04a77f688f7b378ba2be9a31212e19,987435,2020-09-28 02:20:28 UTC,2389900767,2389900522,false,245,987423
6476b1ce144bd183b0a5398b7b817e01434bd7f31929ab792973e2266c11b330,987435,2020-09-28 02:20:28 UTC,2325629590,2325629346,false,244,987423
68e34ca5451857930c22e106804ace8a246c8068b6f6cc49cb8c2ef481183cd8,987435,2020-09-28 02:20:28 UTC,2813238499,2813238254,false,245,987423
051b13932f898569976b8689e2ad6ade1cbb83580938ea0bd8c324be8e62af08,987435,2020-09-28 02:20:28 UTC,39993739,39991289,false,2450,0
16881c5d88f33d35162b5cdb09cecc5b1701b13d8b259252c692214f3cb464b3,987435,2020-09-28 02:20:28 UTC,2775322719,2775322474,false,245,987423
88112bf8fa5bf810e366a1e2b707f0ffcb1d20a220e3ebea7f3234b647e6fdd8,987435,2020-09-28 02:20:28 UTC,2817149228,2817148983,false,245,987423
afa36d6ffb203748a08195df825824db048769817b95640b86366991e9aa1d29,987435,2020-09-28 02:20:28 UTC,2702430437,2702430192,false,245,987423
748e6dd57e6f7ddb8b57ffdd4b1ded4e38cadc04cc70a8802976bc4153f74080,987435,2020-09-28 02:20:28 UTC,2664471741,2664471496,false,245,987423
d368241e727e250d6822f1a5c3efeb9e51a7bc3bbf2552603c166dd3c785c7a4,987435,2020-09-28 02:20:28 UTC,2747979262,2747979017,false,245,987352
6f2bc30562672df23e193aa906ce77eb13e61d3dddfd33ecf5e435757ccbea77,987435,2020-09-28 02:20:28 UTC,2656925284,2656925039,false,245,987423
04c46ebb74337c36d085283798a9b13157bc8a74e4917a2a185cdf6c638e1eb6,987435,2020-09-28 02:20:28 UTC,2299342593,2299342348,false,245,987422
047168c7fdbad0b7050e35ffc650450f343e99103a5c8d8087cc6486e031f942,987434,2020-09-28 02:19:05 UTC,2898117068,2898116823,false,245,987423
9625927f5793864d73cb6332a9b9273c825a4c28f217de6c23004ec03e1f2a94,987434,2020-09-28 02:19:05 UTC,2955625049,2955624805,false,244,987423
75dc4fffc15616304e7a389365a84fcfdc7d18af2955793fa873e1af14312464,987434,2020-09-28 02:19:05 UTC,3291211048,3291210803,false,245,987423
74f6a9d6f4e63042b25467597bba7e86e8fee027d4836e94935b8edad0fa140d,987434,2020-09-28 02:19:05 UTC,3295020637,3295020392,false,245,987423
3f1b78a565972793b1688ec209551c1ba21f6182d008af1a5d3f08c5ea414424,987434,2020-09-28 02:19:05 UTC,8838500199,8838499954,false,245,987423
8aec73e0eade32da118bf5c7c4e8c49a9fc827d341a13ef7a7d8d72eb0d742c0,987434,2020-09-28 02:19:05 UTC,2875249810,2875249566,false,244,987423
ce8ee7088d109f8392133ced44fe07c0fcef2b321ab46278ed3260ce3eac6928,987434,2020-09-28 02:19:05 UTC,3283608091,3283607846,false,245,987423
bec793e740ef409e137097b6e54088507d85bc598f44d1a2e7e938729f2c841f,987434,2020-09-28 02:19:05 UTC,2833772589,2833772344,false,245,987423
14d2014ca8d0c8582f9a1918011ee747226c0b1497f98b03bde09f819c9dc3ad,987434,2020-09-28 02:19:05 UTC,3242263480,3242263236,false,244,987379
f7167b6fcc243a7d328b8e34c82cda75066ce1456548e4583e24e105cddc798a,987434,2020-09-28 02:19:05 UTC,2939486475,2939486230,false,245,987423
cd6d030313aa5f4f687d107c98a9e188fbfb1f6bf702c72b9575bf766117fd8d,987434,2020-09-28 02:19:05 UTC,3015670263,3015670018,false,245,987423
2cf1d720cf21f0e4a5947d370f2c2c164b8414a08592d5f93bc9f74d50e1795a,987434,2020-09-28 02:19:05 UTC,3011929042,3011928798,false,244,987423
e741e5489c40e63c704ec695107c9d1131565b771ce7d57bd6c0b89017b1e5d5,987434,2020-09-28 02:19:05 UTC,2890504291,2890504046,false,245,987423
787484652b33292be0b14fb13d1cc2d650cacb254d39e09b4fbd942148a9df2d,987434,2020-09-28 02:19:05 UTC,8961117400,8961117156,false,244,987423
37f291fb987bdd424083b287a81c1615e8d5b560d541c22563d9b84179491156,987434,2020-09-28 02:19:05 UTC,2894271701,2894271456,false,245,987423
a598bfb87acddca870cabc0ebb9d997545f6b4d932c297cf9de220cbdb9a9ff9,987434,2020-09-28 02:19:05 UTC,2974170557,2974170312,false,245,987423
0f9e0918d9ec5ff63da7d1bcadfd47c50fae23cf74e75c468ba810d511c062b6,987434,2020-09-28 02:19:05 UTC,2871484962,2871484718,false,244,987423
8fc6394b97c979af7e3cb1b6a63d0eddea2910cdab6e64e4e1ebb5eeaf27c218,987434,2020-09-28 02:19:05 UTC,3287405841,3287405597,false,244,987423
275695a9fff14f96cf66092e90d6dabf24847142490647bfa48c453caf4364b1,987434,2020-09-28 02:19:05 UTC,3246073997,3246073753,false,244,987423
848f9aa81f89759a606a479bdf725652b389925e3b74d915b21fde76fc9d6248,987434,2020-09-28 02:19:05 UTC,2882800504,2882800259,false,245,987423
b27d020ae4bd1901e708ed0d705a611356e64780a7d4c086493aa19ddeff84f1,987434,2020-09-28 02:19:05 UTC,500010000,500000000,false,10000,0
5e7430a597758ff74be07ab4c4fb428547c7df93bf3144c81cc350a258adbd35,987434,2020-09-28 02:19:05 UTC,2886609657,2886609412,false,245,987423
89188e4035f4f9a24456a946e5e1f29af62af9bb926c441f234e5a2ad9f71909,987434,2020-09-28 02:19:05 UTC,57622066739,57622066494,false,245,987423
3a4822b43c53cf125dc2909689549870e8ef87bf3923977b6a0fbbdb19e8392b,987434,2020-09-28 02:19:05 UTC,2879041779,2879041534,false,245,987376
29491d2f07fb16deb7e6acb6ac446ad400e1d7f757f44e2e901f95e45c9a3fee,987434,2020-09-28 02:19:05 UTC,3054463024,3054462779,false,245,987423
c1dcbb55b6ce4f8da7cf3f0ef756d7a7f2d893f820db75f0a0d5c4c4256fb20e,987433,2020-09-28 02:17:09 UTC,23327633,23324673,false,2960,0
b2dea3a200e235a21f4e5c4ecfd88948a87b66cf1dda8d02ea33d7cfeb018acf,987431,2020-09-28 02:15:45 UTC,78878053623,78878050095,false,3528,987418
63e29ae562be23bf87c9792c7e0920e76436c9eedbb5e053c29b024115e2be1e,987431,2020-09-28 02:15:45 UTC,449056309135,449056195027,false,114108,987418
bdafdd12bbe78bdfa21a4e1aede4a7d1b612a9fae9ce9457b9de955c9a7b765b,987430,2020-09-28 02:15:16 UTC,10000,,false,10000,0
ff71a9a3f9555a8b2cd51d30db4b2e81745f23f06e24f26a7e4c674862ee57a6,987430,2020-09-28 02:15:16 UTC,66709854041,66709705291,false,148750,987418
df49dd0ecca45b17f763ce7daa2f27b78b96762587a4b28d66d31d3a4a98ce1a,987430,2020-09-28 02:15:16 UTC,3350033647,3350031554,false,2093,987418
360a1495fef5bc86946aeeff295833e1e0c9bbe0e47ce6aeb22428fd1572e672,987430,2020-09-28 02:15:16 UTC,97220261,97211718,false,8543,0
65b222109ef6375cb6a6badf694382ba7ff3fb85ec6ed1be9a7e9b3c168b490e,987430,2020-09-28 02:15:16 UTC,3310512009,3310509916,false,2093,987418
3af8dec8175fdcd9079614678731531f39e67813582def6ec33fd238f2bf78a1,987430,2020-09-28 02:15:16 UTC,3302862860,3302860767,false,2093,987404
3772ad844b0cfd7b9a03c26e2602064a8e55cf8d8984992842d33289eb9d452b,987430,2020-09-28 02:15:16 UTC,3298903926,3298901842,false,2084,987418
2cfb217188c6d25a8c364704dab3f5604010a14ab4934ac5c0790c5d4f73c19d,987430,2020-09-28 02:15:16 UTC,3306642644,3306640560,false,2084,987418
6063929b38a835ec1803d55a6963afe7fdbb5eb2f30846d8f33cc58f4f643a98,987429,2020-09-28 02:15:00 UTC,3607975321,3607973237,false,2084,987418
21c199dcea91972c76330d3822c423f32b6c68eaeeb0ee59500892065e50015d,987429,2020-09-28 02:15:00 UTC,6814485266,6814483173,false,2093,987418
b3fc885c871ab753451085141155ca2728eff1b861a41be2256102909ea62c1a,987429,2020-09-28 02:15:00 UTC,57625892027,57625889943,false,2084,987417
c7ab35cc87e217c0c1e3c682bafc6a76c1a28b59645313c5dacf3eeb92a81309,987429,2020-09-28 02:15:00 UTC,3879341090,3879338997,false,2093,987418
73b3c7c9d31f0b36e3042d008c4009ea2c062414e59ec2ca2ca4cd9df6363833,987429,2020-09-28 02:15:00 UTC,4013529066,4013526973,false,2093,987418
1088d76c6548ceeb34a570a171e4f542654b60f77410374b3631d6415ef8eef7,987429,2020-09-28 02:15:00 UTC,3875467630,3875465546,false,2084,987418
d9925827b7092f13e1ab6c0b2b579a2e47cb613c23056bd0b4baba9662aa61da,987429,2020-09-28 02:15:00 UTC,3629852432,3629849468,false,2964,987418
dfffa767452f9ed06026695f976fe00b29d639db84e2ce105f70a806a29e5293,987429,2020-09-28 02:15:00 UTC,6795301514,6795270768,false,30746,987418
fa98493cd9f071fa670cc9656ff2da0242ce19730e921c6c457ac3d185784357,987429,2020-09-28 02:15:00 UTC,227696790,227693830,false,2960,0
e346b6282e6dbab352165ff20dba318dd2200e199c01d24e65f360a920953f97,987429,2020-09-28 02:15:00 UTC,6860173916,6860171823,false,2093,987418
6934c2c45bfe57f311644cb33142ff413d96886a5eee4486f5af26d8041b2d8f,987429,2020-09-28 02:15:00 UTC,3648032474,3648030381,false,2093,987418
574661c986d408d185bfa652d39a3893baa14c8f0ac8cac4b1793aacbd622035,987429,2020-09-28 02:15:00 UTC,4017416191,4017414098,false,2093,987418
7b3f673b26ec3ffbcae589b4c73696e6e047a665b5ee076cfeccd27c80ae851d,987429,2020-09-28 02:15:00 UTC,3503085035,3503082942,false,2093,987418
d40f4744493fb89ca65ff27a524041b2b00902a40e94639d0da00ad8ae7a4ce7,987429,2020-09-28 02:15:00 UTC,6803019188,6803017095,false,2093,987418
f319cd1a6e5584033818971fe5c7b6f29ea8d5333ee6695b3d418f8acbdb1e80,987429,2020-09-28 02:15:00 UTC,3460673988,3460671895,false,2093,987418
5b80441020a1590cc223180bc1b0e0e4244d6b28ef4b413a637cbafbed9c8167,987429,2020-09-28 02:15:00 UTC,3994889370,3994885825,false,3545,987343
ce780766a9072ce6191ae6fd5def98340a132a79b6fe0de9bc3545cf7bd15e4b,987429,2020-09-28 02:15:00 UTC,3604226506,3604224422,false,2084,987418
e57620ff4d618513bbcccd7b07318b79be510687d184aa36e5e0f81ee66216f5,987429,2020-09-28 02:15:00 UTC,6852497687,6852495603,false,2084,987418
775642ec50b500a719fc93ef76880ee2915a4f1effd379913a14da4ddc5b911b,987429,2020-09-28 02:15:00 UTC,6867789412,6867787328,false,2084,987327
ebb5d25386801312577779859fa6cb47bfbb52d59a7840cce94e17650fd37d9f,987429,2020-09-28 02:15:00 UTC,6806897037,6806894944,false,2093,987418
8b0a9bbb092e5242a716f2a3a499e5c91495c7247357510d8b66238dd9ea57d2,987429,2020-09-28 02:15:00 UTC,3422947695,3422945602,false,2093,987418
bfcd6d25957a97dd48b0b438490458bbfb5e08c619a737d6ff9b5f9fe15d84c8,987429,2020-09-28 02:15:00 UTC,4021177695,4021175602,false,2093,987418
aabe13308134a9517c91e3c10f1185d552be0e9fb19d7f5b692acc1ed3ebab90,987429,2020-09-28 02:15:00 UTC,3510751971,3510749878,false,2093,987418
87cf5b8dfdc0a848e6920b5035bc47fc31bffbedd20f498cc380783b1ef7429c,987429,2020-09-28 02:15:00 UTC,3415244636,3415242543,false,2093,987418
7feb8083e3c735a29d22a7716dac9a88b37d8167943ec79e1c2240ea5277fef0,987429,2020-09-28 02:15:00 UTC,3411337061,3411334968,false,2093,987418
1cb1305febdf01f672e795797a78a5a23b27e10e160acc7436bcbcd68e2d1919,987429,2020-09-28 02:15:00 UTC,3837779239,3837777146,false,2093,987418
a0c9f65fb2beaeb9d8932b0c40000d1cd2fde55ff0c08b0b996b2f569b7f7736,987429,2020-09-28 02:15:00 UTC,6856350867,6856348783,false,2084,987418
fd75d74b9553ce8072ac14ad8965edfe4c1ef4c23524c5144c9a9adee8e88c3c,987429,2020-09-28 02:15:00 UTC,3883239122,3883237029,false,2093,987418
17fd627bb33a83243110c65e4faa35f418b8a763de0b78aa9adb387b852da3b2,987429,2020-09-28 02:15:00 UTC,3506908618,3506906525,false,2093,987418
2afa578abf0a570f61bb7daacceaac00fb8002c53c00b45ea57f7c0bb3b9d75d,987429,2020-09-28 02:15:00 UTC,3833860190,3833858097,false,2093,987418
66b46c2208946027481e2db526402240605563f51dd4f3dbd519b0806e099bd7,987429,2020-09-28 02:15:00 UTC,3566430725,3566428060,false,2665,987418
2cdeecb78b673644cd3d5e800d07a19077778cd33bb85dfce0ea40cd26d35b6b,987429,2020-09-28 02:15:00 UTC,6863983461,6863981368,false,2093,987418
8d3a9a1c6c9c8bbac4d3ab75e8a05d95c8b98fd50d854cde27b3fe6a3cf74bf2,987429,2020-09-28 02:15:00 UTC,6810648663,6810646570,false,2093,987418
553f7a6d3afe9e77161b2a71a4a3ab84b4268346d002e3e61543f3c6967f4d66,987429,2020-09-28 02:15:00 UTC,8979868931,8979866838,false,2093,987417
aa27893497179851edf6054575978d4612a6af0e8c0602bebe55ec5d1b28fcba,987429,2020-09-28 02:15:00 UTC,37843997836,37843996254,false,1582,0
b2281ff4c4cdbb8aff8e1c18591427f44e0804c16e968c56f97afe6be5f1845f,987429,2020-09-28 02:15:00 UTC,3464581354,3464579261,false,2093,987418
a20445c08e899601d132c263bcdcf650056438c2d254a36d90ee8c63e1b420c2,987429,2020-09-28 02:15:00 UTC,3369690327,3369688243,false,2084,987418
5fac4285c78b56b31cdc7e53bb89d86074669eb3474f2a762e4aa19d5c083d81,987429,2020-09-28 02:15:00 UTC,3611838758,3611836665,false,2093,987418
39d6669e2e166a9e1cfe3766f77a58fce460bfb7a247d0722cb02d274b1a122e,987429,2020-09-28 02:15:00 UTC,3373473923,3373471830,false,2093,987334
638779ade6746fe7112e7099f9655187114748dd7981ea775124b92190525ec0,987429,2020-09-28 02:15:00 UTC,6799157187,6799155094,false,2093,987374
832478bd28b58555f9c1bcbfa6ff9a880b6a91d00750ad1f98f9b6cef41ed201,987429,2020-09-28 02:15:00 UTC,3419061437,3419059344,false,2093,987418
63f588322046227e5b8fbc569d91185032161a65f6d53ef96ef01e4ac503250c,987428,2020-09-28 02:13:18 UTC,151290238,151210238,false,80000,0
599d821458c23b7eb418ffedea2c5c2e14f85d29f784f2ba1a84d19ca522172d,987428,2020-09-28 02:13:18 UTC,7061356145,7061354052,false,2093,987416
0b044ef2d6d29f10fc37012b9ebefc2a9026dd91daab8e9d07a6273a20ab4d46,987428,2020-09-28 02:13:18 UTC,10000,,false,10000,0
0f4913309f4901aa9a210b38c9e2875891c0305f6dfcc6b86d35c79d275d1d6d,987428,2020-09-28 02:13:18 UTC,7053641762,7053639678,false,2084,987416
099ca0d5cee1a986d123adf7e5cbb038f7efda791898b1e9d90e0337e537c53b,987428,2020-09-28 02:13:18 UTC,7057391101,7057389008,false,2093,987416
3ec69d10d643e10aa79b13dc5af5b25cf856367927ded8fae9a0a61ca6c323b4,987428,2020-09-28 02:13:18 UTC,7065140369,7065138285,false,2084,987324
ccb25178589f9dbeef17d8a3b1a827b22905b4aee9755ba7e7aef0308426898e,987427,2020-09-28 02:13:13 UTC,8225120505,8225118421,false,2084,987416
0eb2727920d33f7c50081c3f47b4f28cb8f728bf05f3d46a9a8baf379e1aa159,987427,2020-09-28 02:13:13 UTC,57664540938,57664538854,false,2084,987416
f3a95a2fc167d7d6f626065b72f81b42c2877344781f003ea3110b3ec945fa79,987427,2020-09-28 02:13:13 UTC,8269979360,8269977276,false,2084,987416
5dcc65ae4b2d3db66a68bc9490746a793ead7ade1e78678b9634ed398ddb3412,987427,2020-09-28 02:13:13 UTC,7068994422,7068992329,false,2093,987416
f9c8113d64e50cc7acd6b0d3489b8a7f8123c41e7abfe5f9f0637bab1f5d1fd5,987427,2020-09-28 02:13:13 UTC,8228918557,8228916464,false,2093,987416
d5c2a4311561c6e09c074070c62338126ef0c6b2acbc31c59c8267e38da2358a,987427,2020-09-28 02:13:13 UTC,8288840274,8288838190,false,2084,987415
96a0eabd6f65f99b0143d6a34e168264550b2df0c60cb0c958dbd03754bed7ad,987427,2020-09-28 02:13:13 UTC,8266141019,8266138926,false,2093,987416
4d79f4daa9fa89221b5d22c57645bfefe5c6d4438442a0998921f5e7fdc1f147,987427,2020-09-28 02:13:13 UTC,8312123014,8312120921,false,2093,987415
3860e499a47347edac773212ebd7e867d7677ae8ee5e819ec44ce26e3edba828,987427,2020-09-28 02:13:13 UTC,9017777380,9017775296,false,2084,987416
1068014bf4654483f85fb92ca467fbbdee2043fd290a42a2ad37e8d6d20091ea,987427,2020-09-28 02:13:13 UTC,8221255446,8221229894,false,25552,987416
3d1c77b28e6d7e213e335fd15fcbebbf51fe56d2039ddcccd7b9b01d00838188,987427,2020-09-28 02:13:13 UTC,8308374198,8308372105,false,2093,987415
807173f5cc6a161879922ef7f943513f58bee3fbb03ba5679d926c8b3c867c12,987426,2020-09-28 02:12:39 UTC,100000000,99997550,false,2450,0
576f05b0409246ae23e48e40cd20221448fa44bd4f1a2577305df95f0b35d738,987426,2020-09-28 02:12:39 UTC,10000,,false,10000,0
421c4d9a309197d3e6fb99435a5c48da175b9042579f6eb7e1ada187d6a89577,987426,2020-09-28 02:12:39 UTC,15831445,15829352,false,2093,987415
69a30debf57d7eac6346e4e05b7ac9d7b3ba968e727924204b00636e3d7f7387,987426,2020-09-28 02:12:39 UTC,57701734902,57701732818,false,2084,987415
8d380348ef1697d611b9846dba832cec70c902e198c0114786fba7e746fa7e38,987426,2020-09-28 02:12:39 UTC,104563959,104528617,false,35342,0
62472ef2fb8050484444737ca6d7660b00381adfdbf14526fb19a30e0e00a02c,987426,2020-09-28 02:12:39 UTC,116433483,116389060,false,44423,987391
93df89ed5769acc1f2f023a44bacdcd0875b6513e731e97dac4530ad7189502a,987426,2020-09-28 02:12:39 UTC,8316071955,8316069862,false,2093,987415
edb3d97711b386fa04b37b94e64482fc745fd7d24e9d812b0e205ae9aa2773ff,987426,2020-09-28 02:12:39 UTC,37999999418,37999997836,false,1582,0
7662c456c0885e2a92c6dcd02f5fd6a5646701a3e5e19197aac483bf72efb449,987426,2020-09-28 02:12:39 UTC,8373200148,8373198055,false,2093,987415
2a9c713cdb4ed243fd64bc2d670c571254beb4339a42a833556121a3eba74885,987426,2020-09-28 02:12:39 UTC,97264265,97255722,false,8543,0
831a5925bb725c7d18ed754f780a8a93ff51fb46a9078d90e1187ce242fbad2e,987426,2020-09-28 02:12:39 UTC,6638925,6635577,false,3348,987415
3de305ca5cc8e35cef9a9a513ae8dd68e09a1d21932b8490ad465605424af068,987426,2020-09-28 02:12:39 UTC,8543642256,8543640172,false,2084,987415
c4293e9ccfc1bddf26595a7f879675a7c269f85cc9f3679d522e56b37ad3c5c9,987426,2020-09-28 02:12:39 UTC,8581358767,8581356683,false,2084,987415
a208cd761b3a547a4975d80e94687892a46ac35a50fe0d39fa6d0677c1c2ae2b,987426,2020-09-28 02:12:39 UTC,19642732,19640639,false,2093,987415
9e616c2c66abd544fa0015f626ccf3f1c0b0e9e5059863451a655109bafe562d,987426,2020-09-28 02:12:39 UTC,9054837957,9054835864,false,2093,987415
205087b76d5a09022a52564498721019c2c7d7e0939b7bdef88bf8a94f2cc937,987426,2020-09-28 02:12:39 UTC,8353471590,8353469506,false,2084,987415
363cfc456314c122e3cb7e605ca3ebc54a23a8028c5e4ed4ad90985a9c31cee6,987426,2020-09-28 02:12:39 UTC,94947816,94939976,false,7840,0
3a093c8617d597ac87ca7ba3c0655517879f351583777691f7490a130465af59,987426,2020-09-28 02:12:39 UTC,11996882,11994789,false,2093,987415
00cbb324cacbba6983abdbb84385a167e94698288e61ffff7521bc394a58ac7f,987426,2020-09-28 02:12:39 UTC,97295315,97286772,false,8543,0
cc3c3d36053c9de966e7b059cf178d10908334fc4a37bbd5f6786e915b3a35fe,987426,2020-09-28 02:12:39 UTC,8505716234,8505712399,false,3835,987415
ed9f665b4b3f1116c7b7dd826737e3749f92c9a514261f5e5ad66973aef46e4a,987426,2020-09-28 02:12:39 UTC,8118778,8116685,false,2093,987360
1fe4f3d4ce2ad11ffb9f9ff25894cf181d29fd9ac37d8161e1c931ce4d549afe,987426,2020-09-28 02:12:39 UTC,10000,,false,10000,0
6a340ba38a1ab6f334fce70b1b0ac6a165185cd33d04d2ec8c8aefadb417fe2b,987426,2020-09-28 02:12:39 UTC,102608648,102588572,false,20076,987415
eddb44c0df5029ec3f246c1900b58652947cbf69f8462162ae455207f23f246b,987426,2020-09-28 02:12:39 UTC,8410331393,8410329309,false,2084,987415
3277fead07ed7ba87b4d5d101954bf2c2c6ff60b3eee3e4e1dcb3fb9a5fcd050,987425,2020-09-28 02:09:08 UTC,10000,,false,10000,0
d0deab5349dc35b4016a1d4a80c0f79b8c0dd52d5c0c3a4cef3ac892449d6b9d,987425,2020-09-28 02:09:08 UTC,10000,,false,10000,0
7c8f9990b953a450f957cbb1dbfcbb0c8c0873673c709839c86ef85a411a33bb,987425,2020-09-28 02:09:08 UTC,16296,14268,false,2028,0
91138d02bd4b1d4e9b01a6dede3b764dd48ef59fa486c2660623662a5ed185fc,987425,2020-09-28 02:09:08 UTC,23558704,23555131,false,3573,0
1cd4b9d409780971e3bc402fe93351b9b60d1f2e8bbca96dd52a7b8b27202d3f,987425,2020-09-28 02:09:08 UTC,57889876418,57889874836,false,1582,0
20d9dab8b9916afdb9e5c62c08bf9f76dbc3ff0616f0671c4a18a8d033a5a591,987423,2020-09-28 02:06:46 UTC,10000,,false,10000,0
f33fc622b623319b69945b32d8fafe523acea6bc4ccc243dcfb8e3b931064f34,987422,2020-09-28 02:06:18 UTC,48965800864,48965798771,false,2093,987341
e4f53992e22244616561e3b05ed2c79339e3de914e86ec2351a4c61ad1c17566,987421,2020-09-28 02:06:02 UTC,58139878000,58139876418,false,1582,0
61410145e86cc59180bec746c914c7a39079aaea8fceb13298fdfee6a4370112,987421,2020-09-28 02:06:02 UTC,500194752,500184752,false,10000,0
3fefd990a8755ade3d07966161c06bf7526363d9c185cde6ea770c4e71398ebe,987420,2020-09-28 02:05:40 UTC,227885507,227882240,false,3267,0
ed3cbf3a9ad46140c34dd992658c65301c6421efa307c34e95cd2f0cb6265fcd,987420,2020-09-28 02:05:40 UTC,607989340,607987247,false,2093,987409
64137fe95854a42e3a7885ca851d93703db2a772ed1d5c03baa0f5518a2126ff,987420,2020-09-28 02:05:40 UTC,3500099083,3500089083,false,10000,0
789743bf8613496142a0c40e207c359a96040fcb57d6a4ce33c160d2a27ef38f,987420,2020-09-28 02:05:40 UTC,237893978347,237893968347,false,10000,0
49f5ebc2ae00110baa0d5d3b79ece7e4e8b85e6275effaaf81e7b088f710b103,987420,2020-09-28 02:05:40 UTC,10000,,false,10000,0
b01803e40651a4797b4f73fafc9fc88e33b400c81946f2614eaede737656fb24,987420,2020-09-28 02:05:40 UTC,57886273048,57886270964,false,2084,987409
edf2b3953b284300ab3cdfab7ee31522a062ecf1e0c5ea96eef7207d72081692,987420,2020-09-28 02:05:40 UTC,10000,,false,10000,0
7e50c670cd873540ee6e92044d4341127fc3cb21a5543368e0265b7f5cc396bf,987420,2020-09-28 02:05:40 UTC,1500061602,1500051602,false,10000,0
19149a1666bc70bffd194f2a2dfd235fd8cd08ecca8999c070515a4d2551fadf,987420,2020-09-28 02:05:40 UTC,1331209300,1331207207,false,2093,987409
8d838061bcec5364b2456eeb6a9aff33f85f9362fbbd32399c26f027b213827c,987419,2020-09-28 02:03:00 UTC,98123062,98114519,false,8543,0
55dec2839bc7987f7ae729e96ca9663943840bfe36464a8c16e5c3b1ac30788b,987417,2020-09-28 02:02:18 UTC,10000,,false,10000,0
b41bfe834c11215659ad4451a69a5125468142b841cb12e44356dce36cf680fd,987417,2020-09-28 02:02:18 UTC,500164375,500162282,false,2093,987406
d55394eb6f3ceea175b7a6985bc798a3b958c97b96ec17626bd47bc203c646b1,987416,2020-09-28 02:01:38 UTC,629042197,629040104,false,2093,987405
d5e5f9141d2fe41f80edaa5c695ec4a85cd69034e8af48f15c4de1be00f13224,987416,2020-09-28 02:01:38 UTC,162544475125,162544465125,false,10000,0
81467554f9918b13657ded7c4dd40fa28148a919fa4cc1171cce02c10794b0cc,987415,2020-09-28 02:01:01 UTC,103004621,102988304,false,16317,987403
022fbc24319998d8f3e07f7623766d0fbaab0ff22a6c3fe1414c6f2625e16452,987415,2020-09-28 02:01:01 UTC,162544485125,162544475125,false,10000,0
76408642432b4659edf4a9ea7a9cf13c62abe065c7d184bd970011b439e7573c,987415,2020-09-28 02:01:01 UTC,117495338,117444192,false,51146,987403
afa2714bd85b695e9a1cfe4c4c65fe7f4b1c2524c346e062a580cc5f7a90d582,987415,2020-09-28 02:01:01 UTC,18736969966,18736959966,false,10000,0
fe7000bf08d4230ffbb1b8a8b2b0d19db77ab06d6262f4ea8f4986217088207e,987413,2020-09-28 01:59:54 UTC,10000,,false,10000,0
cd455e49d7f0d280675374c3cf53dc15d4e5a1f0f73ae541652e8129678bca20,987413,2020-09-28 01:59:54 UTC,18749191781,18749181781,false,10000,0
b760dd585fd363e74d2d4935e6bf01421290909296f187426392c16822b98e85,987412,2020-09-28 01:58:18 UTC,10000,,false,10000,0
b7db8ae26c8d336901b55ab491ea1d3ceacfecf3fa5118f27887ded24e625564,987410,2020-09-28 01:55:25 UTC,23754419,23751152,false,3267,0
cdb16471557767a2b6b248e9549ef0032341f1f46f8bedde39cc23d01492f8b9,987410,2020-09-28 01:55:25 UTC,199998080,199995544,false,2536,0
b23d9cb931ed821c5d224891c8c8c5a2e2c28b3e6f64c010c742e7fb4fbd8562,987410,2020-09-28 01:55:25 UTC,10000,,false,10000,0
10c2566c6931edf9f739ff1993c8f3c82c763c3374fa003865b30d65c526c40e,987410,2020-09-28 01:55:25 UTC,2876899856,2876779816,false,120040,0
8798f6d946d7d3975d7e15faec0431f1e5fa8b8a5ba8c763dfe769ec84171c0a,987410,2020-09-28 01:55:25 UTC,144069829,143989829,false,80000,0
820f00b03823a8bbc037a5bc5f789c60cbeecbaaa68e43a5b3639abc557c4e23,987409,2020-09-28 01:53:45 UTC,200000000,199998080,false,1920,0
7fca894283ba024f2ab89c25c2625a67e57fc548f3f26e609a83995eedeac0d3,987409,2020-09-28 01:53:45 UTC,10000,,false,10000,0
304d8f4d18db6c9bcc4cb15f02f4a47fd98c3020927410c3a52d6e232b84247e,987408,2020-09-28 01:51:35 UTC,10000,,false,10000,0
4799770775939047c17741a76465d34c59ce45dd3510a77068834a6532b25234,987408,2020-09-28 01:51:35 UTC,98203280,98194737,false,8543,0
4765ee82ced36a36293f7c76f69bdda9a416bc579b77e46a2b47e54bbe84f44a,987407,2020-09-28 01:50:13 UTC,18749201781,18749191781,false,10000,0
a2d7c34c8a32604062ae84651f08d2c59f4e9aadf94e3c193585d0148e72112d,987407,2020-09-28 01:50:13 UTC,118497291,118452518,false,44773,987395
9aa6c8246c1632a928dce00b6c7544e70b8d8ddc2a6febbdd77641f7cc1fe8cb,987407,2020-09-28 01:50:13 UTC,103497466,103475349,false,22117,987395
4bf25a4765cf71cd3877a48d98bcb78dec530f3197447cb77a01a530d98c323f,987407,2020-09-28 01:50:13 UTC,228110144,228106571,false,3573,0
f307595c0f20131eb10620e4ea216863e05d0ff638ff704579c3fe0a8911ed4a,987405,2020-09-28 01:48:59 UTC,10000,,false,10000,0
e8a82d44b2dce0f9ce866aec97282ecdec42b88a6ae92d1cd80d359ba85f8f57,987405,2020-09-28 01:48:59 UTC,19102376442,19102366442,false,10000,0
5205db4ceb98ff54512e5dae933da24814bf73af2b034ec54bed977c731c9a61,987405,2020-09-28 01:48:59 UTC,23901621,23898661,false,2960,0
3c0ad18ed660baf08dda75a392caf9e4def6e2fa3f35a19a16fe16cc2e41ccb1,987405,2020-09-28 01:48:59 UTC,98490261,98481718,false,8543,0
c2c8d1142b711bb461f1cba5c4fdfc2b37e77564e8879cc7bd347d73ceab3492,987405,2020-09-28 01:48:59 UTC,605667590,605648112,false,19478,0
30bef6dadbacafc14ad3b30eaa9c4d97f3099a20cd349310e5e684dd9367aadd,987403,2020-09-28 01:46:34 UTC,98694935,98686392,false,8543,0
a760e1a8c505f5262a1ec63dae57b8c90af58dd131283bed0854369ed6c3d8cf,987403,2020-09-28 01:46:34 UTC,98790110,98781567,false,8543,0
2724eb699843650f1a18cd114229e9d9983f309003c17c30e16c2346bcfc55bf,987403,2020-09-28 01:46:34 UTC,222232818271,222232802521,false,15750,0
2f7e974e373229871b91a1c38a333bb1d240723f707104c7ff34d29a9c894854,987403,2020-09-28 01:46:34 UTC,10000,,false,10000,0
4b450d6e0d52614c45b47ca22db277bd4441a0a5e9100d98701da206bc31fdc6,987403,2020-09-28 01:46:34 UTC,10000,,false,10000,0
b902fe0ac69596582551b3613b98970161c1e8bc437b1dadedb32b2c051623a6,987403,2020-09-28 01:46:34 UTC,10000,,false,10000,0
6182bd39d63f6b1f9d64f9ba4240cbf0e38ed7ded152042c7094777643c74106,987402,2020-09-28 01:42:33 UTC,100116764,100109303,false,7461,0
afe5c01fed94b2efb5c2a9642af7cc72934f746aee0027b3f85e17628d328306,987402,2020-09-28 01:42:33 UTC,98871375,98862832,false,8543,0
57a49a7764a18ea3c0dc8f8a8b18ff0380702b49a46a7d928d576ec69422b86e,987401,2020-09-28 01:42:04 UTC,104248573,104227045,false,21528,987390
e5a76ca88d6250c8ca6c78982e26b2d2649bc2a7772ec1ca2a4590c34a0c2618,987401,2020-09-28 01:42:04 UTC,19102386442,19102376442,false,10000,0
4c166c5e93eb5ebb93e978c593b81e1435290ad760dc282f63c0ce546b908451,987401,2020-09-28 01:42:04 UTC,732624017,732620277,false,3740,0
73d63219f6c7ceaf2b5cd9848b8277de3f70a3fb6a87ef24425f1feadcc66360,987401,2020-09-28 01:42:04 UTC,10000,,false,10000,0
087f615b31b86deefa043afc753f29507a9239651bee1bdd44f38fb6094a6eff,987401,2020-09-28 01:42:04 UTC,10000,,false,10000,0
b7c6c61e7ca03fc236eace192dea79b5812879ca17e624358b190e1781ce2993,987401,2020-09-28 01:42:04 UTC,500000000,499990000,false,10000,0
4da2b52493e4449dad55f64cd8b62a752974190b37f53cece7d2dc2e6688d397,987401,2020-09-28 01:42:04 UTC,319100031,319084261,false,15770,0
5ac75ecc78c8359737d379b682be80e8f4194b221de52393bce303998bc3587c,987401,2020-09-28 01:42:04 UTC,250,,false,250,0
ce1a96075d8d30069b747d511b0f46957188fa673281da83687b802414f38dbf,987401,2020-09-28 01:42:04 UTC,119791128,119738828,false,52300,987349
0c635d972c30dc94438a917fd2129ec4ce5ead5f4d8acd8d1d4458bd38dbd5fb,987401,2020-09-28 01:42:04 UTC,499990495,499980495,false,10000,0
20d0c864ceec0717e9618c457c541aea85f03f91c6b1596d3fd8add785518137,987401,2020-09-28 01:42:04 UTC,228288772,228285812,false,2960,0
a4a28939a7efa1dd31f9f821e88d32545659831a9d4b9a6f53813406455040b3,987401,2020-09-28 01:42:04 UTC,14891185,14884044,false,7141,987329
6151d5215c67f8db0106403779726b2d8dd388463c176bba863b46f4142d455c,987400,2020-09-28 01:39:08 UTC,66322454006,66322438426,false,15580,0
0276f569ec1a6e5185c6c6abfb0418cb93efc3302d3a823418237c715363ae0a,987400,2020-09-28 01:39:08 UTC,40873727,40867727,false,6000,0
f9c5c63d9271d424e5addff95d1bbf5586ddf549dae8bd2ae5b31405fac98a43,987400,2020-09-28 01:39:08 UTC,70490353,70488260,false,2093,987389
257dfa0c533fed5776de55f067e586742898361dd0365dee4d32c75a7360db4c,987400,2020-09-28 01:39:08 UTC,722632506,722629401,false,3105,0
117bc095112e79ac54b1e6df2cb2e0bd695452f74e5549f17b9dfa16e1558a19,987400,2020-09-28 01:39:08 UTC,10000,,false,10000,0
1e8b2d1738c560514032c7fa375647be8548f45db0096bd4f0798ccc14afc3f9,987400,2020-09-28 01:39:08 UTC,499980000,499970000,false,10000,0
dc57b0b467f269d66911a3325194ce8f75653eb14849c161c5328d2ea39f3000,987400,2020-09-28 01:39:08 UTC,722629401,722627481,false,1920,0
c599e9e14f24e02c5b584edce07389337c0e2355c91fb7adb4157479971a421e,987400,2020-09-28 01:39:08 UTC,228458072,228455112,false,2960,0
b8b0be229ca29be8e67c3301a77d09a25dc99314e9f4e97bf3d0042a4937874f,987400,2020-09-28 01:39:08 UTC,10000,,false,10000,0
c0102702937860fc8d325b773b443e2567471440ca4a53dc43862d7d59e00dfb,987400,2020-09-28 01:39:08 UTC,1012318540,1012238540,false,80000,0
f4c5d27cdb6cad31226dd5a3ed496c0a6c239824abd8052f8207cf4a78864408,987400,2020-09-28 01:39:08 UTC,24139619,24136659,false,2960,0
f9bcde25289a30e7f3cc3aba17dbdecfc25942e8368e68cb3b2986f4e0981236,987400,2020-09-28 01:39:08 UTC,10000,,false,10000,0
fa0ddec3ae110c64d56365e526aa254e47ace6702923c72dc81fb86facb01339,987398,2020-09-28 01:31:14 UTC,10000,,false,10000,0
d51e95e10c47c39af13d8829d3015feaffca359792d527b16904caac62582af1,987397,2020-09-28 01:30:10 UTC,120942182,120893667,false,48515,987385
b1541af6ff698d07b7d7bebd75929b08f0197ad9f1f7c04a9e88034dbbb39382,987397,2020-09-28 01:30:10 UTC,104753189,104732507,false,20682,987385
126ac37a14463d7c58acd0c24d304e18d4123b16d4bd361ace44fd4e5e72ebb7,987395,2020-09-28 01:29:45 UTC,25050824,25047864,false,2960,0
1ee60c741332da9967607f918893a87c7cc628c50d9cb4cf05105f336ecbad12,987395,2020-09-28 01:29:45 UTC,499990000,499980000,false,10000,0
c939b7226056ef0232ad48116ab5475a7220ee86e6205a083b5825e4db6d61a3,987395,2020-09-28 01:29:45 UTC,10000,,false,10000,0
aea078a5ebba21f2c9185e649c90ca0001347098a5d54c3445f45ae9c0af2976,987394,2020-09-28 01:28:25 UTC,18763825344,18763815344,false,10000,0
866924088a1a3f56e1e0bbf86e1ac5ccfe8f9f513639fcda1093252317afbda3,987394,2020-09-28 01:28:25 UTC,500000000,499990000,false,10000,0
c5b10dfac21bd94e6daead90805078fa0183667d8460123d9c5dba118c4953b9,987393,2020-09-28 01:26:54 UTC,10000,,false,10000,0
7138fb1ffdfacbdca0ddce2749c21ff4b5f980b5bfd1ca71af0c593f72ee77df,987393,2020-09-28 01:26:54 UTC,500000000,499990000,false,10000,0
0b2fc803e0f767c0ee624793024e2638d187d91a9ef9208114775c4c659e83ec,987393,2020-09-28 01:26:54 UTC,228889442,228885563,false,3879,0
90f048daec58cc35f51c967211c8dcdc8079256f3b2e867e718759ed0e473194,987392,2020-09-28 01:25:33 UTC,10000,,false,10000,0
b807c9a67904bc44e566cb39647523401dbe2d9a527aaca38533682d9555696c,987392,2020-09-28 01:25:33 UTC,499990244,499980244,false,10000,0
c536d72d5ccfbf3d18e29d1b5e0800c9ada5f9e4ac4da1bb8af901649eb7e6b7,987391,2020-09-28 01:24:03 UTC,10000,,false,10000,0
5ab8d6550d44c7c1fd331c1aa138221196c4de25f30059b963ec14eab22fe63e,987390,2020-09-28 01:22:53 UTC,500000244,499990244,false,10000,0
cb2bd942c0e7d0ea891bb7e1e4a8bbc3d669708e1a252decd1664d73bbab0202,987390,2020-09-28 01:22:53 UTC,25202049,25199089,false,2960,0
7728c5d65f8f72e526b9b85e502d0a6ce3e9a3519606c09b3137540deff5d347,987390,2020-09-28 01:22:53 UTC,58486174141,58486172048,false,2093,987378
59f78e1f7a2a8cffc49da96cbd8aadab9507c2b575b3e0bc8bdb884305264340,987389,2020-09-28 01:21:02 UTC,121808920,121760097,false,48823,987377
d2eef18bea5c5c6b33d3ad44740f9c84c387de3fd32b2a1ade7662311a3b80bb,987389,2020-09-28 01:21:02 UTC,10000,,false,10000,0
d57ab114f625735e21ee1d361d6223efd0d490907e3f19672a7b82a81fafa7fa,987389,2020-09-28 01:21:02 UTC,105264748,105245527,false,19221,987377
c70a3d6c832f49778ebc2cdac866610c409b704482bd3c14979a6cdf44fd629f,987388,2020-09-28 01:19:58 UTC,500010244,500000244,false,10000,0
cff6ac5dc42127100fffa40ba3bb358554bce6c60909748622bbee137f43ec97,987388,2020-09-28 01:19:58 UTC,433917528,433837528,false,80000,0
584a25e6894538c05008c1b93cdf199cef621615d354d47772b537a8f173e861,987387,2020-09-28 01:19:17 UTC,84209,76369,false,7840,0
39071d3d4ba189bba52cb7d43acca796c4f387733b0637c2efeb333088c507b8,987387,2020-09-28 01:19:17 UTC,4760663,4751009,false,9654,987375
6ff366b31ae2db2d9c59921d44b64c3a3bcb655d9f6d6295918aa53ecd46c143,987387,2020-09-28 01:19:17 UTC,229048394,229045434,false,2960,0
0f6cc4ac419062fa2d79e840bdb1be58a69f7652ec742e9cb1db26b93717cf8c,987386,2020-09-28 01:18:54 UTC,10000,,false,10000,0
ca6acb126bcd24e164a3f698c4db56b01d4b04f78963274affa7bf89d7033d37,987386,2020-09-28 01:18:54 UTC,1421465,1411465,false,10000,0
4dcc6ebd5e732b6b101ac1c2daa1883116802a57c467a2492c937c58d6a42db2,987386,2020-09-28 01:18:54 UTC,99210609,99202065,false,8544,0
64bda22e5596029185fafa7e9e642a494b74e44b0e89eaabae811d01c3bf763f,987386,2020-09-28 01:18:54 UTC,99165442,99156898,false,8544,0
d6faa0118355a53cff2e75b81d40d9b79b4fb35afeb211b0c195aca83f5049b7,987386,2020-09-28 01:18:54 UTC,6874421,6865877,false,8544,0
a13947ec90d688c14b5dcfc7116d2e0a82643076462b7d9a174fbc2bd1ac8a3e,987386,2020-09-28 01:18:54 UTC,25360300,25357340,false,2960,0
2e15ca12699512bd8993aa1887ec7e2c78a1076ce24206c91d82c52912331436,987385,2020-09-28 01:16:56 UTC,75815787,75813113,false,2674,987373
6720f4e54fb3372606022772247ebf1573f3bfabd796a26aa8389111f969a057,987384,2020-09-28 01:16:41 UTC,3745740292,3745737395,false,2897,0
3424cb3da03bb1282be605ef718ac8a7ee99e1b4af487c65564e3c1c5e2da4d2,987384,2020-09-28 01:16:41 UTC,10000,,false,10000,0
fbff2c51b4f5bec04b72e05f3f4a4e3e385574f808c2d8a61bfc9175aaf3adc8,987383,2020-09-28 01:15:12 UTC,10000,,false,10000,0
bc1d0d1f44187f6907f033e7c2eabb6b2451a85517cf8b8a7360aa8dab507b57,987383,2020-09-28 01:15:12 UTC,500011146,500001146,false,10000,0
f5c27ea825c7fc86824d4658befa659f4f262710dc5c2e0f92de6e080916a4a7,987383,2020-09-28 01:15:12 UTC,229299615,229296655,false,2960,0
91d3825c8104fe69126342f62caaf4bd12e19ba54cd1c415885de770254a1709,987381,2020-09-28 01:13:24 UTC,10000,,false,10000,0
f5c7320cfad0a3221c33cf83c1c217fc7f3fe89b450d3719ddf29587d9d46c10,987381,2020-09-28 01:13:24 UTC,117403015,117386165,false,16850,0
1e15a5be7852d6ee4724f85b42217bbc6226e0c054e1fcaa2f5ce8dffaa710d4,987381,2020-09-28 01:13:24 UTC,10000,,false,10000,0
130689fe42bab7697b130fbe67963c36a8d89569abd3aff570e6d514982197c8,987381,2020-09-28 01:13:24 UTC,18201493538,18201483538,false,10000,0
a0e21597a5877f536ac0b5e10201aa7318fe804739ac2805569ee16889acd3e2,987380,2020-09-28 01:12:22 UTC,99420939,99412396,false,8543,0
d3161917be6658fd02d00f74a5aa856274e4393d76fd80c100ee4b864a479b67,987380,2020-09-28 01:12:22 UTC,10000,,false,10000,0
8c06d5647b298477f2de1c0e4bb31dbb8460a235bdfb2879d514322746c9c330,987380,2020-09-28 01:12:22 UTC,25545679,25542412,false,3267,0
37f4f465ba7ba2416658e87fa121d77543fd62f8159ed4ba9137e2c854830464,987380,2020-09-28 01:12:22 UTC,1011302,1007945,false,3357,987368
204ceecff8d34880feed8b2386c019baf0ce039852b259abf7c7f1e0a77e3276,987380,2020-09-28 01:12:22 UTC,64006578754,64006576661,false,2093,987367
dc4c4480e99e251bcc7fe30276253d66ec0f63f364df188e263d6844d169bc37,987380,2020-09-28 01:12:22 UTC,105729946,105711348,false,18598,987368
fa241a23a96a1bff71b610b95237f1e99199cf9c00a7a00019d61b056c6766f6,987380,2020-09-28 01:12:22 UTC,18885664876,18885654876,false,10000,0
60a517aab59afd65969d8d679280159822eb6e8bf6c225ae915cd10a4d722f67,987380,2020-09-28 01:12:22 UTC,123069554,123015529,false,54025,987368
39a841d9559e79cbb2440fa765229bd6d29249a7d2a5f71745f5f34c3dfa2380,987380,2020-09-28 01:12:22 UTC,500021146,500011146,false,10000,0
b0c1322a93ea9ff53cd74d150bdc6eed06d8b88193fffc7009d81448c7f780cf,987380,2020-09-28 01:12:22 UTC,57077966,57067966,false,10000,0
4af8966d08ef0a58d257e25219006d63023287e97c3745938b1afdb1579ea689,987380,2020-09-28 01:12:22 UTC,99375003,99374727,false,276,0
3ac43e228cc4ff348d00b267ee87cae8bc27a757d8abcee39ecadada62d7dd72,987378,2020-09-28 01:09:15 UTC,229550570,229547610,false,2960,0
6cbdb262dda140589b766b495e67a89adb5fb53039d8cdd8d47c0eef948a718a,987378,2020-09-28 01:09:15 UTC,10000,,false,10000,0
08a489d0e91623d7bf7713831c7c60f5122e5af07c1b73ec2c617957bf8913f6,987377,2020-09-28 01:07:31 UTC,25967190,25964230,false,2960,0
e6970d7101c3e0022380872ee76e3d4867dcdd3eada448e9bc9bfad8cc1492e7,987377,2020-09-28 01:07:31 UTC,3500513607,3500503607,false,10000,0
23649763eb144e39093465071aa9e071b2139adeed77bd598aede7159eacfac5,987377,2020-09-28 01:07:31 UTC,1500142960,1500132960,false,10000,0
bda57c4a92c621eec3774b9e9167d98647851f1668ddbdbea1488cfdda06bfa4,987377,2020-09-28 01:07:31 UTC,3000361230,3000351230,false,10000,0
16478ef7c89a83dc03ed5f476347db64cbb991349d356df3946d4d3263762067,987377,2020-09-28 01:07:31 UTC,10000,,false,10000,0
444aa6e2c9a9a035d12b0a9e0850178ecebe18abb19e5f2ed96bc47bb4c494b6,987377,2020-09-28 01:07:31 UTC,1447439,1446752,false,687,987366
f95f7cab50735442ab48c818777a2a603b8ca4963be79358c20619f58b266513,987377,2020-09-28 01:07:31 UTC,65114968998,65114968754,false,244,987366
c61b8e9ffa35e2e3190be62f4eca02479e158a0cc06b0e5c1f2231b5249a1851,987377,2020-09-28 01:07:31 UTC,235247863391,235247853391,false,10000,0
7b316906077f71af00f86f7e2c24ad40fe974f1aa7574760d87fa7a7bf568635,987377,2020-09-28 01:07:31 UTC,114446378,114446133,false,245,987366
7f6a6d331719739ecf7a16242e94ba6c9260f33fa087f8a8d40cc90666758810,987377,2020-09-28 01:07:31 UTC,3500109083,3500099083,false,10000,0
addf96b20d4cd72080f840507c6b60e56d2cf8e786c8d91823003f110f70a676,987377,2020-09-28 01:07:31 UTC,99596289,99596013,false,276,0
9f6c6f26c14af52d8eeeef6ecaf5b19c944006ad84d3d8cd95fb5f3507252d2f,987376,2020-09-28 01:04:16 UTC,10000,,false,10000,0
7ee2165aa5da81b7e00949ed292db4deb579d0522b3eff8f2334a943ee9d2de3,987375,2020-09-28 01:02:57 UTC,440238086,440158086,false,80000,0
9e4c3cec2a474e091cd938f958ec015d34f965fc81639a6171b27d2d2044cba5,987374,2020-09-28 01:02:12 UTC,99672335,99672059,false,276,0
070d9a940bddbc7dfc68ed53e3b6466f848eb86fb8a23f53af6ddc54f8caf56e,987373,2020-09-28 01:02:05 UTC,129529,127079,false,2450,0
23e7ce9c741f5d29e81d9763c61ade8a6ddf7900ff002fcc0dfb85c0306e654b,987373,2020-09-28 01:02:05 UTC,229751855,229748895,false,2960,0
5c5a922ae802745fa2e296e6093804eef515003ac83b185d6b94ef6201f6b814,987373,2020-09-28 01:02:05 UTC,706243270,706242855,false,415,987361
7cf97cab7f0368934939c0f587ad8e90bdcfe67b45f179c1c686e997d7694bf6,987373,2020-09-28 01:02:05 UTC,10000,,false,10000,0
d9dc18ab5556c8ed978e40938c33cee698a848bfca3769a0d3e98bb0a8f6685a,987372,2020-09-28 01:01:09 UTC,123964730,123959558,false,5172,987361
ff69375f83ce1f5ea1b55733027bf43b9c4b2004ddf20877a8dfcb30ce9f9464,987372,2020-09-28 01:01:09 UTC,10000,,false,10000,0
9c582e0032b4a46a01022b0e2a07894c8577deb256969c9201f45d4d6a084de7,987372,2020-09-28 01:01:09 UTC,500188959,500178959,false,10000,0
e6704d410b0465d1def880c1c6802120bdf26fde59271c61fd1b95fdbe434961,987372,2020-09-28 01:01:09 UTC,11517205,11516813,false,392,987361
a1530c34ef834d38e351607fa911b72d7aee946d4189d18e95481142c15e86df,987372,2020-09-28 01:01:09 UTC,106218402,106216051,false,2351,987361
54cffd4299bd4fb055883c0c16327a96e9f90ea4d52c301598d4b6afb581d57f,987371,2020-09-28 00:59:22 UTC,26200651,26197078,false,3573,0
6f89649039e3fe9f33e4ce8036c4afbd22e389b1359bceb7179b7b220aedcd1a,987371,2020-09-28 00:59:22 UTC,10000,,false,10000,0
315b4023e529dba896b690207124b26077d6b660dc32f9d1383c46636d6f9939,987371,2020-09-28 00:59:22 UTC,100000000,99997570,false,2430,0
0e78e4df3357066fd934736e36f9e11397b19da323f9389cfb77b3630895d411,987370,2020-09-28 00:59:12 UTC,500198959,500188959,false,10000,0
39358cc95328c787c71b27a64c76b5261b2dca7c31a3e72a5339b8374fda9040,987370,2020-09-28 00:59:12 UTC,99712026,99711750,false,276,0
0f486beb43c5b930c4e79d251980b14a3c113494f95cdd61d198f15b1cdc3cda,987368,2020-09-28 00:56:58 UTC,10000,,false,10000,0
f23677afb65a5b6c96ba838ce6761288db938decd0be6f37fccc6b8716654ef9,987368,2020-09-28 00:56:58 UTC,10000,,false,10000,0
6ae3440c2f4ede0bc627ae13557ba17788d3abf9a22f503f9d4788ff5fcc4687,987368,2020-09-28 00:56:58 UTC,1601174557,1601169018,false,5539,0
d26edf143a265acfd37709690018c8dfe2263d55fccbc80e9155bbf42ad12583,987368,2020-09-28 00:56:58 UTC,65738839243,65738838998,false,245,987324
eb1d8cf53e9fb1b91349187761481996744d6aaa56ec9388001d72372fd7e79b,987367,2020-09-28 00:54:15 UTC,10000,,false,10000,0
471e177f96e98b7db029686e601b6826be4130f65a7d0682f1482af6563075b5,987367,2020-09-28 00:54:15 UTC,121472026,121437530,false,34496,0
e2d5e1c41f37d5edd4f123e649ffac191fd64879f30818bde1ddbee1a318cdd1,987367,2020-09-28 00:54:15 UTC,229947518,229944251,false,3267,0
aca1d32d1da728c9bfc7650ec8939e87a6971ee0f3900220825a0bfc7f583554,987367,2020-09-28 00:54:15 UTC,148856,138856,false,10000,0
abe914a2f89ed97e8fb06d6ceb032e82121897f1935d0f48cc59c00c31f354bc,987366,2020-09-28 00:53:32 UTC,101055097,101051740,false,3357,987353
96d96c0f2ca69bfc5414a550df82538daa3f175056313a3b1982939c704be615,987364,2020-09-28 00:52:45 UTC,99746831,99738287,false,8544,0
1f911d45354379d7acd66d6ebc299687ae2ede9ff00628da20bef24046a622c6,987361,2020-09-28 00:51:55 UTC,124855679,124810029,false,45650,987349
2a42e2833ecc2d0e1f9ac1ee777e19ad10512f12e7d349d3600bec751d9c5144,987361,2020-09-28 00:51:55 UTC,15649178,15644573,false,4605,987279
11ed09e32ccbf4ddfc850e5295b9d31e0da91e8a4f7c6785e412d006de84a3a1,987361,2020-09-28 00:51:55 UTC,10000,,false,10000,0
b05ca92800c812297cf33b73ee93bab35d69fedca8fa37df2fe0acfcf67a7b9b,987361,2020-09-28 00:51:55 UTC,143202001,143199917,false,2084,987350
18882eb323e20c3fb52de9594cde18715ca25c69108f0448cd1da822e69c0c8e,987361,2020-09-28 00:51:55 UTC,106613880,106594392,false,19488,987349
4deb97bc736d436908103317f8ef2033c2b96a0d423298070728e452463d8cef,987361,2020-09-28 00:51:55 UTC,541096121,541086121,false,10000,0
43645ba5e6dc66fd5f8ea03a17e8741132e48e082b468337b2a2a86f8314f850,987361,2020-09-28 00:51:55 UTC,100050981,100042437,false,8544,0
caf88619660bbc6253b37f6ec854435383d06a74ff07917bda0f153ccf810b9a,987358,2020-09-28 00:49:04 UTC,26364031,26361071,false,2960,0
9e8f8efe22dec2eefe8042daf67f58d1b45a1500bf56059254f5c68467cd1a20,987358,2020-09-28 00:49:04 UTC,10000,,false,10000,0
876c81234a215e5fb91f33e14c765edbd2c970004ed8d6d36cfc884191247866,987358,2020-09-28 00:49:04 UTC,10000,,false,10000,0
5cbf82b6e4cb682f0900c9def26390b2fd09b6dd2b6914f16a81e5beecde6feb,987358,2020-09-28 00:49:04 UTC,747378330,747374590,false,3740,0
88bb27409a76264aab2e0f8ddde4e40d980f6f585ccf2728e6424db4e38cf541,987358,2020-09-28 00:49:04 UTC,65743341336,65743339243,false,2093,987347
4e1873868b428df76a9193f921862ffe935fe34d126b1694ea81b2e7acd453b6,987358,2020-09-28 00:49:04 UTC,10000,,false,10000,0
4f61e3d573065887a6ad73562a8a351adf3556930ddecff14b3dfb9b2074c686,987358,2020-09-28 00:49:04 UTC,18385495917,18385485917,false,10000,0
23637042b0ee7f13d9e288ad0a338cec5ceaf978ebb2f53485f81b29f79d4572,987357,2020-09-28 00:46:15 UTC,100144977,100136433,false,8544,0
210000b636d6a6f9191349f11e5eba04638c41d42268aa31e7430664577d7d6e,987357,2020-09-28 00:46:15 UTC,285350167,285270167,false,80000,0
1d0426f2fd067563c9fe77bf2151a90c6f12cd7a6b68fc10407cdac9da8731e7,987357,2020-09-28 00:46:15 UTC,100111674,100103130,false,8544,0
308b90587a0fe0c6553716eb2a8c4db99db72c27e05b2c54bbc2381ec4e0ebfc,987356,2020-09-28 00:44:51 UTC,27665196461,27664696461,false,500000,0
c91fbaea8fc95c9c1d34d133d6a9d1bdda61c165bd6dd0d7603c86e668c1c2b5,987356,2020-09-28 00:44:51 UTC,230104712,230101752,false,2960,0
351a90b715dab6654dbc82f30779a1289143b87a7374b486e0f19a5aa903a749,987356,2020-09-28 00:44:51 UTC,10000,,false,10000,0
91e30dd13b1d15d90db533a53d9335efa263f873a0fe60c2be86b4be8fb945b7,987356,2020-09-28 00:44:51 UTC,18905824336,18905814336,false,10000,0
e0304bbcfb895ad267d46842cb0021f96e4237c610ef37235be2a64748a74e06,987356,2020-09-28 00:44:51 UTC,10000,,false,10000,0
d3e15a3494d5ef41e09a0f160b27856c8997d300b8fd56157f6bb5ae31aa1850,987355,2020-09-28 00:43:04 UTC,99934500000,99934497650,false,2350,0
92d0e9c9a62f4a01092ed738a42a4f2e64a09b6dc6b68b0480ad432559ef4add,987354,2020-09-28 00:42:34 UTC,733315,655575,false,77740,0
4bde9bd793790fe11a2b268fe1d237f0837e7fabfbe1de6b1e151b1b6f7a2226,987354,2020-09-28 00:42:34 UTC,26519134,26516174,false,2960,0
ea03a93bf381eb988e049037daa58d580c5e175d1503cf5da10e4002bcfcd478,987354,2020-09-28 00:42:34 UTC,66468877494,66468877249,false,245,987342
b9b6a8c6e1aa6e11f3387c841eb5a74304a20059c5e893440be5f25b8ab52e4d,987353,2020-09-28 00:42:01 UTC,1712492673709,1712492673464,false,245,987341
f5b02f55802d32129f16843bd131321c96f1b67b2697d722ed8b5f0bf9cef2e5,987353,2020-09-28 00:42:01 UTC,10000,,false,10000,0
9377581dff7e1740060d05bf4faaf85a57f259896f74431505f65e5f1a9feff3,987353,2020-09-28 00:42:01 UTC,267990693,267972911,false,17782,0
283928c8f88ebc243e165b1c2a3362b5bf30b47a1e273522e08021bb15cfe408,987353,2020-09-28 00:42:01 UTC,125692341,125687549,false,4792,987341
e1dc31bc07c535c1a095aa789da127f04bfb0af2a0fd6694215ffa7a3af90b70,987353,2020-09-28 00:42:01 UTC,100389107,100388831,false,276,0
d714e6903cc9758bc04aaeb57d11b1dfc0dac26215ebe0061fd965879f2e839b,987353,2020-09-28 00:42:01 UTC,106978610,106976869,false,1741,987341
56f586546d13384bd760dfe96e3c7dd3e753b4ad47c49a11d8fcbea1f70ccfeb,987353,2020-09-28 00:42:01 UTC,287066,277066,false,10000,0
f4ef61b8de3599291abb2eb0faf03b6904f5984d519d441db1570bc7b1b4145e,987352,2020-09-28 00:40:13 UTC,10000,,false,10000,0
b14637045813fb5ab19a64d8778db20cfce8796fa5001d690bb504aeb826bdbe,987352,2020-09-28 00:40:13 UTC,76067877773,76067877494,false,279,987340
89c5b4c7dc40e96fb373c29f6fc2c63b8f59d322e6562f268fdf9aadda1bc82d,987352,2020-09-28 00:40:13 UTC,230310897,230307630,false,3267,0
45c575d53fc15838dc0c49190946bbdf6f8f7e45ed5e83a85dee5f3518570e4f,987351,2020-09-28 00:38:04 UTC,18905834336,18905824336,false,10000,0
7d6e41c709d08c08e1583628a32ac8842f6976efcb4e6819cc609b078f3fde81,987351,2020-09-28 00:38:04 UTC,10000,,false,10000,0
65beaf089df5342290f1d27175c896ff573cf6faec32b268691df29ea6c45df1,987350,2020-09-28 00:36:25 UTC,4500283583,4500273583,false,10000,0
7c6999d6acbc8ff7baaab39c73d0d3f0e97dd60c4093f01aba34c2f001d448a3,987350,2020-09-28 00:36:25 UTC,26721278,26718318,false,2960,0
a9710267b3d46a916f2c7c010e69abd8ce2b1cef3eea5e7fa7613f4ddbc9d550,987348,2020-09-28 00:35:23 UTC,100446303,100446027,false,276,0
14f1e856bffcd92b4a0ebff33a7ce74b704368e0da1640c8e0d60fa51c847037,987348,2020-09-28 00:35:23 UTC,10000,,false,10000,0
1635e3c3af4e4e8818a730495bdc5ae62f57928e486a0e614e30fa3714580355,987348,2020-09-28 00:35:23 UTC,10000,,false,10000,0
b31baa690195865b80d744188e83bf5bb895602086475caf352f8e4f33c05bb6,987348,2020-09-28 00:35:23 UTC,499982450,499972450,false,10000,0
7050ca80184fb600438a8bfeea0dc8f7d9bf44cb7555cf1b31e24b450f96025b,987348,2020-09-28 00:35:23 UTC,10000,,false,10000,0
45e3e3b520dc3c0e9f011e0064324d0a2263f184c2b0aa38cfff5861f9c18be1,987348,2020-09-28 00:35:23 UTC,1013475,1011025,false,2450,0
d10123602ff9594939739e1aebbee16d4d6a88e2866b898423562bf4bca64ba9,987348,2020-09-28 00:35:23 UTC,230537392,230533819,false,3573,0
f1a61baff5a312485de8e698cf53136d5fb34b81ede7594e7201c50365f44a8a,987348,2020-09-28 00:35:23 UTC,89795892,89793632,false,2260,0
70e14c826c786081344665b7c303a13b0a0859bf3ea2e6f162264ec1f1663c82,987348,2020-09-28 00:35:23 UTC,100494478,100494202,false,276,0
aa2abe03b5e4c2e6bef8936f91ad8452c4e6b41bbdee1313f4fa0c7c6341f9b7,987348,2020-09-28 00:35:23 UTC,76580978018,76580977773,false,245,987320
93a850540659f2a625b11f4106e37e86067eed1567c158224af5f0c9962b7871,987347,2020-09-28 00:32:13 UTC,82581143363,82581143118,false,245,987335
b2bbd1c98967b7cfee72a6e27e9fd5ac883de9470315988ecbba6bcf16b11d75,987347,2020-09-28 00:32:13 UTC,3826048437,3826038437,false,10000,0
3e6cd2c3aad449e2c428298634a9c116c4b0c024ba7c10a950d4b3837034a9f2,987347,2020-09-28 00:32:13 UTC,891164318,891159318,false,5000,0
445d1cf81461a75c7bf37f48892c4dbed9bcaacfbc7bdc87278f0cce189c1744,987347,2020-09-28 00:32:13 UTC,84773167,84763167,false,10000,0
9ba9a87b97525222fc8de07abf804e0baee9274b55dc824d7af37d58214d1cd6,987347,2020-09-28 00:32:13 UTC,1008238,1007549,false,689,987335
462296c2c68cc24bd6dfb53d7bfd439e80e436ea06a1285d290d0f76ded33b66,987347,2020-09-28 00:32:13 UTC,100516393,100516117,false,276,0
2278b5955b507b05e4b72826832963f43403617f6960ee3168097743cd6e7b03,987345,2020-09-28 00:31:01 UTC,10000,,false,10000,0
2ede42d3aa50e955c25842c11b7f8cc0ae21176ac09a45844b8035ba97faf15a,987344,2020-09-28 00:30:38 UTC,109083884,109076264,false,7620,0
aa01a4df9fc9886741baba3eae90a5f5347aac4011d1ff35c1463c2e07f55259,987344,2020-09-28 00:30:38 UTC,107372391,107370650,false,1741,987333
d05bace0393de0dd1b07a2e497b9ea743ab98317499ac1b1f89ae8b1f6208bb3,987344,2020-09-28 00:30:38 UTC,101711897351,101711895001,false,2350,0
35ba75235588f82ac8237c63aae423e50f377527bb1a519500cef15040627ddf,987344,2020-09-28 00:30:38 UTC,10000,,false,10000,0
b8acc540ec5a7138b9876e8b607ad0a575a4628044973c8ac08ba55457adaced,987344,2020-09-28 00:30:38 UTC,1597042727,1597037471,false,5256,0
545157daa5d74449393f420fceb948dce3b091148df8c0c94fb5710a7294ff6b,987344,2020-09-28 00:30:38 UTC,26967054,26963481,false,3573,0
ddc19f103ba5196e9ef61fa39fe3ed6e40c3108b0bfcc0ee4b6fa14d5a058bab,987344,2020-09-28 00:30:38 UTC,10000,,false,10000,0
2273dfe902373dd2fc3515eea34ce74daec0f1191b61663681453250acf28328,987344,2020-09-28 00:30:38 UTC,4139787470,4139787225,false,245,987333
eb08f3d2c64b5fd0fe835f3d49378b1771768dd21a11bde161352a19898b8b5b,987344,2020-09-28 00:30:38 UTC,499980154,499968069,false,12085,0
cc97075978c43fae8ae8145f2a2b48e1283c5a90c992a4e1ef780c7a917ed5c8,987344,2020-09-28 00:30:38 UTC,5347885351,5347827093,false,58258,0
d2a5c7b172bdce0e569114d3d027454a13e4f5053645637c442d34908a6e0706,987344,2020-09-28 00:30:38 UTC,10000,,false,10000,0
ad599726fd2fd6e85882f236036aa2283b21b9c03ec8c6f48cc7c83b6e81a36e,987344,2020-09-28 00:30:38 UTC,51727841,51725581,false,2260,0
a37836dce70c7921e5a1654073563d4f01b776473e35ffe2223e816c1f27434b,987344,2020-09-28 00:30:38 UTC,1124294528186,1124294520776,false,7410,0
2913ba5b2a2271e8b1f56091e0e679af50f38ad4cdc22371e2aa5e534a5ee692,987344,2020-09-28 00:30:38 UTC,199669768,199667848,false,1920,0
e8acd32f7fd8e4cb6270f92847bc5dca8d5c403b25f16ec2a18243ae812da178,987344,2020-09-28 00:30:38 UTC,126634645,126629846,false,4799,987249
d3ed2ee57b1ad85fa4f89521b13ef13ab1c3f3f392cbd7144cc9da5f0325ce10,987344,2020-09-28 00:30:38 UTC,10000,,false,10000,0
38c18789bb8e52dcfc42103326fbc69498addfdb1b218a1449b34d4b07bf1400,987344,2020-09-28 00:30:38 UTC,3126022,3125482,false,540,987333
2d06183baac0188254f67108aafbeb7112f33076c885fe5f638342a971990b1e,987344,2020-09-28 00:30:38 UTC,499992450,499982450,false,10000,0
d248d6bc67f65c84cde5a92abe16d019eb158e3ab2a076199322f742a51b1b3e,987344,2020-09-28 00:30:38 UTC,1126685103,1126605103,false,80000,0
5b33f4a89e434d53fe01732462ff0f02c974c4370617d1574dd21511b679889e,987343,2020-09-28 00:24:11 UTC,83509143606,83509143363,false,243,987269
0638a28807324f65cadb6430b4822bc8b2aa9f1502c7c2f16fdd72b804182cd7,987343,2020-09-28 00:24:11 UTC,500002450,499992450,false,10000,0
c456c7c51edad3a328d121be0b7265f7bcfa6769063fae43a7e325d2589fa9f9,987342,2020-09-28 00:23:41 UTC,18606025731,18606015731,false,10000,0
f010929dd7459013cb9fd7159dad1b51e78088c073a92401203701c8a30e22b6,987340,2020-09-28 00:23:15 UTC,230696249,230693289,false,2960,0
4716cce37ea2d954fa9c4ecf3df76ebb10985d03cecb7fdf1793762472cb76fe,987340,2020-09-28 00:23:15 UTC,10000,,false,10000,0
c1d157f81aadb6ca9c21626879a57d3809abb590df3aa8fb1ee337abbeb764c5,987338,2020-09-28 00:22:46 UTC,1128377817762,1128377810352,false,7410,0
a3b680a2c1abe6a7f385bbc1c417058a41bdb934bb84c5265806a66a1f3fc365,987338,2020-09-28 00:22:46 UTC,53346917,53344467,false,2450,0
be96fe797c82086f98ddb8f28456dfd3d90d3ad1b3344f8b1c635f974e9f0781,987338,2020-09-28 00:22:46 UTC,48944295,48914925,false,29370,0
93c246e25786ba4a7bbb0f160244e6a9741d23688844511aaa1060a8fde7f834,987338,2020-09-28 00:22:46 UTC,37310,27310,false,10000,0
5411b5772df2be56e44cd2a3e40ba54f3308711c3ceb2aa28df059156ed5a643,987338,2020-09-28 00:22:46 UTC,4101001248,4101000119,false,1129,987327
590ddcb0a0dedd4b4d23cc8f3d3de83a11a2b29a87b57878e6d5adba7480715f,987338,2020-09-28 00:22:46 UTC,3854781,3853781,false,1000,0
db2ec71196e3e6345f7f674daf2fc1ede0ca8f451757d53251bf187fadeacc2e,987338,2020-09-28 00:22:46 UTC,19174042192,19174032192,false,10000,0
2316d632ef6aa6c48959948928304ab399ad91caa54f1066173857da777854c5,987337,2020-09-28 00:21:27 UTC,19174052192,19174042192,false,10000,0
3e49f4c979dbb8ec8765949e7f554a2905cc19c52028428bdb92e720fd53f316,987337,2020-09-28 00:21:27 UTC,127138254462,127138252112,false,2350,0
0fa9d06097ecbe31043d11c203da18e884387e0f08f98fd7da4bea48b297386d,987337,2020-09-28 00:21:27 UTC,15887651299,15887621299,false,30000,0
52d59bdadb2c88aa2364d6c22a248b57b427453816cd670b54b9077cc95d4d9b,987336,2020-09-28 00:20:38 UTC,121241917,121240021,false,1896,0
d384971c65af0a895cb1f2468033ee19f2b8ee1bba438ea0594692f2ae65945a,987336,2020-09-28 00:20:38 UTC,267578670,267568670,false,10000,0
8494feae5e09cc96a356002d6f8d0234b77891bf2a87572e59b2a9dd91a08345,987336,2020-09-28 00:20:38 UTC,196549163,196548918,false,245,987325
ba3356698620edb0213258a8a0d795b36d122707237fec657b69bb110636c715,987336,2020-09-28 00:20:38 UTC,27205679,27202412,false,3267,0
7017f1cdc4c2b8e2badfcb706177fc0e41041f0f02b90d0f709991e61e4821d5,987336,2020-09-28 00:20:38 UTC,10000,,false,10000,0
00c39fe3a04bdbf0277a94eff11dc9edfaa604ba4a0d48fa28fa12a57fb17573,987336,2020-09-28 00:20:38 UTC,500020735,500010735,false,10000,0
ba8d056dbd5e2283660d9c4605b65022daf04e831dbb29866331988aa68b5423,987336,2020-09-28 00:20:38 UTC,10000,,false,10000,0
87c1495c7e0ac66d77df971ecabe1ca014c73b8802b1f5c0c1f355000402006e,987336,2020-09-28 00:20:38 UTC,18845451718,18845441718,false,10000,0
7a826082a67f1fd199de9d7387c99d385a7b2412c1ecc37ce483d1999ef2734a,987336,2020-09-28 00:20:38 UTC,127625421,127620115,false,5306,987325
98ffb73b40f2948629688ee1d96614bdf1dc57fd8fb70975b45d4975e84a2d24,987336,2020-09-28 00:20:38 UTC,107784898,107783261,false,1637,987325
a4f937e8d9163be2611914c3b7355302c288fa642065f82900d019a429d23975,987336,2020-09-28 00:20:38 UTC,9755346883,9755078680,false,268203,0
9ba44565651963cfe12d5fa9446e43c5c91288a56733d4c17d73ce52ec154a7f,987335,2020-09-28 00:16:58 UTC,10101002523,10101001248,false,1275,987324
4a72e6b84c4377cd77d8b6ab4fc5b84f3199f7602cf6a8c04e08519bc0ca79bb,987335,2020-09-28 00:16:58 UTC,500030735,500020735,false,10000,0
5911871878f36fb81c3ff4afaf477bd0282a7f54426bd44fe3fa3e7bfe440c6b,987335,2020-09-28 00:16:58 UTC,10000,,false,10000,0
d761a27dd2da0bbca022d4cebb5081aa6bf5d6b65c519282f2074ca91629a19c,987335,2020-09-28 00:16:58 UTC,28790,23910,false,4880,0
420c6b523da777b96a2b30053e58a6bfed952b44b357486da992df43b82818de,987335,2020-09-28 00:16:58 UTC,100670819,100670543,false,276,0
8d9ca6f91cd3dbcc763c32973a31aebf01b6e6e2f672a1e928baa6081b910b62,987335,2020-09-28 00:16:58 UTC,25028654,25026734,false,1920,0
340f21df3fc46377c3c94b727f385aab0401039287ece0abeeb10409356a693a,987335,2020-09-28 00:16:58 UTC,100000000,99997570,false,2430,0
89c91a39abfb4508bcea02ad69de0deceb4aef68b940a6474fa890e5350db0d2,987335,2020-09-28 00:16:58 UTC,18845461718,18845451718,false,10000,0
a4422f127a58827ce2b5521e6108716b194c393a98b2271a384ff5bbda9e2ef9,987335,2020-09-28 00:16:58 UTC,10000,,false,10000,0
b672ce592fefd24494ebe77375d5793ad8543d2b07b3e0bdc4878087ab342134,987335,2020-09-28 00:16:58 UTC,100000000,99997570,false,2430,0
793861b4d7db580a5204fe2c1bf49d6c79829d9e72f2059c077610bcff1605db,987335,2020-09-28 00:16:58 UTC,10000,,false,10000,0
f6d9f9554bcabac9b3aa3d035e63fcffb5bf3502c9db0beaaa8bbb55a9de8a2f,987334,2020-09-28 00:12:47 UTC,230845466,230842506,false,2960,0
fccc52f9bbe5116efbc2a85e86f1e26f65f68f8f2dd2262dddf73714d83a0595,987334,2020-09-28 00:12:47 UTC,108237681,108235668,false,2013,987322
2d453695885bd38e4f48b6560f93d42ae70bf2f62ab1fbdab7c6a86478df156a,987334,2020-09-28 00:12:47 UTC,164240479,164217724,false,22755,0
b3a43ab23c7a8b96cb84f35f9f261e7a66dead0e1ba21c20cddfec80119c86fe,987334,2020-09-28 00:12:47 UTC,128375926,128370893,false,5033,987322
38e6e53fa46f04a6882824a7e525df955388d36863902825cf06ff36c53ef51c,987334,2020-09-28 00:12:47 UTC,10000,,false,10000,0
b35a3c0ab5f6095546c0fbd2420d10d6657f29e0d0e417b652fbd6718f52b81b,987334,2020-09-28 00:12:47 UTC,499980000,499970000,false,10000,0
f8a6e39b1fcb6f8daf15569fb6e1cd9f11c6cc9bce0d6b1752da7839b7d0427c,987334,2020-09-28 00:12:47 UTC,11310688,11305757,false,4931,987323
711073d286a943b816cac7fee7f4a871a2bd81a3cedb40979840a1a9aa5a5a96,987333,2020-09-28 00:10:07 UTC,10000,,false,10000,0
c32b646aa5f8990f682e21f455e2de22aeab5cb7f61d68aecb3733a2b1e090a9,987333,2020-09-28 00:10:07 UTC,134931642950,134931640600,false,2350,0
83c169be5fa566815cddaadbefeb951ccae8aad70a6a3fca9cab37411222df31,987332,2020-09-28 00:09:15 UTC,100890971,100890695,false,276,0
1582270500f68b88321bd89e5e9a97451382cbce452e2646f68d023e8f694b91,987332,2020-09-28 00:09:15 UTC,144173894,144093894,false,80000,0
e1a0f818e2e8b5501c6be5b033d5d8f1b7b96587c28fc5e388a315eb4e14d7f5,987332,2020-09-28 00:09:15 UTC,1002416759,1002408579,false,8180,0
f3a0430eb9cc49527afcb9059056838a265c311401080fa3eb96aac732bfe1e5,987331,2020-09-28 00:08:14 UTC,1000010000,1000000000,false,10000,0
0cb5bd4b2fe15cec591fbda7551d006579dde966732d677271aabb31013f4776,987331,2020-09-28 00:08:14 UTC,10000,,false,10000,0
1fbab37f1463107e42797d1f3497c6ceb76b02bb4b2882489f8f3244e10af5fa,987331,2020-09-28 00:08:14 UTC,10000,,false,10000,0
323adf7fb96656da9b015122e714ddb08f1b076c13dbbfb4a1974d473f5d51dd,987331,2020-09-28 00:08:14 UTC,12500829262,12500819262,false,10000,0
e39e3834f0d2390ad0fb1ffbc06b38bb2f5da63e041e95e442990e8a4877ffbf,987331,2020-09-28 00:08:14 UTC,306600,304150,false,2450,0
2919158a82be4658beac4136272e5b4e6b82c97c6acd8e718d7ad239125e7294,987330,2020-09-28 00:06:30 UTC,85508734951,85508734706,false,245,987318
2d954b5e9ed3a5f53280f96dc900620f2d681171c94be2e483a2f4a36ee41de8,987329,2020-09-28 00:06:14 UTC,27674313,27671046,false,3267,0
356d25f083fa94fa4c8885fb42ace66b20ca990b11583a7bdf735954b4b41f46,987329,2020-09-28 00:06:14 UTC,100956118,100955842,false,276,0
7672c59890064d63e5c0d0791f5a611a127c851702cdd348bd82c5fc34b0c0bc,987329,2020-09-28 00:06:14 UTC,10000,,false,10000,0
d18908164d72fb1a11649a3c83fca9e06f33f0fd3b9f00cf14850ec425d46cda,987329,2020-09-28 00:06:14 UTC,1033837266,1033737266,false,100000,0
f52cba7c9f05fa1c5b1f88f2a01ada8b089c916cd0f24b2c92c4c4451354fa1c,987329,2020-09-28 00:06:14 UTC,227311603,227311358,false,245,987318
1a0126ed76e9be3592a2ecf8cb1a6d8163c4c705e4e9715b28e95ab4fdf2afb5,987329,2020-09-28 00:06:14 UTC,2500529732,2500519732,false,10000,0
35abb6013084309fa1ba431565acc670e9a73ee41d14614f0bb3031aae510c81,987329,2020-09-28 00:06:14 UTC,3500523607,3500513607,false,10000,0
fa151cbd59d62a114eca6f13cd8cde69080b6a381cecbb4569e21b692d265935,987329,2020-09-28 00:06:14 UTC,238529349522,238529339522,false,10000,0
501fd903f0a6b7da2fec9c40bc7fa62b5e1aeed8e2700a66560cd1974b3d8930,987329,2020-09-28 00:06:14 UTC,500022093,500012093,false,10000,0
e4ca2f4a90014f7742676b75e1fb45e0f2e769f771096b02ae0cdec3b82bc4e2,987329,2020-09-28 00:06:14 UTC,10000,,false,10000,0
c760f44097cc3b705b4dfca87073d88484fbdd1b7a6f86061c0c74321487d5ff,987328,2020-09-28 00:01:20 UTC,138336355,138336111,false,244,987316
c1c3f3629755c2d3b63939659cf2d697ae58c5940fec0f8881ac6bdc2a5e9f42,987328,2020-09-28 00:01:20 UTC,56877676,56877364,false,312,987317
02e075659473d84346911b893c2deccb36bf4649c12e870d241fc12122b78f65,987328,2020-09-28 00:01:20 UTC,6243916,6242230,false,1686,987316
8761da1d0a63a51c6f524655e16e0ea25e91f43994762724da8750beb2c5ab7a,987328,2020-09-28 00:01:20 UTC,129211360,129206735,false,4625,987316
8c244912cd292e4c98e636661a733ceabb456bd0fe93ebe5d560f2ae58ffc143,987328,2020-09-28 00:01:20 UTC,766972455,766972074,false,381,987317
6b0ae236c50340f651a87a5d198068516300d1e4d01bc2ba401476106224ecc9,987328,2020-09-28 00:01:20 UTC,1310000,1307550,false,2450,0
b94dc3e9bf1dd780c205646c0124b82b1748f0166e7e75950f1e549036e82512,987328,2020-09-28 00:01:20 UTC,108673917,108671870,false,2047,987316
0ca6e274ebb311269e0e2ad438918921aea7b2f5b5e9229318c3500097a864ab,987328,2020-09-28 00:01:20 UTC,995098310,995095835,false,2475,0
6428af076812934c35102a2b92c26d978ee15a128f2d6d965c8cef2d926f8a84,987328,2020-09-28 00:01:20 UTC,1130000,1127550,false,2450,0
c2192ce1cada611b628da1e7c2ae8edb2ae8f34cf25d9ec61adacf76ee0d45f6,987328,2020-09-28 00:01:20 UTC,10000,,false,10000,0
6d5c2ffe573a318e2c6c85ab7980b49de4ab2771af60481642aff2bd11fd813c,987328,2020-09-28 00:01:20 UTC,132843631,132842911,false,720,987317
f285e1af4288b7d969c5202bc36c76e8f88a4ba56fc112562bfa5edc6aacc321,987327,2020-09-27 23:59:48 UTC,10000,,false,10000,0
6fabf5eef44382634da226ae9fe772579d2edc208541816c3f43fdc592af6407,987327,2020-09-27 23:59:48 UTC,10000,,false,10000,0
ed2e587417b65f08926e6c4bb4639df62446816e6d77a0b0d198b9bb82f36c15,987327,2020-09-27 23:59:48 UTC,999993740,999983740,false,10000,0
8134906a244706becfd81702293d370d4d11c3d54f84d61bf10455d488e5ed5e,987326,2020-09-27 23:56:43 UTC,499990000,499980000,false,10000,0
f8e76c545505c02660a0c5cfe366b0b7ebb399eb7022f2b0aa6cfdcf3e3cc77d,987326,2020-09-27 23:56:43 UTC,10000,,false,10000,0
27ef1bd61dfd1300615628541798502fbbf0b57866570e1c1a844379ca5fba54,987326,2020-09-27 23:56:43 UTC,1000003740,999993740,false,10000,0
adf235612c9692761c488db52ed870fc3c7cd4214b9d3a95ef7a1e81f4a85a73,987326,2020-09-27 23:56:43 UTC,231025027,231022067,false,2960,0
3a117046d871f97ee2e39675dd0ac0b9efc17aba866f3a4de0abd040ffe4eac4,987326,2020-09-27 23:56:43 UTC,1083780000,1083770000,false,10000,0
7ee69160d7e053d34757d0408e0d85dbc063e324e1c58cbefc8b91beef1d5e3f,987326,2020-09-27 23:56:43 UTC,10000,,false,10000,0
e2998902dd49ccccf3cfdc3f2c429ce6f3ca26abdc038fd34cde5d512041a01b,987326,2020-09-27 23:56:43 UTC,3430162,3430162,false,0,0
de3953df43d27cb640f2c4919fd66db300e3ecd5ca8d9832ffeb2e3f46395cc1,987324,2020-09-27 23:53:01 UTC,500000000,499990000,false,10000,0
32426bcc3e01a0f807691015857caad9da91bb9ecf4cd51efbcc5e585a71e530,987322,2020-09-27 23:51:29 UTC,10000,,false,10000,0
4c82a88a9695bfe59cb60ed8f2bed9ee98a419b5d45c72aef3e7617fca70675d,987321,2020-09-27 23:51:05 UTC,27870470,27867203,false,3267,0
92902f8993a361462edf8e2e99289bae695b81e888c512e03de2637a517033e6,987320,2020-09-27 23:50:38 UTC,130417856,130412995,false,4861,987309
58b40cf1d0af2d7edcaaeb8103e94b312b5c9884b438a8f1d0ef45074fd9fda7,987320,2020-09-27 23:50:38 UTC,109098654,109096777,false,1877,987309
0628ffd7515c2a3042b76653aeda930724a428afbb3cdc4207985be945428c08,987320,2020-09-27 23:50:38 UTC,3501642,3501642,false,0,0
6e2f4f12fe2ce617de2dfcb08b459cf72b366c0fa7ced2f73b1cd5b74a75f644,987319,2020-09-27 23:49:38 UTC,271722965,271716965,false,6000,0
b2e75fe32b3e0f465500772489306ac1f1091094012f79f5bb2c84dd6688a3e7,987319,2020-09-27 23:49:38 UTC,144193512,144113512,false,80000,0
511aadbea659c66a5cb6542798daae895584e01ce54f06d934806d552b68d0c5,987319,2020-09-27 23:49:38 UTC,2031642,2031642,false,0,0
8b684ffa7deee54c2aa8505096a8e24ec9a7491d0e0654585cc3a8727734b380,987319,2020-09-27 23:49:38 UTC,10000,,false,10000,0
85d6981afce72c856aabcb09803c9069e80db4b85a86a2ef21355c167a5a7a9e,987319,2020-09-27 23:49:38 UTC,100193798,100183798,false,10000,0
d10a21e6e5a89507cf7d87015e83cf24323eb8eb5aa3b08b542f8d38c20fabbd,987319,2020-09-27 23:49:38 UTC,10000,,false,10000,0
7dacd208d407daa6953dc2039c7552a058984fe7ade40e8d2e8c44461b1ce796,987317,2020-09-27 23:45:17 UTC,10000,,false,10000,0
cd7ca1a6eae56f2f38decaabb6f2576913902e29465c76d923ec6ec7e6657d88,987317,2020-09-27 23:45:17 UTC,136167000,136165080,false,1920,0
f21095926258fb7f5346fec88f73dc60556243be495fd22072b0da559998bb47,987317,2020-09-27 23:45:17 UTC,10000,,false,10000,0
30a2f21f95f0546183b6cde1e5bf2185c3e56670b9dd793cc89ceecdd451d513,987316,2020-09-27 23:42:39 UTC,1133000000,1132993220,false,6780,0
9e8afe33f02902cc5294718334cb324b8856c79375b7d6b28537fb8ead5e1afb,987316,2020-09-27 23:42:39 UTC,10000,,false,10000,0
035e0020dc55e2584b80d2e9a2e77a31b2479cf0a19355b61fdc4aca4e5727b3,987316,2020-09-27 23:42:39 UTC,3949567732,3949567488,false,244,987305
98f5665294cf42e6812a572f2f3c6822a134a928ddf2ce9aac2d4cb5fd8cc0b7,987316,2020-09-27 23:42:39 UTC,231230449,231227182,false,3267,0
67c00615a33ea198e39e4ba3037a4be51e5f784aac7ab613448ce93797e95bf3,987315,2020-09-27 23:40:34 UTC,131225629,131221109,false,4520,987304
0e9099f167913a59448b1f3dcb55abec6f54c12b6eb2dfcab93726660ff2b048,987315,2020-09-27 23:40:34 UTC,15987875097,15987845097,false,30000,0
a9a4ad5b97541ea317f9d6fb17d28919aae79699ccffabe55780c8b880fcbbc4,987315,2020-09-27 23:40:34 UTC,68925535,68915535,false,10000,0
23b973aed4f52537f995476c2028898744be31c1b1582d23279a29d34e9cf8e2,987315,2020-09-27 23:40:34 UTC,110647022,110645043,false,1979,987304
53df3d4741a6c3a1370c17d69af79f8b41309b4b5637407743dcd9431825d27c,987313,2020-09-27 23:39:17 UTC,10000,,false,10000,0
9b86eb8d6654853a9187baae86605bfcda901119c68b3112363dd7c41712ac61,987313,2020-09-27 23:39:17 UTC,10000,,false,10000,0
dc7e6f691adf7f6949f8dced10ba5cbc54f271c41a3bd83820e7dba627d7e329,987311,2020-09-27 23:37:31 UTC,10000,,false,10000,0
bdc403f5c48a19502d8b3cc841f1cb9b160c466c7c62757eb54103be56dd89bc,987311,2020-09-27 23:37:31 UTC,251590952,251590707,false,245,987300
9dcd84ddd65dcf560961cd44c5522bdba4660ffdab2d99cca8d07aaa5616c399,987311,2020-09-27 23:37:31 UTC,500000000,499990000,false,10000,0
221adc42434b705e8e60f5b7e0a4936baa9e501dde166b62a5ad0283cb1df569,987311,2020-09-27 23:37:31 UTC,136777910579,136777907889,false,2690,0
ba29d79ce0840613c5be06eada7d65b3381291a58852d28ea8337f324a2c1065,987311,2020-09-27 23:37:31 UTC,750000000,749997550,false,2450,0
d4da66285fde052c6d7589e987de2ed1fa060db489059923825a8f647de334ee,987309,2020-09-27 23:34:29 UTC,28064418,28061151,false,3267,0
79e4715a13e9b95be9e1018ff524a55100b02ea6e4c7f86f4cd47b6a9ecc2ba5,987309,2020-09-27 23:34:29 UTC,10000,,false,10000,0
84cf88d7ec44c2977cda054d428d82e0a179fe3d47456813f716be5ea4fc3210,987307,2020-09-27 23:33:37 UTC,10000,,false,10000,0
eb232d3d70336c11aafa2094af54a506251d2201d5cc3e81ce2ee2d2505405fc,987307,2020-09-27 23:33:37 UTC,101218207,101217931,false,276,0
ea201ba026abd3dc30bda17a6199ae927e3e59460e69b13c4b48356aae3f2967,987307,2020-09-27 23:33:37 UTC,107617859,107612639,false,5220,0
2cc4301425379eb2b63f64585968cd0b4748140bfc54d1f99bb086d285756196,987306,2020-09-27 23:31:04 UTC,110990922,110988981,false,1941,987294
885384830d8b48c76c110c6c1de0a02b66f1716f1eee4ca564c5b835e3977286,987306,2020-09-27 23:31:04 UTC,1282066061,1281986061,false,80000,0
4f1d64c067fb55463f3c020ba1a05efb05229b034b332702aecfd6f9e54dcd55,987306,2020-09-27 23:31:04 UTC,10000,,false,10000,0
f1a2ce54b3325e20b1ed73069f0d476fb8a8072b045c69483a20fa875ce58f91,987306,2020-09-27 23:31:04 UTC,65919878878,65919878778,false,100,987295
7a455e09bcc6df0424a6ddfaf0e82073eacc0774e47492ffa9e7fa8cc7115919,987306,2020-09-27 23:31:04 UTC,132131937,132126873,false,5064,987272
f3b4476cbfe6209b5d5b8da624efe5c06fbcaa04411ad523c199ce257b9d3206,987305,2020-09-27 23:30:17 UTC,1195173123,1195170673,false,2450,0
87b0db15fb120f5673e4ef8d600e0e1b4522eb041b122ff8397f389f6159e0c4,987302,2020-09-27 23:28:08 UTC,72495854,72494708,false,1146,0
c5e5ba56c020971f7692b7ef4edcba0c49d034f36f48676d201343bb5002f1a0,987301,2020-09-27 23:28:02 UTC,231641422,231636319,false,5103,0
6f03b6024c28add63afa7606c7607d3016a53f0aa2afe2d067df9628f34a5ae4,987300,2020-09-27 23:26:53 UTC,102497000,102495854,false,1146,0
1b90e21a3c85dedfdb8153754ec23f8cb949b9bef7c924757858fae7420e88a9,987300,2020-09-27 23:26:53 UTC,10000,,false,10000,0
30dcc1096c25fa594df0d269f75b36d2bb17925d4c2256c1ea71948d50b39e05,987300,2020-09-27 23:26:53 UTC,28215764,28212804,false,2960,0
d13ca75b8cb27d656241e74decd7aa1abaf73255b4522bc4e3354e7d347bcb01,987300,2020-09-27 23:26:53 UTC,10000,,false,10000,0
31dd40275fca3710fd8a6885b7f019e2c80a578983ccf1e72f198060a6b0c7a2,987298,2020-09-27 23:23:54 UTC,1196821000,1196816776,false,4224,0
688ff63192462d77f7787e906aaad7d7092bb2ba98b1689c60d2bdece68bbc12,987298,2020-09-27 23:23:54 UTC,10000,,false,10000,0
0af19a5fc8ee68a3c311b6d77ff3c3e8de93c104c7570fea03d72c844c5bb75f,987298,2020-09-27 23:23:54 UTC,10000,,false,10000,0
958c9db3dedb91b7ddceecbd9649d3fb043859638dcd9e5d3486f1bdc62a6c7f,987297,2020-09-27 23:20:59 UTC,2020797740,2020795656,false,2084,987285
0aa3869183a698c49ebf097c53deea8f8da260176b27381b998a05f447080a36,987297,2020-09-27 23:20:59 UTC,1004019,997239,false,6780,0
744098521d9123cc4bdb87816ff95cfc7dba1a728b6d7539c409488f0654f542,987297,2020-09-27 23:20:59 UTC,87028237044,87028234951,false,2093,987285
fd114c1da3088a20d9c43ee4aeadd678f18db006920eef59bb811f33c2ab0bc1,987294,2020-09-27 23:20:41 UTC,133203979,133198946,false,5033,987282
e064cbcb3c3d34af90d0023956d03187626eb28b18920e53c784b371c4b98691,987294,2020-09-27 23:20:41 UTC,111429587,111427302,false,2285,987282
7433722bca9ec691865681f49d9f375440071e473df1e53874c25f22ab144a6f,987294,2020-09-27 23:20:41 UTC,117294775,117260520,false,34255,0
69bfa1d9be9e3e4fcc7c0c42fd18ae3d112cc0ed6d1120fd95ded66d3a50f118,987294,2020-09-27 23:20:41 UTC,17770688229,17770678229,false,10000,0
4210f730060c99244c0223f76fcd8317b771c7fe93df497be55395bb9a1e61e6,987294,2020-09-27 23:20:41 UTC,14497087,14496400,false,687,987203
c7d79d995e4f523a47ad1ba51999af371baa56ecefaf3f53049561947c2666d8,987294,2020-09-27 23:20:41 UTC,10000,,false,10000,0
8dce505d5bed2373213f9fed2a246e8e8411aa5e29acdf66d4391a815af4cc16,987291,2020-09-27 23:18:52 UTC,215000000,214997464,false,2536,0
085b444174dd7f559521b8eca49e46688b2435ca749120dc23d465bf33531d47,987291,2020-09-27 23:18:52 UTC,18056856243,18056846243,false,10000,0
43fa32ddf063c10a524ad4ed6fa564944f032697a691e37f1f91b7a5d258d3e8,987291,2020-09-27 23:18:52 UTC,612946,610496,false,2450,0
ebb592461e5b161c6a06cc461c28860ac808c4497c1175112230ef1866ec2538,987290,2020-09-27 23:18:06 UTC,231817361,231814401,false,2960,0
e0d38b06bc68f6d4b30dd4f35013a00e2ea4864da3ce7b4a9ef1700b79433258,987289,2020-09-27 23:17:35 UTC,18056866243,18056856243,false,10000,0
b7372691936bd3071f44575dd695d2b9834a5aadeb44d8a343c62a45201a6c27,987289,2020-09-27 23:17:35 UTC,10000,,false,10000,0
945c82e6d6e2ab0921d4a2231dc3a9287ffcbbd4129ec47080256f30a35ac322,987288,2020-09-27 23:16:59 UTC,104487989406,104487989127,false,279,987243
57cfd5a852b1692b58d0a6d5ecb90fc847030e971e618cefb9214bdd5e15d0a6,987288,2020-09-27 23:16:59 UTC,215896937,215886937,false,10000,0
73bbc9323d5d0a49261b760d6e4260b55e4455ba138050df2913d6f9c05dbc8f,987287,2020-09-27 23:16:44 UTC,499980000,499970000,false,10000,0
a06d68d0550e9c9e8ad7f502733c977b4bc73760ab6d7b693fd359db1c03e735,987287,2020-09-27 23:16:44 UTC,278745709,278745465,false,244,987276
5a1f91e8a6bc6f85dc6ace92b57e9aa3b14f149581dbd1ddd8341b51c04e1853,987286,2020-09-27 23:15:02 UTC,10000,,false,10000,0
95a3655e7f77d0a4090d88bd8889882058285b812cac284a5346a09398160996,987285,2020-09-27 23:13:54 UTC,1697955676,1697940096,false,15580,0
120fee051aec29afff5f62104df73b72e83602f887c0fe0681756daf736e1dc9,987285,2020-09-27 23:13:54 UTC,10000,,false,10000,0
cdaf5f129bd83dceb319bac7df8d0f9e5d2e6e3b37b2120d11c992916d5b5aa8,987285,2020-09-27 23:13:54 UTC,28446010,28443050,false,2960,0
32772803c10bbde490e714d6d75c0e6aa4a4de3387e89391500e30122c696b6a,987285,2020-09-27 23:13:54 UTC,2379299810,2379297360,false,2450,0
5001c621b6b3a647d695201bf36959709d88b5c8909f806d9cfd1f5b5ece8f25,987282,2020-09-27 23:12:38 UTC,144230416,144150416,false,80000,0
81a1e5749e3d96671b60061a773b586dda64e76a701c581de074d1c12d7db9cf,987282,2020-09-27 23:12:38 UTC,4808555487,4808539907,false,15580,0
e928cc546a3b99bed79bbf007fbf42492ef205e846dfa4e6f0fe809196addd23,987280,2020-09-27 23:11:48 UTC,10000,,false,10000,0
b6acb7669087d07a28cc5cf449c921b550b89cd7cd9516ccfa2f6ac963309803,987280,2020-09-27 23:11:48 UTC,111893674,111877637,false,16037,987267
781aba802f093f5ca0f454ae527d16ff7005e33f4428e20d4b4aa5af8cd8e08a,987280,2020-09-27 23:11:48 UTC,134336961,134291926,false,45035,987269
f088dad71c65f53d731496c41f0b20ff5b1885ba6b3e432ea416d21db37341e9,987280,2020-09-27 23:11:48 UTC,231968444,231965484,false,2960,0
7096f4f9b4404222268e00f30cdefd84d467e5325fdadb577d220dbf71b6b46f,987280,2020-09-27 23:11:48 UTC,28135531077,28135515497,false,15580,0
1613e7728f1b20b9572f5320962c6ec8ff1272ed880f8720b486d5f86ab918b8,987280,2020-09-27 23:11:48 UTC,702674,617534,false,85140,0
81c8ea7066514ddcc71eda2cc6f3c2806a6ac9d42ece451b3b91ecdde8b4f126,987280,2020-09-27 23:11:48 UTC,10000,,false,10000,0
7d241af15f3e197ccc11216a92c5f803ba7c59e92d7f9fb77c148664e183fa64,987280,2020-09-27 23:11:48 UTC,499990000,499980000,false,10000,0
0f97e9ce6ff7933359331e562df546e80a4fba4f44c82326dc946e45a70bfc33,987279,2020-09-27 23:08:31 UTC,106500000,106498854,false,1146,0
f147e50c22e2634514042b8b8bcc11e0ca93c36be445b88e2aee5f57834e98ba,987279,2020-09-27 23:08:31 UTC,500000000,499990000,false,10000,0
23e7ab8df31e299712b99755484adccf475ee32aea3b7e3324a780365ac882cf,987279,2020-09-27 23:08:31 UTC,10000,,false,10000,0
6aacbf5989ba50ed779d14c245e0f539d7bd46bd619f6ae66b255a67ea301741,987276,2020-09-27 23:06:13 UTC,10000,,false,10000,0
3b7ab039894d02d5b5aa9f5b706ccf3d79b11f50fe23371cd5cbf3ce808833a7,987276,2020-09-27 23:06:13 UTC,2000143173,2000133173,false,10000,0
b052605029c2fd3f671cb976fcc5044363ac79861b1e5ddc3320e23bdb71a12f,987276,2020-09-27 23:06:13 UTC,104594491499,104594489406,false,2093,987265
70d029e487e45b4109668cc0e9238bf80fd5c4e0274750487b2942439571f977,987276,2020-09-27 23:06:13 UTC,500138746,500128746,false,10000,0
4ca99c6077c9e972bdc7561f2c44fa74aa50353702ff444c06fb24ca29c2fae3,987276,2020-09-27 23:06:13 UTC,70644,64644,false,6000,0
3e9f2068bdffc09b1dff1776424e15caeaf3a53774f20af9cf693f5799b06e64,987276,2020-09-27 23:06:13 UTC,237134392758,237134382758,false,10000,0
cfa387aa052513c9f45f0d87c9e5a2c9134a12deb253041804edf73fdf80b293,987276,2020-09-27 23:06:13 UTC,2500539732,2500529732,false,10000,0
41a6ef44863e35521b471349a3e55de816c573d9ea92a36d437bfd7db0523c4e,987276,2020-09-27 23:06:13 UTC,2000169398,2000159398,false,10000,0
281a967e6d89892bc99cc92bd169d2f41b8d5d44685e4e64b0a91071f8e04e5f,987275,2020-09-27 23:04:31 UTC,10000,,false,10000,0
ff0feff11cfa7671d10548bb8b158bbab6e76397bb45d712ed6e77dc78118681,987275,2020-09-27 23:04:31 UTC,1143235162038,1143235154627,false,7411,0
06a205368481a954f399087395584d41b6bbf1444a3e4af67eeb792c71d2ff56,987275,2020-09-27 23:04:31 UTC,316405502,316403418,false,2084,987264
660d58c6ea50221ad85adf9b2741be3fb07a79005ceb3e6eef9be335b0d120cd,987275,2020-09-27 23:04:31 UTC,34260,24260,false,10000,0
bfa0fadfcca8de440f00352bf492f4e3e68e2558adf5dfc3f00fe40350d2463d,987275,2020-09-27 23:04:31 UTC,499990000,499980000,false,10000,0
16522f87dcd30b0f62c45f53a86a4afb8a2a8442fb0bdfafbb65e4e1518d8b78,987274,2020-09-27 23:02:32 UTC,666661535,666616775,false,44760,987273
fd4b839efc7a9d2d186d6ac4b78787a38b875b8f9fb352491d55251afe0954c7,987274,2020-09-27 23:02:32 UTC,28636598,28633638,false,2960,0
869046148d8c69cc81fe73497cfec261d2e469d094e283a83a11ddd2a7a8ce33,987274,2020-09-27 23:02:32 UTC,7422,6372,false,1050,0
31205e9538c880ceff4d57294931ca81a88eeb9b0d152f3c35d069f9b6908afe,987274,2020-09-27 23:02:32 UTC,10000,,false,10000,0
d34589263ea364b1e7421545cf45f934c4e0ffe418361eed08f599b6196d97b0,987274,2020-09-27 23:02:32 UTC,500000000,499990000,false,10000,0
9c0960645e71a88d204fdefb3ed8458f0d1ea6ad95528e57d1b66a61758579e6,987274,2020-09-27 23:02:32 UTC,9215898754,9215888754,false,10000,0
ecbb50098da1d64cf7397828fb1009606b71d851ca3342752c0b12058a5bb07d,987274,2020-09-27 23:02:32 UTC,135910654,135905038,false,5616,987263
a176a764aae51fbf01254cb27e6e3f582253f55bf6f01d82fb02273bc36eeebd,987274,2020-09-27 23:02:32 UTC,10000,,false,10000,0
eb3457ed2c6661e9a41e15f1c9859aca01bd6b41a3073526d34507e05c4885be,987274,2020-09-27 23:02:32 UTC,89053034,89052755,false,279,987263
3bed18289359f2a56499fe0de8207147bd700f9454a9b98b2474cff6afb65c31,987274,2020-09-27 23:02:32 UTC,870028993,870028748,false,245,987263
285d3d3023ae2a98a1c11f6821975ef565cf613e88046249c5ca1d985e3b863e,987274,2020-09-27 23:02:32 UTC,1541923,1531923,false,10000,0
a48e72587155b324587ead7f63bf4d0f2c0f2793251909fe4dc351df0bf21f6a,987274,2020-09-27 23:02:32 UTC,112273701,112271722,false,1979,987263
e4e953547311055b56a2157f21e83f7bf49c9ed42f6c12301c0acafc9e59bea3,987273,2020-09-27 22:59:30 UTC,17365938967,17365928967,false,10000,0
325cfb2350eee80492905998b56faeee3117f979fce709b1d18d2612bf4bc152,987272,2020-09-27 22:58:47 UTC,10000,,false,10000,0
739f9de6ec96666edce369d7a7321a448878f68237c55e337439c46f06868a50,987272,2020-09-27 22:58:47 UTC,61172095259,61171995259,false,100000,987261
500c572bfc3e751c4d11cd2ccd6dbf68bdc858fa6fa2df239b2893861cb355a8,987271,2020-09-27 22:57:17 UTC,992334010,992254010,false,80000,0
e90c2b52e07f756727ca8ab47ed1c099a7c84258140ecd7d18544f79289db10f,987271,2020-09-27 22:57:17 UTC,17663418996,17663408996,false,10000,0
ef573756a55ef8d6162e6c63f5864fc21f9479834f600afa3f2abd067abf2c15,987271,2020-09-27 22:57:17 UTC,31940160868,31940148957,false,11911,0
69a1d01b51826bfbf95ef2e19d77975fff10ff4e2f209b8fd4f801eba4a589e1,987271,2020-09-27 22:57:17 UTC,870991894,870986674,false,5220,0
0dc82ca1341f653bea06e94af0cd04c768f9e41de39a48e03db049f78ad033ed,987270,2020-09-27 22:53:54 UTC,10000,,false,10000,0
e28dc367276f9700c3366178d68940f243f343ddb1f1c0b413e3b4b7c0d31557,987270,2020-09-27 22:53:54 UTC,999990000,999987550,false,2450,0
f6ca977d295666287bbe88a2fe338f17012584a46e4e35410ecedb2af96f506e,987270,2020-09-27 22:53:54 UTC,232125418,232122458,false,2960,0
e0b908d61c683517ee49738307d5d13c01eac6558e8201fb66e9b55809e333cc,987270,2020-09-27 22:53:54 UTC,10000,,false,10000,0
8d171856ac6f8a742290826244ae23189e973e32e30818371b7a654c87ff5923,987268,2020-09-27 22:51:24 UTC,15564444,15559839,false,4605,987257
603ac37c666b32646423f0d82a7ee4fd52acad4173857a7ef323aafaacbb300b,987268,2020-09-27 22:51:24 UTC,112785821,112768041,false,17780,987257
f471c53cd32762791a2469f68580fb005ca9e9a0ac85aaab3743042697f810cb,987268,2020-09-27 22:51:24 UTC,10000,,false,10000,0
7d89408f301c5700eb0b8df0726d12aef9676096c2d6dfccc672f00d89d7bb8b,987268,2020-09-27 22:51:24 UTC,28791404,28788444,false,2960,0
192828a60426053f595046f50afff2d21a764d3862520dc9753c9e4122dedc02,987268,2020-09-27 22:51:24 UTC,17663428996,17663418996,false,10000,0
33dc9a98325bebdc7c6438b02ca2e8d9d7a7d4fe8835fd7401768e68c383c390,987268,2020-09-27 22:51:24 UTC,8815951104,8815843104,false,108000,0
0879107cdd8d8e4e445311311f6f5050cb0c639c47b8a8d43b92f49dde612dcc,987268,2020-09-27 22:51:24 UTC,4115014387,4115010647,false,3740,0
ec4664fdac1549047bc47e12024e3722ac911c0414e65527b3728bb222c3f193,987268,2020-09-27 22:51:24 UTC,136962468,136920594,false,41874,987257
1502edabf9de91efd9595320f05f146b0e8587577c68e603efd5a7f433ae8106,987267,2020-09-27 22:47:59 UTC,26242538609,26242523029,false,15580,0
4cbd711cfd18c433ef8c5d364d73683185f1af50b0f7902b9150d14327b4546a,987267,2020-09-27 22:47:59 UTC,999970000,999960000,false,10000,0
e0f1fc8e16345bb61053a2e3ac5802bddebad285760d871dcc0bd5916df8e166,987267,2020-09-27 22:47:59 UTC,10000,,false,10000,0
cc0c49c5031762770bfbcc8dd1891ac33a202d82333f1c0f7c7827ffc4cabb40,987264,2020-09-27 22:46:45 UTC,500000000,499990000,false,10000,0
0d6f0ed90a67356b232f4b72f5d76454cfd1ade59c1a468fc0e32b91f2eb3b82,987264,2020-09-27 22:46:45 UTC,6495128,6485128,false,10000,0
06000a860de31e001994977cc73310b39d1e3adb92bee72f7afa013ccd3ce56d,987264,2020-09-27 22:46:45 UTC,10000,,false,10000,0
3ac318369d73c980d8e1a3d057cc844fc5d556a14ce2387a25892cd4dd065b01,987264,2020-09-27 22:46:45 UTC,10000,,false,10000,0
3baf2f70c5d4414a9c38963d32c2625e8f255ac1e8a5298e2ca6ef736f06822c,987264,2020-09-27 22:46:45 UTC,500000000,499990000,false,10000,0
bcb192c3687843638e8357b9ed8a4ce509cdd2cc410500555520901196f963b3,987264,2020-09-27 22:46:45 UTC,173222438645,173222430275,false,8370,0
1be17ab16eec1616c013739ff24a2705aeb7b72f22d7d87ccee0c05197450bae,987261,2020-09-27 22:44:05 UTC,232448152,232445192,false,2960,0
33522dbf8b745e39aae7419a8a5e0d3db235cfc4f1e38e31a66806bd23d0bbeb,987260,2020-09-27 22:43:28 UTC,101324976,101316432,false,8544,0
743373f639688b00aed1cbaac5acc1fde8541e78518a8ed3e40058c8edee179a,987260,2020-09-27 22:43:28 UTC,138017305,137969117,false,48188,987249
15bc5c1a2fef5203a69ea8693090cd90db40eb5f8d8b7e3b34282fad2a2dc0f3,987260,2020-09-27 22:43:28 UTC,500010000,500000000,false,10000,0
28009943b6185d8f8a2de338dbc6774f1b1b0aac74787d7dc736280d3d003a0e,987260,2020-09-27 22:43:28 UTC,10000,,false,10000,0
d5ccdab5cf7c40dc5a00c800bedd06ef48be25092d1ec1f0e29b8188d549b90a,987260,2020-09-27 22:43:28 UTC,1001008548,1001000141,false,8407,987249
db150a57cdfd3c7e9e3d264cef3e98acb2cc19a42dc3d3198733231fbccce06c,987260,2020-09-27 22:43:28 UTC,10000,,false,10000,0
883f8fe528376b9337c9d112560fbce3953ed9282ff38b6d53857c91607fbbd5,987260,2020-09-27 22:43:28 UTC,28943009,28940049,false,2960,0
79d167a1ed3fdc4a5b6dead0695cc61c077d297f8993da40c3791ce9093adf2d,987260,2020-09-27 22:43:28 UTC,101287947,101279403,false,8544,0
20261f9123e238313daee1550dcb79ee43ad79f54e2192caab5d942603acf443,987260,2020-09-27 22:43:28 UTC,101713171,101704627,false,8544,0
4117252b241745308ceea843bb5490339b26b1e9111c886d2ab0d7fb2cb06239,987260,2020-09-27 22:43:28 UTC,10000,,false,10000,0
4741865dd755d795ec3f55abbebb0119876e84bc5e1dea2ad1cb346208d15aff,987260,2020-09-27 22:43:28 UTC,113448709,113430075,false,18634,987205
9dc40f02d1ae0da57e0c553a618a9de4f434c3cafe5b7eb41663675f1a9c22b4,987260,2020-09-27 22:43:28 UTC,108687661822,108687659729,false,2093,987249
3cced39b5b1ca0bcca92816ebc57023942a804da61291dbd7f70003e42730b6c,987259,2020-09-27 22:37:26 UTC,568358761,568278761,false,80000,0
10ce610bdccfd839b8592355bff62cb9fcc52d5ebba7d36d0eb450e8fca16ba2,987259,2020-09-27 22:37:26 UTC,2020697740,2020695656,false,2084,987246
460c8469c5be7dc786fbf5e38a4266ac0a69a469e416f0a8a0e9dbc7d11693b2,987259,2020-09-27 22:37:26 UTC,362372,348612,false,13760,0
3a536c19ab558fe1d3e55d2484b293d755ce8c62f0fd6facb8e990884cf6aa16,987257,2020-09-27 22:36:22 UTC,72134854,72124854,false,10000,0
765728c21d09ee28f933bc1613cfaff96358ea05a2f353036d3580390eb2d5a1,987256,2020-09-27 22:36:13 UTC,1500032960,1500022960,false,10000,0
6143a8c71315b0d4b581ce05fdf9cec5229e378bd0f789aeda460e7bb1ba7865,987255,2020-09-27 22:35:40 UTC,232596555,232593595,false,2960,0
4b629be7b69b4c2d348160c26a78d4adfb67ecd45bc2cb6beba013be7a6c5716,987255,2020-09-27 22:35:40 UTC,9000753826,9000738246,false,15580,0
385e68d7d8dbe1f746f1c5dd0420f87c69c851d4736ce51414a7408862ee3f0d,987255,2020-09-27 22:35:40 UTC,10000,,false,10000,0
e5796624d6b0cb8f75c1d4b2b19d7e7cb8260a22c04809ca0edc937455c04e34,987254,2020-09-27 22:35:03 UTC,1025672611,1025596495,false,76116,0
3fa21232e1f610cc3b7744b4c6dd65bea842e1e4910add85485d969260c0cfb2,987253,2020-09-27 22:34:31 UTC,499990000,499980000,false,10000,0
b30f569fad1172834dd45517d4dd7e6fb678d78b0876f562cb8560e13e202f75,987253,2020-09-27 22:34:31 UTC,10000,,false,10000,0
54a470f78753f8e345e90e790494378612c4e9d44c8e820b741f846820b247ac,987253,2020-09-27 22:34:31 UTC,19056327049,19056311469,false,15580,0
27fb1e43a4509b553e475547810163dd140f0db1ea6dc75b1c2e7cc7aec41d22,987253,2020-09-27 22:34:31 UTC,109286597815,109286595722,false,2093,987242
a643026b235ed3e915b2ff7380f2c5288c42de5fb132530de791a4bf5cabdca3,987253,2020-09-27 22:34:31 UTC,345123528,345121435,false,2093,987242
7b75c5a929b25d54c8baf172f65225e586ac0d62baf9aae44f0732b44267ad4d,987252,2020-09-27 22:32:17 UTC,500000000,499990000,false,10000,0
e1fe94a1d4eace32606641e3282b070c653a75ef1faf0ee995aaa5a908ee8fee,987252,2020-09-27 22:32:17 UTC,10000,,false,10000,0
7a6e4c5cf7a7fcde18da7e9a353aca562feb605354d2a52440cc61eae6e2e88e,987251,2020-09-27 22:30:26 UTC,16060039951,16060009951,false,30000,0
7143b1914f1aea6474dab802a64dce64aecf04b2dcd5aa2427fa822a47341edf,987251,2020-09-27 22:30:26 UTC,10000,,false,10000,0
abc356603538c5f15ffa1daa05f74b2bc458aecdfdc641b5c9c5e91a290561a4,987250,2020-09-27 22:30:16 UTC,114766235,114743825,false,22410,987239
27c552fc9e5f5ac7df06985860ceb811094fbe70a4b8593567c19bf60920eed0,987250,2020-09-27 22:30:16 UTC,139330017,139286417,false,43600,987239
1b36dec24b9e429271880793a5f3efa68e60d68180ead4fa10db6b5923d116b1,987247,2020-09-27 22:27:36 UTC,10000,,false,10000,0
ced30fb6254a528c08944d7386b06cb87b4f3b6805a70f65aa64c076187d0ce7,987245,2020-09-27 22:26:44 UTC,29087638,29084678,false,2960,0
3978c737f3b7b091d4cc4e9601847b7fdf7e104e6d9014ab524f6d6a3c500284,987245,2020-09-27 22:26:44 UTC,10000,,false,10000,0
00eb9c707694f47c604f3c5be564ee13eb840aa435e8448ae70628ea553f9446,987245,2020-09-27 22:26:44 UTC,101912127,101903584,false,8543,0
0e00ce71c6b65a816e27caa5b8346cf1a495f24130dd2c0906acb619cf86621b,987244,2020-09-27 22:24:27 UTC,10000,,false,10000,0
8f1766c4d7153f8ae4f5cc1e4a4d09fe27eb3691f8bd7d10b843d3e3c1f53247,987244,2020-09-27 22:24:27 UTC,499980068,499967983,false,12085,0
58bfb6768ad3fe44a90cb66954c3df5470e2e77d175d6d06a681ec1e1720e614,987244,2020-09-27 22:24:27 UTC,101941311,101932768,false,8543,0
4bb38868473737e61781092b9b58a3eb79ec841eb83052a66f85f584e1912539,987242,2020-09-27 22:22:38 UTC,4400000000,4399997550,false,2450,0
27f962d4d7e8bf3da5f9d78446852c656a137dee448c068311c30e5fae96bab7,987241,2020-09-27 22:22:24 UTC,4050402185,4050398445,false,3740,0
08a8aa5932839df6bda57402436c17a79893c326cc9c032edb2d3ab9f804f6e4,987240,2020-09-27 22:20:49 UTC,140349040,140307180,false,41860,987228
8e441202dcf635a42a471f57e64886081300e56548afdb5eef0fa46e454de3f3,987240,2020-09-27 22:20:49 UTC,115716421,115696328,false,20093,987228
408eda4dd27fb97e05371f90e79ed267344258db1af460548da1b5e6ee31579e,987240,2020-09-27 22:20:49 UTC,10000,,false,10000,0
6821fd9174a60ec6460c2dfe179927b72eb7d9862d323fa5ae3b37063f62bcd9,987239,2020-09-27 22:19:44 UTC,73178,64976,false,8202,0
9d2dc8a9fc069a0f54d19afdb2961f97df93c160e9313b97edc921e270695579,987239,2020-09-27 22:19:44 UTC,11704584,11694584,false,10000,0
d113f93be7428ed441b0da732adb9e50f151e0966d06d0819dd4569229b9f9de,987239,2020-09-27 22:19:44 UTC,10000,,false,10000,0
52b2cd6c7ad9df8f84fa94b49f0dfab52b3d4babebbc52c898af8434083432f1,987239,2020-09-27 22:19:44 UTC,285645661,285577317,false,68344,0
e342b2fead10d185f3b2d44e5574c5baa8294f311b8f4c7ef3a5098c953c6cd5,987239,2020-09-27 22:19:44 UTC,164171744,164169660,false,2084,987227
c78b73587f52e4118732be7f43347160fc64d80363c5e7759cc6dc0a4f517b22,987239,2020-09-27 22:19:44 UTC,86681976,86667582,false,14394,987228
d5a3503e686472357e48a181f6a0d3f4da294a76b2706a3f23421337a696d20f,987239,2020-09-27 22:19:44 UTC,378040628,378038535,false,2093,987228
9c5a1e7a0d744a6f91c26d5e8ddb03778ba3591a199397e61f474445981d4302,987238,2020-09-27 22:17:07 UTC,8045501,8035501,false,10000,0
84ff755f94a0e3c10a27322a0017095c51220d44d24fb67af7c1151a2d00c39b,987238,2020-09-27 22:17:07 UTC,2550000,2540000,false,10000,0
9f107231ba51c3b708a029c11d335601568a92cc0fa3aba5cc4428fe48484a11,987238,2020-09-27 22:17:07 UTC,232764522,232761562,false,2960,0
3230d1e6c700d33546202cacd45adeb0f192409fd4885b8f5f6d09e9a98ce354,987238,2020-09-27 22:17:07 UTC,10000,,false,10000,0
ef2f228c34f3f421081fa3fa01a5b639265f30a96144d0d7f403649cc1954e24,987237,2020-09-27 22:15:16 UTC,1712552379165,1712552377072,false,2093,987225
e35c3d17804cd393d1bac53861f7a5654be7a937c6e77bcaacd0ecc41bdaaaca,987237,2020-09-27 22:15:16 UTC,17212487119,17212477119,false,10000,0
91b0d5b35ac61093c8ca094bf007469fe18c96a80aa5883647344fa237fe725f,987237,2020-09-27 22:15:16 UTC,18080714,18070714,false,10000,0
04f8edc3c66fada260dca13b7b58d0d16a2fcfdf63f516fd1fcfa7f1304d5b18,987237,2020-09-27 22:15:16 UTC,10000,,false,10000,0
77740d2d1b9d1506e6043f5633c17e3201dc5935a1673117944f6a1e9d4c802c,987236,2020-09-27 22:13:21 UTC,110483420908,110483418815,false,2093,987225
eba6a6cef59c1fe15287dd9210dc5d06fa144ba4cf201db37a969bcedf0dac1a,987236,2020-09-27 22:13:21 UTC,10000,,false,10000,0
f2f490b3fe45197d5fd489c4f3762a9d60f1ab2d353b43fcab2ceb0a846ae69d,987236,2020-09-27 22:13:21 UTC,115860475,115848475,false,12000,0
5807d179a0b930bf7138f6e3248cf21b949cebe212aed6c2082196932e282096,987236,2020-09-27 22:13:21 UTC,17412690841,17412680841,false,10000,0
45e3e2fdd42d8a7de999f90df1af9a5b19974c55b8ac1ee863090db203df318c,987236,2020-09-27 22:13:21 UTC,10000,,false,10000,0
759794c49cff8265279be7c8514b1194347e6865fea88d3c84fddbf9c5f386d0,987236,2020-09-27 22:13:21 UTC,102097333,102088790,false,8543,0
984de8db9f4350b33a0694b9d0fb8eb77669f0f6a4292bbc992be570fbdf0d56,987234,2020-09-27 22:10:41 UTC,10000,,false,10000,0
218594a16ce4dd530af30d30f9049114a6d4c81dbbc8facc3fc381501540dc8b,987234,2020-09-27 22:10:41 UTC,159968361,159947626,false,20735,0
c7990eafad45572b5ca8f87864e60866c2b9894315070c9f56ef1de9da7bfcc5,987233,2020-09-27 22:10:11 UTC,10111458,10109008,false,2450,0
ad1e321817b0f3ad359bbf1045671e5987491671cacc98012fa14aef67f20a94,987233,2020-09-27 22:10:11 UTC,57585373,57575373,false,10000,0
183e1954cec79785e1d48fb2ad89658d0282af247451ee8265f93670e09d15fa,987233,2020-09-27 22:10:11 UTC,116514488,116494711,false,19777,987211
0fca4d6381a0b6cd1fd74eb35346a560c97f0ae8f77d7c451650ca787cc94aab,987233,2020-09-27 22:10:11 UTC,17412700841,17412690841,false,10000,0
bbd37fb65a906d1fb0c8be120ea55c4a5be2fd8354223f6c680f6b6d4b97947c,987233,2020-09-27 22:10:11 UTC,10000,,false,10000,0
d9022e0c51f23224de1fb1abf55b68373d6cae2f266a952c105c148de7956ad8,987233,2020-09-27 22:10:11 UTC,141437999,141396438,false,41561,987222
4ff7b211e7ebc6db76e4ed999744b5dbcdf7db55fc6002da83e0b3f17fd59cab,987233,2020-09-27 22:10:11 UTC,29835586,29832626,false,2960,0
b4cfa7a59c4597c87d3c80d527fb064e684845722c748ceeb1c563c0a0611076,987233,2020-09-27 22:10:11 UTC,114511975289,114511973196,false,2093,987222
5be87b6c36aefe3c20fc32cb753d17f970f154ef1a1488b618ec7772cb68f227,987232,2020-09-27 22:07:24 UTC,499980000,499970000,false,10000,0
097ef48ab80be37447898932b05e9848eefe22abe2e7b97bd2aea8efcb1b44d3,987232,2020-09-27 22:07:24 UTC,3000292184,3000282184,false,10000,0
8b455f766441d47d6271fd6f7732131e6e865bb8febaf1a4d93d507ddb13080f,987232,2020-09-27 22:07:24 UTC,42287527,42281527,false,6000,0
72d9a10c0847f74143a36ee9124ee65b3db47fcc4f38672e2a9cfbd6e0e589a1,987232,2020-09-27 22:07:24 UTC,500063793,500053793,false,10000,0
a14aef21a333dfed0094a28ed6c4a7fd19d00290a050d1ae5cd74fb8edc9c4de,987232,2020-09-27 22:07:24 UTC,16694165,16691735,false,2430,0
ea54e61eef8f731a5d5a0a16730ee552a37c59a7c2440ea5f226fd8c584761d9,987232,2020-09-27 22:07:24 UTC,10000,,false,10000,0
e61a5a2819da44c99fa470dd2454b50c69bbeb406023da1581f350b3b0ca94eb,987231,2020-09-27 22:04:34 UTC,234794143238,234794133238,false,10000,0
41797fac851f29cab99ac06a14de918db28d14c810a6dee8799fbd4261a3458f,987231,2020-09-27 22:04:34 UTC,232941315,232938355,false,2960,0
62415dbdbad17f903b9942fb81523f1ce867c7bf42a5aedca996f978f4ae9222,987231,2020-09-27 22:04:34 UTC,2000179398,2000169398,false,10000,0
6c6230c198410188f46868d0675cc57273219ad76592b08b7603c6315f6bfdc3,987231,2020-09-27 22:04:34 UTC,10000,,false,10000,0
0c076b24df47984f868992eb2863bc70b470f8b25e5b4523627fbf349df2178d,987231,2020-09-27 22:04:34 UTC,499990000,499980000,false,10000,0
ae052b1cba0bca8c2bf21805c96b038b6d26974afd2c2be9e5dd1be183591580,987230,2020-09-27 22:02:41 UTC,86066579,86055779,false,10800,0
40e8219697433fcb32cc7ebe8b5be2123e0ff3c08ea0d729d6c6abcac9a0acda,987229,2020-09-27 22:02:35 UTC,17253703490,17253693490,false,10000,0
5dafab3cb5f3baba25a0dce334f427d25acb845d65f11dbc7a212189227c9d1b,987229,2020-09-27 22:02:35 UTC,102126631,102118088,false,8543,0
69e145faeb32682265de0be5e43a912dc655d682bb414cbefe013488d998c6c2,987229,2020-09-27 22:02:35 UTC,421310313,421307930,false,2383,987218
135c45193c793b4d587d808740f9d5e8460a40925d594292e8e5e90370d99af7,987229,2020-09-27 22:02:35 UTC,19134346,19127205,false,7141,987216
98c0f391f03204ff300bad08bc8383e69e793a6f0560bd4232518921bc8c56b9,987229,2020-09-27 22:02:35 UTC,102472000,102463457,false,8543,0
f9481cb63cf576a680ecf1fa6288a0d53dbf174b0ce22d48bc35c0f8659bc286,987229,2020-09-27 22:02:35 UTC,167578053,167574508,false,3545,987218
9a24f615630a7e8f0a6cfa59ed32b590a42975e555eab2f92515350e8e309108,987229,2020-09-27 22:02:35 UTC,10000,,false,10000,0
953792b546e5b33c5096f72c519d59c7f8217f713c7f0301d299a152f32f20db,987228,2020-09-27 22:00:35 UTC,117310471,117289498,false,20973,987216
6f2ed0f6c40a85ca1e3702cc75442ba11cbd1aef467be4d865be02ebbd5e05f0,987228,2020-09-27 22:00:35 UTC,492510000,492500000,false,10000,0
08997fc8d1da62088e79882bf3635df78f4e22a67c562da9344b8d83ce4c1d3c,987228,2020-09-27 22:00:35 UTC,999970000,999960000,false,10000,0
3826f4a01251ff408a90c5440ecd99cca157634aa99aa92871037ef608287c6e,987228,2020-09-27 22:00:35 UTC,5573799830,5573794346,false,5484,987216
62f66759e9d8048566bb7d29b557881c2d9bdf27e98c84f096ae535697aff523,987228,2020-09-27 22:00:35 UTC,102502637,102494094,false,8543,0
3c92ca659695be840f1e98352b49da0b1f00f14aff30ec18f0e53ad9c149dbd8,987228,2020-09-27 22:00:35 UTC,142639011,142598595,false,40416,987201
349f09da31a29aaadfe3f8e1dd8e18f0f7862ece875f181591b47802805edb1d,987227,2020-09-27 22:00:04 UTC,9474238,9470881,false,3357,987215
24304dbafa652d474d9a1c327be032edd008d802344fc98cb2a9235d8eb2efaf,987227,2020-09-27 22:00:04 UTC,500000000,499990000,false,10000,0
6ea6230c02e51a379a2fd04b97df5b12c97d649e3624662319262172f2c37b7b,987227,2020-09-27 22:00:04 UTC,10712766,10710682,false,2084,987215
1364267875b830874aaf5a72d018c2b82f1e9f0fceecdf63bc60c1d95ea5d2fb,987227,2020-09-27 22:00:04 UTC,427056574,426976574,false,80000,0
3809783cfcdd8dca225c38a94e57df8b4e79c4c9449a63c6c4ee4512ff37fef9,987227,2020-09-27 22:00:04 UTC,22946384,22941771,false,4613,987215
abca6eb0d0da880f2844c3369dc216825ad94a109d2cd7416aa0074f91741b89,987227,2020-09-27 22:00:04 UTC,20363954,20360606,false,3348,987215
c5a52075a74d9b57a9a5043cb5370c5bd81cefcfe16e053ff8a58057c97edfe3,987227,2020-09-27 22:00:04 UTC,15538905,15534292,false,4613,987215
56e37709fc390a9785d40117701dc3dab3b67a5ff19b1018b6278658adafafc6,987227,2020-09-27 22:00:04 UTC,10000,,false,10000,0
fc73bd6d71d32b5002c1afb392175a15a6196d19194a700aa2b5df14096a33af,987227,2020-09-27 22:00:04 UTC,10437102,10435018,false,2084,987215
28070c9b27728326a88740268f9ce73deb3da7b31b1dbed4b367e815a5a97f4e,987227,2020-09-27 22:00:04 UTC,23670356,23665752,false,4604,987215
1475649972422f8361c729a4b299058f2378a4af10dabd3647eee4a85a1928c0,987227,2020-09-27 22:00:04 UTC,7274655,7271307,false,3348,987215
4933716d11b38acdb3ed8ed8e65eb2653802db802ffafa7cc0557e78385cbc0f,987226,2020-09-27 21:59:01 UTC,17851479915,17851469915,false,10000,0
03b7836681654fdc76d80ee7e1a3ed32eeb5a9ebbed1d6a1f109c539875b45d3,987226,2020-09-27 21:59:01 UTC,999980000,999970000,false,10000,0
a6ddd4bc172d4c8fb6aeae4add18fd4f139ce6a641c8c186f1b44b627d1abbba,987224,2020-09-27 21:57:17 UTC,114611477382,114611475289,false,2093,987212
83d80ff505bcb6a03476d0b806e913d7a9cb8f1b7bd74ae284a67df76f404ce5,987224,2020-09-27 21:57:17 UTC,550000000,549994900,false,5100,0
7f704fd390c8b6ee473e9ad9a2a18e129a56f932b5165d50c1a2c9bc5814bc00,987224,2020-09-27 21:57:17 UTC,10000,,false,10000,0
9017d5b1b91bfdb562d92132c47c10962ef13b4e3dec8a257f65ef00838f75cd,987224,2020-09-27 21:57:17 UTC,360000000,359998080,false,1920,0
fd4040f17d9fb083529e114e9d4b7738a7a1495d19baaa97adea0ba9f20acdd9,987223,2020-09-27 21:55:58 UTC,111435632,111431892,false,3740,0
38277a20bd57cf8a39f3db0031a60273d21a59ed88d651f37ea4bf822634cacb,987221,2020-09-27 21:55:35 UTC,886078876,886075528,false,3348,987210
c6698d2d3843106c71f66224c19e775105366e8eee6afda36fdb22687e2db23f,987220,2020-09-27 21:55:14 UTC,260984566,260965366,false,19200,0
c0a0497b66d8bb4fe564578007c2885d75cc0f9deebf2fd31552f067fff8d97a,987219,2020-09-27 21:54:59 UTC,30019474,30016207,false,3267,0
5d7c51961b93fa8466a27f28fe59ebd82b0647620098a43f5a14960f57317139,987219,2020-09-27 21:54:59 UTC,10000,,false,10000,0
49f111336bb932564409eee7dea24e5eefbc78e297ac6175855c46edaa792dd5,987219,2020-09-27 21:54:59 UTC,625539437,625529437,false,10000,0
f4841f71b43b1e8685b63268c23af702d043e0b22a4d4a8a76e0c1e3fca44e98,987219,2020-09-27 21:54:59 UTC,552153967,552143367,false,10600,0
7c98efa5f034f9b633afe825873b15b3ef7548a8bac3ab670b28198e8fb68227,987219,2020-09-27 21:54:59 UTC,10000,,false,10000,0
be8b8e430c49c4e87326ce74f4bfe46e3a7b033fbcedf86b8d39c09e4fdb0bf2,987219,2020-09-27 21:54:59 UTC,500000000,499990000,false,10000,0
e77a9d93f278aa1c194d6697eda63606fb95fb19607f90674a9dee29dd04e9d6,987219,2020-09-27 21:54:59 UTC,10000,,false,10000,0
6ba406b1ab6d75baf6bb4bf8a3b18b72bb61e468bd59c4291a2b53f54ca3276f,987219,2020-09-27 21:54:59 UTC,500000000,499990000,false,10000,0
992f7631747a5c228bb0d0e42e949077839813a9e6fb18d753536d67f5e1be62,987219,2020-09-27 21:54:59 UTC,102576803,102568260,false,8543,0
111cee45b74a6b04805f04f6a6055f1aadc5c51535f75fcd81b95f7b58b3d90a,987217,2020-09-27 21:50:30 UTC,500796420,500786420,false,10000,0
6dc5106c8495a06b6cd8d4f9d9825b8c367d5dcbffdd0295897e1e348601c564,987217,2020-09-27 21:50:30 UTC,143640398,143601143,false,39255,987206
fa5d455f845b2e72d49f79e90e1c107a30c62857b7b29ebdb11b731196ff3ee8,987217,2020-09-27 21:50:30 UTC,117880271,117859879,false,20392,987206
681101b28ac792182cc2249ef15c6391b487055c7e46c097b8bf50f209633f46,987217,2020-09-27 21:50:30 UTC,159364881,159361089,false,3792,0
e0d158333042b0bdc44c58af8da784839659b25cd5fbb6f9a1cf80d586e67c25,987216,2020-09-27 21:49:10 UTC,2020597740,2020595647,false,2093,987204
c6f45f98296f880c326c198664e133270acad6a8ead9d59a0714483e1f968c5c,987216,2020-09-27 21:49:10 UTC,10000,,false,10000,0
7d3dfffbe95d3ee6dfe86428164d98322e6b33effc95319e0fdba15bad1d5898,987216,2020-09-27 21:49:10 UTC,500021920,500011920,false,10000,0
1766457f362a6113cc5b2db2e16bb1077eecd659e3430f76954525d7ce59191c,987215,2020-09-27 21:48:44 UTC,102609073,102600530,false,8543,0
0b01583605b44ae3e01636749bebd84b83fda5d2f4adde656164cf11eabf881d,987214,2020-09-27 21:47:48 UTC,10000,,false,10000,0
5395e0b73e344cfac4470dd1b8152e596e71259d283fc8360f7caa1335f3a963,987213,2020-09-27 21:46:32 UTC,233092464,233089504,false,2960,0
741e288e962027af80ed6ac29aa541a0ff3877df76e0f5eecc8bf0551c30b15d,987212,2020-09-27 21:46:10 UTC,10000,,false,10000,0
f10ff9787f80ab9e27c0bb2b37329290b620b57921866480405901f5d61db624,987212,2020-09-27 21:46:10 UTC,500031920,500021920,false,10000,0
c6a8f92b2900e4222c133ff58c2cddcecd0c20cb96c9b51d4780be3d03bacff0,987210,2020-09-27 21:44:01 UTC,34464116,34442616,false,21500,0
c847f0de4e5d413070fc86b827e82c0934f2e6be696fa5152615cd42472cfebf,987208,2020-09-27 21:43:09 UTC,51893959075,51893947165,false,11910,0
7c8810470b91d0c6a491c309803f3202a5986f83ea8cc5f7f86d238ac8936382,987208,2020-09-27 21:43:09 UTC,10000,,false,10000,0
0f20e2a7dd4d95f65b7826d4cf81233575f9addfb27a370ae0cd186548209d80,987208,2020-09-27 21:43:09 UTC,102846329,102837786,false,8543,0
c34cefab3ef85631f5fd0c345f29f6abd418253c80c3622ec4dd0cd3468a14f7,987208,2020-09-27 21:43:09 UTC,362560000,362550000,false,10000,0
1de5b64eccb6a1994d75fd47979ce352aec88f5eba9a73a95fc024a6e3e2d666,987208,2020-09-27 21:43:09 UTC,448297438,448287438,false,10000,0
cacfdf9a797dd43d68d27bef1dfe0036565f59d20d925b496d4a98790533bed2,987208,2020-09-27 21:43:09 UTC,144312404,144244060,false,68344,0
b5cc9e40b06a45c56ba65dae08e66cf9f9c3741a73cd0405c8c438f8e8c8c8b5,987207,2020-09-27 21:42:13 UTC,233348267,233345307,false,2960,0
489e20026c6f8e894bdbb8bd15e96685aef7caa0946b6468e2704399f4e14a11,987207,2020-09-27 21:42:13 UTC,10000,,false,10000,0
f32df7c69a005e187de3b8c70325a70d7377ea39dd4d216ae3ad83e371928d9b,987207,2020-09-27 21:42:13 UTC,362570000,362560000,false,10000,0
8ab1487f7e4cae698a372986ce0f1a48b95beffd2d902cec63dcb4608787b793,987207,2020-09-27 21:42:13 UTC,118581861,118562341,false,19520,987196
4a589520a432a907ae2c278e46da381d28c8f789b23b1745da48fb4d87c217cc,987207,2020-09-27 21:42:13 UTC,10000,,false,10000,0
c9681e77c147af80304f5767bd069eb504637de316ae7c722d2b5c7278ffbd11,987207,2020-09-27 21:42:13 UTC,10000,,false,10000,0
fa2b8445bc528c64022c308356a62ec028819a7e4091b8c6c7e8a137bbf7e098,987207,2020-09-27 21:42:13 UTC,30181776,30178816,false,2960,0
30e1bff3bd2dfffd5f1a895f2537a6a0c3f86b4fc269d1c5d35ba402e928f166,987207,2020-09-27 21:42:13 UTC,10000,,false,10000,0
94191b91e9d5fea765abc5dcee35c2349c1639e575ad56505aa7e6d89f6de515,987207,2020-09-27 21:42:13 UTC,116357830875,116357828782,false,2093,987196
2a99ba48905361204b257dec734a931672b23f627b853aa146fbad798414032b,987207,2020-09-27 21:42:13 UTC,102880067,102871524,false,8543,0
fefb9028a01173c279e0f59db6de9dacde02c6b3802a29a9836684f71f240e24,987207,2020-09-27 21:42:13 UTC,144695667,144655831,false,39836,987196
d21b2946253b0477eeb5211787936a78fd4cf27ab0196e66542df070d9b2b45a,987207,2020-09-27 21:42:13 UTC,1218618,1059818,false,158800,0
f45984ff58f0bde3f67ccbda31969030122c124670e9544c98e0c5e760a2d33b,987206,2020-09-27 21:37:05 UTC,116469223533,116469221440,false,2093,987193
c0efb840aa6a178372aba1527a2898817593ea3ca5c75896f02dbb36db6458e2,987206,2020-09-27 21:37:05 UTC,360314431,360312347,false,2084,987194
3a549948d7ccf0cd028e3c6edef57e2a27d1bef6beeec87706bbef3e25b1f19f,987206,2020-09-27 21:37:05 UTC,102911273,102902730,false,8543,0
e5aa8c8cae6e3638babdbd1983223ea36729aa2c57f2d5e1ed5b074e3a2bee3b,987206,2020-09-27 21:37:05 UTC,1860316524,1860314431,false,2093,987194
738769b37791aab438a424e98088560cb30f5e2500e109080a9070b324e16232,987206,2020-09-27 21:37:05 UTC,9260318617,9260316524,false,2093,987119
07f472fbc145659c58ad8ec2ca76cfa4a7e134e2047f5b5ecf0f6afdf8fefe5b,987206,2020-09-27 21:37:05 UTC,500010000,500000000,false,10000,0
8a2cfd4db70f8f61e1025f0bb93fa69ffe0b2e290a168c283ec00d1523728905,987206,2020-09-27 21:37:05 UTC,10000,,false,10000,0
cac11d6622aaeafe06efe9c401544ae073eb8629200fce8174d0fe2d731dfabd,987205,2020-09-27 21:35:43 UTC,10000,,false,10000,0
b92777f1913e521eb3160eba8402a92e56ce344fc00792084928b420d4d3278b,987203,2020-09-27 21:33:43 UTC,2677661158,2677658708,false,2450,0
054a0b88827a80f533c975f432ced24b327e1c78733ed359ba93a2f9d778de06,987203,2020-09-27 21:33:43 UTC,560000000,559997907,false,2093,987191
577a746f6015d4a85103fe561a9b39e561146579930548f5818f004c31d88a8a,987203,2020-09-27 21:33:43 UTC,116569624626,116569622533,false,2093,987192
3c7696a0c51cf069acafca76bf794c5fd30fbadc12861950350604735ae9fe2b,987203,2020-09-27 21:33:43 UTC,36189164,35819804,false,369360,987202
1e6a31a697267bb45a49f1a131dd2c8918ac1f98845f920a4584364122d868ab,987203,2020-09-27 21:33:43 UTC,233507910,233504950,false,2960,0
c5fd3a32b3c99b7cd1902b7142786ff73cfa1627b56467f65f78ef0394143bd0,987203,2020-09-27 21:33:43 UTC,854047814,854035729,false,12085,0
79039d18acd5d571a42e77be63f9275d99a870397a2ee23f97086ee8d5c791cf,987203,2020-09-27 21:33:43 UTC,10000,,false,10000,0
cde4ddadc842882f68eae5bf276e61a66ff2a7c8b9327281e92fd8660ae6469a,987201,2020-09-27 21:31:29 UTC,1025655745,1025638523,false,17222,987189
ea0ef209e86b71cbeacd3b6b0b97fa8c260f0776518895075a1ff5f150c0ac08,987201,2020-09-27 21:31:29 UTC,10000,,false,10000,0
747ed7c744821842205d617901dc67405820b81a9c5c46afad409ad599461536,987201,2020-09-27 21:31:29 UTC,10000,,false,10000,0
710f4fcbcac0b44223f39f52d08a84c784b95537a312be3a453a3b630a1c7cc9,987200,2020-09-27 21:30:43 UTC,147147222,147126643,false,20579,0
fd3aa336dab56d9f255dc49c3345de7723d265a6926ed11ef94c9d6fba2e5c61,987200,2020-09-27 21:30:43 UTC,119137075,119114941,false,22134,987189
8ff240f3717d67907256e8422250981578c159effbef8e001cdc2e9343514d51,987200,2020-09-27 21:30:43 UTC,116669026690,116669024606,false,2084,987188
f3706c785facf2ab31c166d6bb1f3643aaec8eb1ba1607b3b13431db3b817d04,987200,2020-09-27 21:30:43 UTC,146061073,146016573,false,44500,987189
1b1d2a082cfbe02b8ca0c58bf9ed0c1a1f6dd54d1c61c34d0441f2e8f0bae902,987200,2020-09-27 21:30:43 UTC,17351477995,17351467995,false,10000,0
45e7bdd07b8c6466c4966a3786095b191777920c64d37483bf91cd63e709ac31,987199,2020-09-27 21:29:09 UTC,10000,,false,10000,0
c2d1e6d2107b20b41becf54d73ea99ab0f562b19c00aa0670049d3120c7cf065,987199,2020-09-27 21:29:09 UTC,4150,2230,false,1920,0
67ea11d295447156ed5c9eb5d321aafd00d81072edbf4cec60399d602f377ce9,987197,2020-09-27 21:27:35 UTC,17964038464,17964028464,false,10000,0
9a0c666c4dee6360048949087b613573bffc9507d6a25a146888ed971f7ca814,987197,2020-09-27 21:27:35 UTC,30375597,30372637,false,2960,0
98b7f398e05fb3c5b211249c71f05714e0837c9d40f7b3a69467bb6693b5cf22,987197,2020-09-27 21:27:35 UTC,10000,,false,10000,0
50bd84977aa6d1250b6bc715347dbec7ab46b41dac81c715bd9461af1b418abf,987197,2020-09-27 21:27:35 UTC,10000,,false,10000,0
410d5661f39eafdce2e122fcf9a8095b63a8cdcf91e320b42e98aa8f3ca117cc,987197,2020-09-27 21:27:35 UTC,1939003,1855003,false,84000,0
d668b9620f859aa347c52e87494f61869a755db51e555e56795b8fe2e525b9dc,987197,2020-09-27 21:27:35 UTC,1045287037,1045284587,false,2450,0
5b9952c7824c18ee99e7fcc8b87c51b077309a881e27db313242d200b36a753d,987197,2020-09-27 21:27:35 UTC,10000,,false,10000,0
15382be57654fb64e9cd454cb430d4f01430ad1842a8f704485f750bc07d4663,987197,2020-09-27 21:27:35 UTC,136068528783,136068526690,false,2093,987186
2c5c809b94368641a4f460f2a4efadb165782d6685906c4fa9b6c24ed7661751,987197,2020-09-27 21:27:35 UTC,17195067530,17195051950,false,15580,0
b21f7844230a40c353e4c37c44ea3204bf3d314426daaa7a9ba1e122744bf6bf,987197,2020-09-27 21:27:35 UTC,285711436,285643092,false,68344,0
896594fb1e7cf65f544b30724edc75be2e92a1354fd94b3dc01a292674886db0,987196,2020-09-27 21:24:00 UTC,10000,,false,10000,0
e9c1199a5f7c52902fe1f7658f99572749d1996f7642c29cb9d1b08773fa7814,987195,2020-09-27 21:22:55 UTC,362704426,362694426,false,10000,0
f4c9ff5ae1d13adec88719b27aad7c1d89402aeb51d0888c67ebf3a27eb17fd7,987195,2020-09-27 21:22:55 UTC,10000,,false,10000,0
6a8a285a315f6a17e56bb1c33e6abff7256662c65619af28a32275a501df0000,987195,2020-09-27 21:22:55 UTC,49181498000,49181398000,false,100000,0
fd6ea60d3a524e6a638c22e09b1362b2c1608c6618f117a393beb4f73c3ce838,987194,2020-09-27 21:21:33 UTC,147294928,147246387,false,48541,987183
ac3bdd2c24c0dd6dbb2b88fafa42db709a82ed47d3d5c44ec4d47a4c1b8bae18,987194,2020-09-27 21:21:33 UTC,119860351,119838533,false,21818,987183
6ae37c2ea3ad66e15544521a58d5e815cd9d5419897d8d355fe99150e3f2c359,987194,2020-09-27 21:21:33 UTC,16324979518,16324963938,false,15580,0
3ac9eeda9e75cd107956ea5954749fe4e6dff69e2c6181dbeae21a10ffd6412b,987194,2020-09-27 21:21:33 UTC,1770153636,1770149896,false,3740,0
30e0368c390597cc0fe2d63fbcece7cb7f1916385c119e5b4cc075dc76a48632,987194,2020-09-27 21:21:33 UTC,344429,334429,false,10000,0
1b7fd3edc23fdc1ada4c31af58b3a2be8aab8cc2557abf73d575ea364cddd7e8,987193,2020-09-27 21:19:51 UTC,17808369950,17808339950,false,30000,0
88f4bef2fcb270ae9e9cf1a9d317a7055a7642252ae7062463cb6548c9774697,987193,2020-09-27 21:19:51 UTC,10000,,false,10000,0
0fee23775378e04c0e5220be49ac31484d54706da3c7360f443cddbbdb6206df,987193,2020-09-27 21:19:51 UTC,5269468,5262768,false,6700,0
40e6a8ef872c8711f6a13360e1992891f3d0378d3c80b0bd74253c1e2fef1e0b,987193,2020-09-27 21:19:51 UTC,233710348,233707388,false,2960,0
6551968d22dd8cbc7e788b5b6d64c9fead1646edbdfc2a9db0d7ae6c7d97ca6d,987193,2020-09-27 21:19:51 UTC,65530,44370,false,21160,0
dd9e2737bfc3c6e3a85dc13f76a6133084f0bc1fd8d94e8a085e92e908039ee0,987192,2020-09-27 21:18:13 UTC,9285500000,9285488117,false,11883,987181
0845d31b0652d8e8b66c8be2ae40a2b3b6e7c8fb99654b363a32756183e09d2f,987192,2020-09-27 21:18:13 UTC,369394946,369392496,false,2450,0
1a93ce5465b34a33712a242a6df675e451336939b98ab9928949a21cb6f8009b,987191,2020-09-27 21:17:09 UTC,10000,,false,10000,0
97cec5995e8e23093de0224e0976b23231bb66d6d50d1877bfc0b173f90fde9e,987190,2020-09-27 21:16:45 UTC,26007959,26005866,false,2093,987179
3f9cda553a3008cf530b75139506842e5fc871729bd056a94a8c9f13cda31edb,987189,2020-09-27 21:14:51 UTC,186513271,186511001,false,2270,0
0ae627006fb89b641d6d86c0ec41f5a7db1c75ef7b5c02d7a5ee96a696a580af,987189,2020-09-27 21:14:51 UTC,10000,,false,10000,0
c75ec11152a6f9cc9e5261b20463de889e53bcf6012658b08129c45536f1ee5e,987188,2020-09-27 21:12:45 UTC,30541279,30538319,false,2960,0
3bc3001ec530e3bd31e1ec034603b4fc5ed02b91edd04b33485551e441235f30,987188,2020-09-27 21:12:45 UTC,10000,,false,10000,0
76e5d4d824ebbabef8c59eff1aeedf07a331a20e57e7f931521b48330b2fb24a,987187,2020-09-27 21:10:59 UTC,120660799,120636631,false,24168,987176
0ee627ac336faa64cfa73f2818d256713653c9f88468ea852f0870b43e0d38a2,987187,2020-09-27 21:10:59 UTC,148443876,148393285,false,50591,987176
d2cc962d34fa90af8be95ac764977c827789759a429e500e6059b4d5dbd1c2ad,987187,2020-09-27 21:10:59 UTC,102969816,102961273,false,8543,0
b072ebc822828c2f4b3195ed58c41c05d4b50def92929bcc553a91ced799f81a,987187,2020-09-27 21:10:59 UTC,233892545,233889585,false,2960,0
bcdede4edbda056675fc6b3610b837f70839950f3bd61df356730c3157c020ec,987187,2020-09-27 21:10:59 UTC,97157650,97147650,false,10000,0
fb007ec2e55b63abbee868c9047b7db82a720ccb2106a8e604293eb8d253a59c,987187,2020-09-27 21:10:59 UTC,499990000,499980000,false,10000,0
a66487dd079c0f5f68d2855250c674a5c71b07c0728defabb8c5d0cce39e6b42,987187,2020-09-27 21:10:59 UTC,30786621,30783661,false,2960,0
e623500f5aefad752bc8d048bfdb4551e0d09066b6837a550789b3c31c5eef8b,987187,2020-09-27 21:10:59 UTC,10000,,false,10000,0
40e365cd42f8b36a0b6a082d2b97c083c81e82e603e45dcf2c039dfc10bd0619,987186,2020-09-27 21:09:02 UTC,10000,,false,10000,0
a4121d602807faf2b08e33cad6430d8ae97077bc598e0890f74279fb925e39bc,987185,2020-09-27 21:07:53 UTC,134604,110484,false,24120,0
97600b0021b0cfda8dc95b57d5cb20b6b04ef6f0d25a3b8ce695465df925c4ca,987185,2020-09-27 21:07:53 UTC,234213860,234210900,false,2960,0
cbb78664d35b8c750ebee2c4b9dca71000667c2b729646419c4de1f6d741739a,987185,2020-09-27 21:07:53 UTC,500000000,499990000,false,10000,0
cdc6bf9d33d370f74e91af026afc87083405d7c431a72c9ec484ceb171a4d1a2,987185,2020-09-27 21:07:53 UTC,10000,,false,10000,0
cb9f9c39c197580a32f450f727920e74693261f38532e3faae2a030ca3dbd009,987184,2020-09-27 21:07:04 UTC,144340647,144272303,false,68344,0
c635c0ae451ce88e0f287267d478480784f0baccdf080fb73c9ef6d534b4467c,987183,2020-09-27 21:05:50 UTC,145354030867,145354028783,false,2084,987171
1a748b1316490ab0fd3df99c1cd20f2b293fef086467abb128ea71eb2a70f484,987183,2020-09-27 21:05:50 UTC,234462378,234459418,false,2960,0
6ca9005abbf55a14ef74452b81b44778a9f0f4edac283c00fd759dac59aee9c3,987183,2020-09-27 21:05:50 UTC,10000,,false,10000,0
4e0a544afea410693d8fb4542e300c9d5f031834adf8460bf827e6a021bf76eb,987183,2020-09-27 21:05:50 UTC,103006197,102997654,false,8543,0
d428a556ac7641f70f37372bab56ecca12cbf0f0b72fa6da8ce9e681f6ae2570,987183,2020-09-27 21:05:50 UTC,1136419678,1136319678,false,100000,0
f988b7c10ab06f8da768967e14f58c717faa9319aa8c4090894268852d4d2e6b,987183,2020-09-27 21:05:50 UTC,1000002092,999992092,false,10000,0
c0f05a02938975466dbdf4fe6c9754e5da20f631bf4e5aa174818fa1e13f643b,987183,2020-09-27 21:05:50 UTC,30989146,30986186,false,2960,0
91cfccb6735126fef4b0a81f51c4c0957f95b65f1f5927b79c77d6fba652d611,987182,2020-09-27 21:05:03 UTC,103048013,103039470,false,8543,0
5c05d8a8b0b8fe1fa96fe250b7d70064a108b5fff5b91a84755ac42c1df1a538,987182,2020-09-27 21:05:03 UTC,2500239883,2500229883,false,10000,0
f4aa4d9401fbc710bfe41bebd2e2106ae38928f72e626e2ad0f4e6ca3b7cd9d7,987182,2020-09-27 21:05:03 UTC,10000,,false,10000,0
99d20510aee3e2856339e70e6f7b1b5a53549909a3c6f9073f8b13f52be00160,987182,2020-09-27 21:05:03 UTC,209412000,209406000,false,6000,0
81961e7cc8f312ba7089ee735f2626868036f99cb6371823f0f28282af46a340,987182,2020-09-27 21:05:03 UTC,500113362,500110979,false,2383,987171
694f772e690453b73996a02f583e255e6f9c977cd0a96a951b61c1baed3b86aa,987182,2020-09-27 21:05:03 UTC,31231318,31228358,false,2960,0
cb34519a8a68a238f95e388766d0fd5f6a786a61e545aed03dea0d66626266f6,987182,2020-09-27 21:05:03 UTC,102191618,102189698,false,1920,0
1b482fab2a01eb6e56f4cb8af3835c90959722972e0d35735083a01a67f1d554,987182,2020-09-27 21:05:03 UTC,3000302184,3000292184,false,10000,0
1bd40c9bdc3313c60e46bbb02119c40cf15ee94a0c12e3ad40ddd3cbdd1fe57d,987182,2020-09-27 21:05:03 UTC,233348464675,233348454675,false,10000,0
95cc08966023b473e2f2bd78891d11ef9b158ceb080db86f906458385ba4da3c,987181,2020-09-27 21:02:17 UTC,234609462,234606502,false,2960,0
08fed7d02c3f0fe27b44a29f947de286a992ce699c0c816c995f139f0d808013,987181,2020-09-27 21:02:17 UTC,149581330,149533652,false,47678,987170
c7c8a890ccf054ee5d6ef3e8fecbb830e4c473e4492ec3ca2ba0461a65e69438,987181,2020-09-27 21:02:17 UTC,263982695,263980030,false,2665,987170
04c86384dee26a7b446dd82f8c5a4040b408e693d99a8219a9b133e59d891719,987181,2020-09-27 21:02:17 UTC,171500010000,171500000000,false,10000,0
77a4e2203b7a3c7a1b1810d06c57a3295c79bb811250de956692864939b282c5,987181,2020-09-27 21:02:17 UTC,10000,,false,10000,0
92a78a137b843039719c6dc803759970c7d3ff1d78d9b456fcd4ae91c8bbff48,987181,2020-09-27 21:02:17 UTC,101361547,101356327,false,5220,0
affe1efd4680c6a66cbc8cbbed1b53831855e0a143723485d1a8ace120429702,987181,2020-09-27 21:02:17 UTC,10000,,false,10000,0
a77bd7c7f64d651f098ca4040ef862705c2b842253f75e212f53652c79247048,987181,2020-09-27 21:02:17 UTC,958072430,958068595,false,3835,987170
e2165d09158a78978fbe5b42de8c2e24ab448b0c7e7158492b91d96852561bb1,987181,2020-09-27 21:02:17 UTC,635497815,635495555,false,2260,0
2730e6f0b2cc2bdbdac0ac39dfedf28fffaca6ec35debb0e0ef6eb23852f3453,987181,2020-09-27 21:02:17 UTC,792898456400,792898454050,false,2350,0
f1768b2377baea145d736f5cf946f7b29e691b20c8fa4f509b8de7e3ee910eb0,987181,2020-09-27 21:02:17 UTC,10000,,false,10000,0
4337f349ba7f004e74107b8fe55898d6692d167c625591d078c7d364c96b6063,987181,2020-09-27 21:02:17 UTC,121044710,121028111,false,16599,987073
7ce04aa8d8130d04ef7bb0b6a736270a78aef569e176e17e585952ad8465b0c8,987179,2020-09-27 20:58:46 UTC,7476778,7466778,false,10000,0
ccffd7b42fd3ce0d79fc28e805f682bdfd2ded45fa72c2aab7a1aab34daeafdb,987179,2020-09-27 20:58:46 UTC,18055501,18045501,false,10000,0
48933aae70f0ba840f9fc1bf017eaaef9aa87a3a73a0654b3c30220a0eaf9d48,987178,2020-09-27 20:57:44 UTC,10000,,false,10000,0
81c9e576ecb0e5e5fdc790b9df59b1759073960400814be92445a079b55af868,987178,2020-09-27 20:57:44 UTC,100000000,99997550,false,2450,0
d95e0d868ea18e7e5c6abafb5e1e5e0e3bba6dbc41213aeaedb16783ab296206,987178,2020-09-27 20:57:44 UTC,31385616,31382656,false,2960,0
85e41afd3aed27c3f3b1b34a0dc55500cd046ea70ee30c15c0e7fdc8f174adb9,987178,2020-09-27 20:57:44 UTC,10000,,false,10000,0
071615fd9aecfe884b7685dc589dd09d62de3ed18400954aff9c6b9db3b0567d,987178,2020-09-27 20:57:44 UTC,496744155,496740744,false,3411,0
a029367893063f6d43bdd3d4e25e6523e5cd5c2388d2045c2909c7788e320279,987177,2020-09-27 20:56:15 UTC,210706167,210703907,false,2260,0
52aa58982ab2e787e86edd90f19d5b328b1ea11178c6bee53bb3d8dcde03dda6,987174,2020-09-27 20:54:41 UTC,103195287,103186744,false,8543,0
d8e315e785d99fff598abc2b73c698d84f0471fd908c59c2711cf8a6f4246af3,987174,2020-09-27 20:54:41 UTC,1313452,1306319,false,7133,987160
56ff01f802c8e22e7536aef3b469e53069022617bddba61921bfe7043aa4c7ee,987174,2020-09-27 20:54:41 UTC,10000,,false,10000,0
f49ca8f9bfebbe31650d3b9fe3bea414e66a5c9dadd85c592e0030b07b27346f,987171,2020-09-27 20:52:32 UTC,3416806876,3416796876,false,10000,0
d499e454429daaaf69bf247995360f4171a65823e5ed1cf4f04c40cab56cb42d,987171,2020-09-27 20:52:32 UTC,500151380,500141380,false,10000,0
12104076bc8dc972fdc009b6cfab336ccaad942943118e473498573697536ae3,987171,2020-09-27 20:52:32 UTC,202081063,202063125,false,17938,0
44f12a1710d052014c5029cb047f166ea3677703be4da2bf4b4d90d640f75a35,987171,2020-09-27 20:52:32 UTC,10000,,false,10000,0
15f2db02fd6b48e295f79cc4e5eaff5b0910b12a13a3ba4e1262bed000b28300,987171,2020-09-27 20:52:32 UTC,10000,,false,10000,0
635318c9f76b09b09802402241098c92e83ab9b81ddff52f0fca5d45b94032b9,987170,2020-09-27 20:50:19 UTC,121822345,121799049,false,23296,987159
9190f003cbbc6ee230901430f4909db5646440ddd8532d3905a3ea098f79cfeb,987170,2020-09-27 20:50:19 UTC,1033905610,1033837266,false,68344,0
a6f99592ff0a24644d89d8f790cf41140b010e612b6cbe809fd394ca8aa70cf8,987170,2020-09-27 20:50:19 UTC,151285646,151238540,false,47106,987159
f6adf538fb112d279f5046425c64100322195f9e016fedae373bc4a0e40f74d4,987169,2020-09-27 20:49:32 UTC,10000,,false,10000,0
61d022789ebcbe4c599bc1f0ac2bf35ab7b92fd3eb43557be18b2099a70c2b0a,987168,2020-09-27 20:49:01 UTC,7000399,6800399,false,200000,0
a8b1b402b419de3570e43a6ed1ddeb26345529adef08da6a4e321239ea7cd699,987168,2020-09-27 20:49:01 UTC,46105678,46103585,false,2093,987157
9e2086f85f372f95c73fd2fc4cd55804f8a729b121ead90fa815b1db76bb3e9f,987168,2020-09-27 20:49:01 UTC,10000,,false,10000,0
db0ed8926eec2d4200c5d7b609428d5c85c47f6f0a11ff7a41a0c98f35156400,987167,2020-09-27 20:46:57 UTC,103416477,103407934,false,8543,0
08b0326ff41af87f21578a9a54795cb83045787acbbc2be788ad93ff55da3cd9,987167,2020-09-27 20:46:57 UTC,1641,1094,false,547,0
bfd94a19dc426e5a5d1e89a708a724ddd25adcbf65c5be7fdfbab5fbd0f42dfe,987166,2020-09-27 20:45:58 UTC,10000,,false,10000,0
20587aa9c1cd0c7fc5a4de1bfee1f98a1cf5b37293c0eef1aedca673633901a8,987166,2020-09-27 20:45:58 UTC,10000,,false,10000,0
f9fe1e89f4e29eb369ef7df351359add0e05c4e61a4e9c113f119014b5f95cbd,987166,2020-09-27 20:45:58 UTC,4414214,4412121,false,2093,987155
44db02563ccf74bd7ce1fd99755d191023fc2b421e2605de336bde756234e4c5,987165,2020-09-27 20:43:18 UTC,234787745,234784785,false,2960,0
30e406c501fc8d8d6a1048c1c7b2c59e8caa2534eacd857a318d88f876f4ca04,987164,2020-09-27 20:42:47 UTC,95785217,95782787,false,2430,0
cc31e19b291238de7487b38919db663b1635b04beb6e71843fb9e04f4368ef65,987163,2020-09-27 20:42:01 UTC,122239989,122221648,false,18341,987151
ff4751415cd3c64e79a48639133c94dcadf5b7f2357669405ae9afa60e9dbe19,987163,2020-09-27 20:42:01 UTC,17464068464,17464058464,false,10000,0
5a3c772f7fbbc98a65f07a28863d4b29f6336347e27f40279641ae952ac5ee59,987163,2020-09-27 20:42:01 UTC,10000,,false,10000,0
8357555071d5ae923619e939e0bff0cdbe01312ef442d1e5a1ea2951084f1a16,987163,2020-09-27 20:42:01 UTC,13785931,13784203,false,1728,0
fb7b83b1301b118d379438b561beb06cd9b9b40b3fbe1612bf170bc3db790696,987163,2020-09-27 20:42:01 UTC,152496759,152451422,false,45337,987151
925b878adca2879aff1145532c9c02a1ee46069893a32ef99b2bd8cc8c797f78,987162,2020-09-27 20:40:01 UTC,103300699,103298779,false,1920,0
a7e6ddef9576d4a12c8b7e538f820e0bb9484fff9a8b8797dd98296d5c85121e,987162,2020-09-27 20:40:01 UTC,10000,,false,10000,0
e5552e8ef3efda7f7760c45941989617b4dc7c112726eaf49d1ff43aa25c5779,987161,2020-09-27 20:39:29 UTC,500001920,499991920,false,10000,0
acc8bf7dc97eff7be09557d8f8b1d102bc46982c88621a42add1d36b8ba25798,987161,2020-09-27 20:39:29 UTC,31533286,31530326,false,2960,0
2e3651a0fb27c34243fe885a3f2414c4758b0712701299eceed9e1b04766af2c,987160,2020-09-27 20:38:55 UTC,466674365,466671828,false,2537,0
9e4a2de2d730d147626d30ff4275aa65bc57dc481a5e6b33477bbcc97e18549e,987159,2020-09-27 20:37:21 UTC,10000,,false,10000,0
4d5d8f916ee93b0f6c23202cc1a5e5324c2b9acdd3de2c2167f72da8c39bbb9c,987157,2020-09-27 20:36:45 UTC,1000139784,1000129784,false,10000,0
ac1e50864f37aaef7b9eebbe5508a9ae9fa94ea2861cc4c18007130beedf006b,987157,2020-09-27 20:36:45 UTC,103445955,103437412,false,8543,0
403ed2a46c065d41383c6c6368fb65a8a835241f0a4d68b93d058da83169f880,987156,2020-09-27 20:35:56 UTC,10000,,false,10000,0
2fe864044f5d56adeba3019b7fc7b1c006e7e995d86f5163e473c30c188a5e4b,987156,2020-09-27 20:35:56 UTC,103484812,103476269,false,8543,0
35f0de3dd44e2b3daf32b5ef2f251d228af4ab9be423004ced2a1a22b0304513,987156,2020-09-27 20:35:56 UTC,466678205,466676285,false,1920,0
c7c0b3c3200c083cbb569a94fb7c01dba1d7e8a8bb5aef86f16cfc28e3b8a4fa,987156,2020-09-27 20:35:56 UTC,234972859,234969592,false,3267,0
fe35add3330331f01fab54333c01154b4f6f1e1d60e23f0861b69dfb61977af7,987156,2020-09-27 20:35:56 UTC,466676285,466674365,false,1920,0
28e48340fed14438684e0904515229e822e112d0ff97c0bc3e8c7918851fa418,987155,2020-09-27 20:34:53 UTC,10000,,false,10000,0
1539d49fd6223e07d3d26b4269475a208d393687b7dbce43b478ba2f9b45e7c2,987155,2020-09-27 20:34:53 UTC,145399132951,145399130867,false,2084,987144
2d11d8f53d94ad6d1244cc5433cf827e968cb71a905171281f7c1b0c07842eef,987155,2020-09-27 20:34:53 UTC,358314070,358292910,false,21160,0
964a5d319ccb0c409af460b20e4523060ae7175c3cbaf38476d486337499df10,987155,2020-09-27 20:34:53 UTC,5137943,5135513,false,2430,0
bcd5df5b9b4b7d62559d0cc4d3877c23ad4f72579f1942f6fff66d9991995165,987155,2020-09-27 20:34:53 UTC,10000,,false,10000,0
510f664ad108438f56c0ebc658e246d699eaccf29b6216789ae74e411af5d262,987154,2020-09-27 20:31:35 UTC,122773215,122751679,false,21536,987142
0457fd721d6e64e835cb6d258defa7ed4c49ea0486a57fc57e193f0a0fa46fb6,987154,2020-09-27 20:31:35 UTC,4200565,4198135,false,2430,0
6c96745749935af20492f3ac84dce1cc14d88d9b301dd76b6fb1f2022638ed4a,987154,2020-09-27 20:31:35 UTC,103517126,103508583,false,8543,0
fed162138f8cfdb2514c0a4e92c987d6f15d5fb9e9500b9751932e69d6889a4f,987154,2020-09-27 20:31:35 UTC,1032334,1029884,false,2450,0
637b765fa782be2920c9347df69452441dd876ee7ac9ec6a6e9707c71226e1fa,987153,2020-09-27 20:30:07 UTC,147507683,147439339,false,68344,0
fffb8fb4dde1e3f3ffb04ddca3a07213f24ab52eb182ad7e3fb28e93e73299e1,987153,2020-09-27 20:30:07 UTC,153426782,153383751,false,43031,987142
48092aabf816703347e974cc64989cf3c148dd83000273345def52ac1ae8e01a,987152,2020-09-27 20:29:24 UTC,334314,323713,false,10601,987141
5ea1b21d0c43cbe997e9d54473961066e48e0befc7e5f3ab1f845de6dcf8c0d8,987152,2020-09-27 20:29:24 UTC,500011920,500001920,false,10000,0
0a3960f9cb35563497e7283dab3ee9bbc28f2b14e58191624e1b21a60f41d029,987152,2020-09-27 20:29:24 UTC,152406884,152403824,false,3060,0
a2e12a2db1a5b3e5eccddb17fde88e95e59ce331fe46a982376ab774a716637a,987152,2020-09-27 20:29:24 UTC,10000,,false,10000,0
07dab46a57af58c77eedb5b049c19babf19b368a7f7be325aa8da270a22ab89b,987152,2020-09-27 20:29:24 UTC,316168438,315868438,false,300000,0
efc16bfac5a616464111976227dd2ce95b730d69f784aae78750d4fe5f189821,987152,2020-09-27 20:29:24 UTC,427362071,427346491,false,15580,0
6b154acf4e106ef968d41700cc5411dd27b8b85be082eeee48e007472f601209,987152,2020-09-27 20:29:24 UTC,385151718,385136138,false,15580,0
1b701c52e7e6e81848613ff4f5cc4db99a94fbdfc208be4b1ff993fcde6e6b43,987152,2020-09-27 20:29:24 UTC,10000,,false,10000,0
31b98b34cfcda507915f66734cb861c8c31f64a401842d9ba10824641c1027d3,987150,2020-09-27 20:26:32 UTC,580759022,580743442,false,15580,0
15592e9aded6519e58921333ebd5ccebf324f284e7aae4fea09488bd415863d3,987149,2020-09-27 20:26:02 UTC,500021920,500011920,false,10000,0
877665a6b2df43c1cf7f08f3ade11eaf62e0573ac4cd009858f3850c0e735740,987149,2020-09-27 20:26:02 UTC,1836137485,1836121905,false,15580,0
5dfe342dafb75a63e79562ae28f312cc6bfb7e95932db16928f77491f4c28122,987149,2020-09-27 20:26:02 UTC,543582993,543576993,false,6000,0
5a0f5be65696ead3d0972cfeb706d81a7a438a2271fa31f79506bad155e38264,987148,2020-09-27 20:25:13 UTC,31675099,31672139,false,2960,0
d6d97d3bb944d78b75bf3901e934f6e455cb0d75a8670d570aa32432a6837afd,987148,2020-09-27 20:25:13 UTC,10000,,false,10000,0
078dca8f1d85e6bd7679b7d6867bef6d7e4636766531f5971323f3f891e257f9,987147,2020-09-27 20:25:00 UTC,412063382,412047802,false,15580,0
faa992bd25aa7434cfe5b2cd351e2e098aa866ca710b576cac950fe10366cee3,987147,2020-09-27 20:25:00 UTC,10000,,false,10000,0
bbaaf76cf5a5279799a894b60459b2b6a3c2010071e89ee6fd9d5348e1809e5b,987147,2020-09-27 20:25:00 UTC,11025742,11022778,false,2964,987136
58681def574948a10763ce22e457365165668717dcf5f1afe4f535e0db5a56a1,987147,2020-09-27 20:25:00 UTC,963076021,963060441,false,15580,0
8c53d2a32979e76b5e9b203e78dea02ed826106377a61919c925bf73076a22ca,987147,2020-09-27 20:25:00 UTC,366117081,366101501,false,15580,0
52fa57771a953f09de26a7f0fdb88b77b7a22a6f7f092dcad0e34d5fcdb03e59,987147,2020-09-27 20:25:00 UTC,145429145944,145429143851,false,2093,987136
d9b66d50785f63547f8235fd678fd1698eff8960cb8a3eefabd58609da63114f,987147,2020-09-27 20:25:00 UTC,873842110,873839850,false,2260,0
ce43d826a66f80b4c274dd162fd2eee28e8d1da5c87da56ee777d04d49e2f671,987147,2020-09-27 20:25:00 UTC,235213837,235210877,false,2960,0
5588f739a92c9b14b2b4ff82f6120e34bab409a20d9cd63e8306484276a304ca,987147,2020-09-27 20:25:00 UTC,103712247,103703704,false,8543,0
11a967d90ebf63e0e0cc5828b8c80c7c381bee4a720fc09c2925cae2e2c0bed1,987147,2020-09-27 20:25:00 UTC,2359725948,2359723498,false,2450,0
aa67387419c5749705506b330481796998795b6f7fd57ee71ca34b14463fc4cb,987147,2020-09-27 20:25:00 UTC,23064780,23064328,false,452,0
fc090027f82c4f5503eed9fa7d1d2932616a8d3069dbb80810fa7dbd6d83361f,987146,2020-09-27 20:21:53 UTC,15443719,15440371,false,3348,987134
4efda8194b34580b20b3598c4ed09db58bf1e861e470e3a2aa7a2951f39d9c8f,987146,2020-09-27 20:21:53 UTC,10000,,false,10000,0
a83e0cb8ef869357d30f73fae067c1247bbdea1d98e9b4f4cefafe232f3db106,987146,2020-09-27 20:21:53 UTC,30872,24872,false,6000,0
da5d681d38b502bd2a080799d3aaafe34fec6067142ba958378ea3db8e6ef8a5,987146,2020-09-27 20:21:53 UTC,4525694,4516374,false,9320,0
2480d6894453b8f874a9ab09e298263cfb99e80cb36fbd9e9a4c38d9a99c4fd3,987146,2020-09-27 20:21:53 UTC,61272095259,61271995259,false,100000,987135
dc910a8036bd82e7807a833b2719f3297c98896c2fd0fcc676a8bf01ea82013b,987145,2020-09-27 20:20:34 UTC,33607068976,33607054815,false,14161,0
fcca8828fb80c8571c0fd08c3afc4b21f47981647693717e090b6dd73895f540,987145,2020-09-27 20:20:34 UTC,10000,,false,10000,0
bbdd2a0ae76c8abf559941d2b08c5fc7c934c0e35ac0575a1b6e733ccc5644d6,987145,2020-09-27 20:20:34 UTC,500039500,500029500,false,10000,0
8ea306e98a475ba9ab3925985035304662700404d3aa37a074db507d1813f4d1,987145,2020-09-27 20:20:34 UTC,123251301,123234122,false,17179,987134
51ebe2e7498e281183947f6a77391eae6288a435c6f22900cdc764e60e22fa2e,987145,2020-09-27 20:20:34 UTC,154615040,154567661,false,47379,987134
e6ac1810b905c197188719decd5683d76ef9c68a6a509217e0f6c0fd4766ebb7,987145,2020-09-27 20:20:34 UTC,17144531193,17144521193,false,10000,0
5ea73b9f672e74966705f76c34d2544323e5c6e71188277a1b54085ffe3d9b33,987144,2020-09-27 20:18:15 UTC,122774506,122764506,false,10000,0
b3c515523c88fd5c3d03f251f1383e4551db24cb92d522006fbc50ca1908dabc,987144,2020-09-27 20:18:15 UTC,100000000,99997550,false,2450,0
91c9f64990bfdeac4ce9c4f5240c91297020f21fe93b88daff623c078e22a082,987144,2020-09-27 20:18:15 UTC,33047637,33046637,false,1000,0
f7d51d3c7a16aed485ebf1aeb2c59d894440b642a0831c393e8d07771ce677e9,987144,2020-09-27 20:18:15 UTC,499990000,499980000,false,10000,0
48f786b72ae2ab1e01b933a0bae8683a1d674dce9a8e3aa3d076bc41d5334898,987144,2020-09-27 20:18:15 UTC,10000,,false,10000,0
5d3f7b5daefae131c45ac9cb4e8727755e3838444417d0f9edba5962b20d9b46,987144,2020-09-27 20:18:15 UTC,100000000,99997570,false,2430,0
ff383705b855cb87891d42cf8c51aeed8e9ab96997e42e80720b7c0d659ef87b,987144,2020-09-27 20:18:15 UTC,32279426,32276159,false,3267,0
35f4e5ae59c8d15b5ea509798ace2aa000b68d9e5925ae250663406deebdd16f,987141,2020-09-27 20:15:17 UTC,66545796,66543703,false,2093,987129
6181c713d3051e44f17b1ebf3f8a63aaa3a48374648e54b210a576a2727f8eac,987140,2020-09-27 20:15:15 UTC,19069,13000,false,6069,0
f85665ce41185128a45d90ff3334f9ec6eaee15b71ba8eda67e50ec2f8c46d62,987140,2020-09-27 20:15:15 UTC,10000,,false,10000,0
27221315b672162d9b6215a7541d585577f8cb89f2a53d94b38a2e2b24b71490,987140,2020-09-27 20:15:15 UTC,103762494,103753951,false,8543,0
2492708400f5993f99d1faf715b14a2728a230be93231bf9acefd6b6fa12d4ea,987139,2020-09-27 20:14:16 UTC,145498934037,145498931944,false,2093,987128
042b28e739dff9409cdd776339ee38a49c4fae9a73fc1374fb03368a92298df4,987139,2020-09-27 20:14:16 UTC,747954099,747885755,false,68344,0
a131aef3652c6b1fd8869fed5c0e8695f44848479ce5b2c3d7f5a4e69f937120,987139,2020-09-27 20:14:16 UTC,10000,,false,10000,0
6dfa80010716add7ecfd25d35960cdad11155996a9603a0a3aa3d9f651f07742,987138,2020-09-27 20:12:22 UTC,99998080,99996160,false,1920,0
a0b6307e93740cf84dd106f83fb95c231c7d071229fb493156c2038938d9cf2f,987138,2020-09-27 20:12:22 UTC,104022227,104013684,false,8543,0
d0fd17b2d3e27b6794ca2dda8e2fb18a87ae95737370ae3ad9d8e1a77640b35a,987136,2020-09-27 20:10:46 UTC,155671625,155626271,false,45354,987125
7947e8fd196957a02f3ca613c5994d2b6e2341f181cd5fb47640537f02604d1b,987136,2020-09-27 20:10:46 UTC,11884648,11880035,false,4613,987125
ace5af325858f9613344f3e8cd36ca5873d157b28fbc9f04fb9f2f791596da50,987136,2020-09-27 20:10:46 UTC,151720256,151701231,false,19025,0
dfe1b14f1c228dbe79dcd9d6a7f2b4c19e6bef9ea2cca5493ae7b9d2aaea9e58,987136,2020-09-27 20:10:46 UTC,123915800,123896570,false,19230,987125
c5ff6e41f8ee3e5b4517028683a40868629d7767755e6bd0000816479a724f4f,987136,2020-09-27 20:10:46 UTC,10000,,false,10000,0
e3340f47c515a87561b3735e535668fc03570c512cfedc5ef459266251c681f1,987135,2020-09-27 20:09:11 UTC,500000000,499990000,false,10000,0
034096086eb4e9f5b3eb5560a3e66feb2c2a177980d76503431a17c41f6f07db,987135,2020-09-27 20:09:11 UTC,117206979144,117206976794,false,2350,0
0c9b1ed4512870f30de2a1dc08d365742c68d996bea30e0678e2d1ef53ca23c0,987135,2020-09-27 20:09:11 UTC,10000,,false,10000,0
e4fccd89c5be013c194731fe17ff9c6b32d824e1f0d789066d81f182b29debc3,987135,2020-09-27 20:09:11 UTC,14047427,14037757,false,9670,0
c6a9ad38b87e351e4fc086168a12e937ac5075162b87c5126b9da7e65a6b3087,987134,2020-09-27 20:07:27 UTC,235372085,235369125,false,2960,0
0b8da9b6e5e642e8c953ff95c465dc9d63287212ab52449b732858ae6f10aff3,987134,2020-09-27 20:07:27 UTC,10000,,false,10000,0
21aa33e81524188c9f54531b802428c02cd5733b989b028250018155274bf381,987134,2020-09-27 20:07:27 UTC,1500120944,1500110944,false,10000,0
1cbf46ab256c9809cad1d04366d1ce0b2007ed4b6a3d79943232ea078b31706b,987134,2020-09-27 20:07:27 UTC,990096615,990086615,false,10000,0
540a6743f0cb760019e5d310103acf0b918bfcf86019f5bc9530beffad488deb,987133,2020-09-27 20:05:52 UTC,112770015209,112769999629,false,15580,0
0bf1d5bc6173fe9a4eda15819857f8ac2400e8b06c2917e705ef7a9f895c48dc,987133,2020-09-27 20:05:52 UTC,500010000,500000000,false,10000,0
30c69451c17e70527d5284219e403b93a5fed0013de19a7ff246a6e23f0927f1,987133,2020-09-27 20:05:52 UTC,10000,,false,10000,0
049fef818c38821354f84321cf4b87def3d7952044d4a0279ab616593a95f0d7,987132,2020-09-27 20:05:12 UTC,244347672714,244347662714,false,10000,0
40a30990420ba30d2ad3a7317efffde17a117d98a95d46123a0dc9f665f96b05,987132,2020-09-27 20:05:12 UTC,17057831613,17057821613,false,10000,0
543f65191755db2695c36854c124fa79ab4654e78d86bae1d9cc8e9a47f68b5b,987132,2020-09-27 20:05:12 UTC,2500249883,2500239883,false,10000,0
3e587f4db450622a4a69fbae669df6c2eb0f3f40e0c1dcbfa137654223d8b8ac,987132,2020-09-27 20:05:12 UTC,32474347,32471387,false,2960,0
2c1db4533c727d568fbe20024e97482ba00ac39910719975163a6f359acbc63f,987132,2020-09-27 20:05:12 UTC,2000894246,2000884246,false,10000,0
7b7152b5160ea62715b1661382e0dbe58b0293985d50fae6a014844e08b0d3d5,987132,2020-09-27 20:05:12 UTC,41631,40485,false,1146,0
c038d6d5e353766bc88d86baf22dad44a4cb2b69c6b15338636643c5c2af32dc,987130,2020-09-27 20:03:58 UTC,295019575,295017192,false,2383,987066
3898e1b0da78f556522f2744002cf2e2ff7c36da44620c42500d71777555c5cd,987130,2020-09-27 20:03:58 UTC,500000000,499990000,false,10000,0
ff36f22e4e0a257d98a590a739007be64b7c4df2d1d3bbb677040260fd4528e7,987130,2020-09-27 20:03:58 UTC,145503707230,145503705137,false,2093,987119
ae00fe42aea03bc649d954fdc701f0f2fa9073c4ed9982f94064988d9af54013,987130,2020-09-27 20:03:58 UTC,1000014239,1000004239,false,10000,0
d7b5c8da5b526bd45ea370eb23c7dbbb2c41954e577a2f7af15dd6e90de149d9,987130,2020-09-27 20:03:58 UTC,91755475,91753382,false,2093,987119
d890c0ce64ff6a69ec8ed67e64ecb55a449a5f8ee259416c66a3bbb904fb90c2,987130,2020-09-27 20:03:58 UTC,10000,,false,10000,0
f885e5be703d2ec02f0e10be44867bddee28e9a472e98278de1803d14705f26b,987130,2020-09-27 20:03:58 UTC,32612920,32243560,false,369360,987129
4b81283ef0bf1f676e1a6b9f83c32d827f50e70b51602ce18028bcf5165eaefb,987129,2020-09-27 20:01:26 UTC,10000,,false,10000,0
ff0fe4de267e02016b5152afba7fcff013b35704a9fe5d41ffcf2b96714cae41,987128,2020-09-27 20:01:06 UTC,8214,7164,false,1050,0
c931e4800cf9f80a4ed8786b01656a673cf1e4074fe2e9470ccca081787d324d,987128,2020-09-27 20:01:06 UTC,145573257323,145573255230,false,2093,987117
7d1d44d21c448f98bb882b2255d8af0a2da8db160e54d671dd253c687e73933d,987128,2020-09-27 20:01:06 UTC,10000,,false,10000,0
0b72e1c1a4bc3886f301bf6a4fc25f7b54644554433063acf366d8e20e88fe43,987128,2020-09-27 20:01:06 UTC,10000,,false,10000,0
e7a3a09bcd9b9b3502db2ee45812d5cdcdc946a78e10dc91b82fd0354db2c75e,987128,2020-09-27 20:01:06 UTC,416652666,416650001,false,2665,987055
22f5e56621ab3622e29c24778be9f7044ac60af6c698c32065b6dfab79df09da,987128,2020-09-27 20:01:06 UTC,124485079,124466746,false,18333,987117
72ea2c4f58be527882a335f48f920f7778ce10bd27e8aeed4cb36e32125353f4,987128,2020-09-27 20:01:06 UTC,156656517,156612923,false,43594,987117
be9b5da458779556f901c82b64c77fe61e1302dded5a375f24c47f92d118f885,987127,2020-09-27 19:58:16 UTC,104060821,104052278,false,8543,0
8f4d92e69dee3c9c40c38e131a734570c1c376de02d0ea98b80eb0aec34b19e9,987126,2020-09-27 19:57:37 UTC,223242592,223232592,false,10000,0
10dd14b89cb55afb79da724d45638140bd40681121d3a1d84eebfa5b5c5a8e04,987126,2020-09-27 19:57:37 UTC,10000,,false,10000,0
404ecf7f04feaf279fe93877ca0463a5fe9cc8a49333f318222a2a9ce7aa2f99,987125,2020-09-27 19:55:10 UTC,291889,195249,false,96640,0
b81c6638e7e891bb12b77245887cecee02095c39d5f38ba98b894fb02bf0710d,987125,2020-09-27 19:55:10 UTC,10000,,false,10000,0
79b1713b90d34bb9a06b0183928b185399f678e1728cd4c8417282e69d594251,987123,2020-09-27 19:53:32 UTC,235517174,235514214,false,2960,0
4835298af5e912909b851829c704cce51adf40b3728c7f8b1aab66aa401b8ab2,987123,2020-09-27 19:53:32 UTC,1432453645,1432385301,false,68344,0
9cb6a28bdc269a75c01038f6a3d00afec3ab7ba0e4dec11503072760e845489a,987123,2020-09-27 19:53:32 UTC,10000,,false,10000,0
3dee9439b4d6562e37bb3f546f1e48495533a34179e20b8b8e98db3bd7fc68c2,987123,2020-09-27 19:53:32 UTC,183866659407,183866657323,false,2084,987084
ad5c4abbd42b0718b6ef49b2c970607c6c9ffb397b07d76bfd6b85e937c05086,987120,2020-09-27 19:52:35 UTC,1000024239,1000014239,false,10000,0
8bd4ea8f8dbdcc1e4dadc43036618977451a1209c61c4db2eb4d7371f9fb1415,987120,2020-09-27 19:52:35 UTC,184098429000,184098426907,false,2093,987109
d6eae6123e768e4b9d851cfaf3bde55dea3fdeb2c40bb0f67c9b14e380004e6d,987120,2020-09-27 19:52:35 UTC,240255804,240154373,false,101431,987109
e5dc72f783c2869d7cbd2555dc632c2a87c52955d14e284a489616c5136b99bf,987120,2020-09-27 19:52:35 UTC,14668399,14662522,false,5877,987109
5010d6ef6d4f4246249323c1a56e8ac108d62fae812b61c54cda44677665c377,987120,2020-09-27 19:52:35 UTC,157656448,157615160,false,41288,987109
ac4f4d0e8d7180ae415b54a2ffb0aaa434edde5378363608d9882cd9aafa6ce9,987120,2020-09-27 19:52:35 UTC,10000,,false,10000,0
611fe48e547795fd72fc8609458056ab84c6a2dc2e8132e93b4ceeb7cd867079,987120,2020-09-27 19:52:35 UTC,16693654204,16693644204,false,10000,0
6569b3f1274f55b5e828487116e2c06cc5df4de6db89aa2ee42a4689f626f8c6,987120,2020-09-27 19:52:35 UTC,10000,,false,10000,0
c58cc0f56cbd08ded271a713ecd51aac87f43e26666cfa4ced5606aaec18813f,987120,2020-09-27 19:52:35 UTC,500033424,500023424,false,10000,0
724f8903b6d8a23d1746395c8c40a6a95b008411d9946108219fdbf7a8e933db,987120,2020-09-27 19:52:35 UTC,922711165,922708905,false,2260,0
06b4d02a6d6c602b0d1d226c3401c9ee398d6876d33cd18fa03ddf161b295bc2,987120,2020-09-27 19:52:35 UTC,3167154395,3166789115,false,365280,987119
4815b98cdc6d806b0d998571a979a788d07a6c3fce2e4b4e211ccfdf6c2ab775,987120,2020-09-27 19:52:35 UTC,17274,7274,false,10000,0
f9ed5ea796c72834f1fc5332deef287937d04831c16b15312442855dd6d14b2e,987120,2020-09-27 19:52:35 UTC,32648531,32645571,false,2960,0
85975780bb297d01fd814b5f41d5fd69ddc24221cc101d3c2953b848011a235a,987120,2020-09-27 19:52:35 UTC,10000,,false,10000,0
43b3abed01263a99d85dc8a851d8e70884c4bb6a32997e035b78bf57ed06af62,987120,2020-09-27 19:52:35 UTC,125069795,125048284,false,21511,987109
08d6ba61e50ecf1e66f5435bcc2e9f2238770487e0e38fe1171c2365639be0d4,987120,2020-09-27 19:52:35 UTC,111921129,111919036,false,2093,987109
202fa9a2a815b8c63f306ad8e3e07d539bc233d57eb1aed4c9e6a6e4dc1fbb2c,987119,2020-09-27 19:48:04 UTC,235665837,235662877,false,2960,0
188f741a41e5e6c0864e71a6d7961db84fcd714e7bd0a4d9031cb9cc7d41ee80,987119,2020-09-27 19:48:04 UTC,500027832,500017832,false,10000,0
38d8ccc2a4687b5ac4dcafdfa22a5eca6b6605f42f18d2f19dbb3144d14cee36,987119,2020-09-27 19:48:04 UTC,10000,,false,10000,0
919bb06668f680eec88198efec1a8abb10a0d2075f332654d159614f4213d8eb,987119,2020-09-27 19:48:04 UTC,500040972,500030972,false,10000,0
ae3d38ea4af8b8751f0da016b51578369a21836596d7133199572ad0770f5540,987119,2020-09-27 19:48:04 UTC,500003267,499993267,false,10000,0
cd1e95d72fc3ece7dae014352b1ed25f3b3b9b5e19a93bed706de3c1694f3ee1,987117,2020-09-27 19:44:35 UTC,34200,32280,false,1920,0
f0d5ef3341f137103f2929b2247dc9980bdacb181e7e16a0e3ae24f1214100e7,987116,2020-09-27 19:43:58 UTC,193797931093,193797929000,false,2093,987105
eb3be8b62771a9a09f300a05a30c3ddf65162a60748aff1c75985e4569621b83,987116,2020-09-27 19:43:58 UTC,250,,false,250,0
834b4b01f2105791ede17372fad2527ab4255b129ad3a2d83a0259e086ec184c,987116,2020-09-27 19:43:58 UTC,10000,,false,10000,0
ccdeb84b3fd5c65eaf4dafd9ed79bc981d3cd06294f462f70ce1111e21796c08,987116,2020-09-27 19:43:58 UTC,1712622382249,1712622380165,false,2084,987105
cf3d9f93d717ad5007a1fe9717be523a3301ef3d95b51fd381770edc93216dd7,987116,2020-09-27 19:43:58 UTC,104159737,104151194,false,8543,0
8ead1ec55c016948820a98833dd8a59501a1c6d6c8524c78c997f78412244b28,987116,2020-09-27 19:43:58 UTC,10000,,false,10000,0
46a9132c48d532a72e9cc6ffddfcc626c393853e61e188e4ce615008794b6f33,987116,2020-09-27 19:43:58 UTC,125756536,125736725,false,19811,987105
7622a2d9a66053da6bfd9f286cda9e1a5690f632d50c76bf9d0787f4efec33d0,987116,2020-09-27 19:43:58 UTC,158726022,158678686,false,47336,987105
067b2efdd9e864dd4e2884f2e3173181d0a8a97a37ebd7cfda1cdbc3df2b172d,987116,2020-09-27 19:43:58 UTC,10000,,false,10000,0
f1ddff699f9844818f7e24da64bc02a33123cc37887e5d2621e774cf156b6c4a,987116,2020-09-27 19:43:58 UTC,104110752,104102209,false,8543,0
2ca276133ac93ad1669b65e50629ff462b8fd43d292498e894bce16131cf0d8c,987115,2020-09-27 19:39:09 UTC,3730071,3727621,false,2450,0
f11ad38d30dcf70691b5e1a9cd802a3a835165b41ebb5b23470037098a0ffd55,987115,2020-09-27 19:39:09 UTC,32873285,32870325,false,2960,0
f9627640328975f8dce306382451623a3f465544888ed46eefb4ebd682160574,987115,2020-09-27 19:39:09 UTC,200869257,200866997,false,2260,0
d894439103b0443b6e1354524ad35cc90dee82eceee9f3242d3b6d6eca111b8a,987113,2020-09-27 19:37:20 UTC,10000,,false,10000,0
783b4f0870a04ba4682dc694d0701de3088a8033703b897e9b7f55c32369ce5e,987113,2020-09-27 19:37:20 UTC,235826556,235823596,false,2960,0
a43c4fe0548faaa8e6201569816f29c6a1634d84dc63c5c91f8f0e4f52bc7203,987113,2020-09-27 19:37:20 UTC,10000,,false,10000,0
dc33a14441d89a00d8f2faa98c2fbda2b9f86be910a670a01644fecdefb5d84e,987111,2020-09-27 19:36:19 UTC,10000,,false,10000,0
9582125404e8cf4d66ea47b52eabbb81fccdad202c6584df1b58dea2f8403d87,987111,2020-09-27 19:36:19 UTC,500010634,500000634,false,10000,0
0d7e4cc65acd7c14112f315aea3090288de649b3c15d099d198fb2f748c21b53,987111,2020-09-27 19:36:19 UTC,1006185,1004265,false,1920,0
657a7be15dac7b14de08662ab2b86ab852ea0447e9c0e20e48864f462630a5d5,987111,2020-09-27 19:36:19 UTC,56974102,56964102,false,10000,0
6a8e94cea77e0bf2e4caf707fb96993eda60d865790b5402399d4784673b2e08,987110,2020-09-27 19:34:33 UTC,369256747,369188403,false,68344,0
cd4c140b8fd6a276f28a96b49ec438fb65d5605de12b4eb15226e97f1549f512,987110,2020-09-27 19:34:33 UTC,27368532,27364740,false,3792,0
04d22fae57abed7f0df446d4fddf39864b11f8ed3fb3f9de6cbe465ee6353890,987110,2020-09-27 19:34:33 UTC,100294204,100288204,false,6000,0
be5f6f1d0ff0b5c4f4ddccd83e914097eb3b039c837755b6265583b398fa1b5e,987110,2020-09-27 19:34:33 UTC,10000,,false,10000,0
97602972e8d053df4e793135c4368407f794c4bc7213965781547e0af8924d73,987109,2020-09-27 19:32:32 UTC,126292636,126268776,false,23860,987097
e1b76240837ef1cc9c036bb570ae4307594a054c188b87cb102dec0163bacd5d,987109,2020-09-27 19:32:32 UTC,100000000,99997570,false,2430,0
c22ef5e2b696a57c9b1921235fd8dee1974c09e056f35755a4bf74ff6b77b092,987109,2020-09-27 19:32:32 UTC,236080636,236064408,false,16228,0
7375cb13c9757f753cd40fd281a15ee6c5d2b1c78d98ad9d76ffd18ede3de2a1,987109,2020-09-27 19:32:32 UTC,500037832,500027832,false,10000,0
e1e8b3332871bed5ebfda58ffd1a0612c9d895b1eb3032147f95ab11bbab32c5,987109,2020-09-27 19:32:32 UTC,10000,,false,10000,0
b13d18d17a8371816b0f5d8cb20fdef25c84bb9b7954646a46ccdb42c5f4cc26,987109,2020-09-27 19:32:32 UTC,61010000,61000000,false,10000,0
26c0d447314bdb06f92c2d5628ef8769ec8528b7694769bd74fb5e0500b5d5cd,987109,2020-09-27 19:32:32 UTC,160035802,159982639,false,53163,987097
2fc0761bc0bf5a923990f5793513f6bc5d260d02ca616c7382c145824f921ed2,987109,2020-09-27 19:32:32 UTC,73612000,73610854,false,1146,0
423578be55bb397f1960dff042dc342cd9511951aa12fdb353fd65f0370e7ff4,987109,2020-09-27 19:32:32 UTC,1136310422,1136210422,false,100000,0
452eb0bb42385b923234a6c330bae83c7d6dc2961ec39c8458889bc1a5579ea1,987108,2020-09-27 19:30:01 UTC,500047832,500037832,false,10000,0
ffbc4b1efb962e9a0475f508eab913872ed93bd39fccc9ff9e2c01c4c70c9ed7,987108,2020-09-27 19:30:01 UTC,10000,,false,10000,0
33cc71fca11db93f9fe0fe712bf3ad6e2bdc54c45b53eda96f43de86b3104c92,987108,2020-09-27 19:30:01 UTC,33152315,33149355,false,2960,0
831d65dce8efa33b3d1d6c3e4add7508854b5983046237bc38d87331998bee9d,987108,2020-09-27 19:30:01 UTC,10000,,false,10000,0
28ab68c126826766014e724a1fc6bf69e2482202102bef99e25d5415a6bdb1c2,987107,2020-09-27 19:28:03 UTC,10000,,false,10000,0
e16793fa85dfc36ba5a5d81060113e917696fd498bb4c8fa59faa19bce38c0c3,987107,2020-09-27 19:28:03 UTC,10000,,false,10000,0
45c3fa889e7f23d55602709e749f9c0f1c04bf6bcccd233cfb4dcffb09371ca3,987107,2020-09-27 19:28:03 UTC,7086968,7078425,false,8543,0
a1e3aee01e4cdbdbcdc9c708c7b65c9f3ab8fc18bcef764f8f5e35a22eba7ac8,987107,2020-09-27 19:28:03 UTC,104200599,104192056,false,8543,0
91a88bb93b1b0d902c467b839ea820d2456531d56c6f6d419013101c36eb6e87,987107,2020-09-27 19:28:03 UTC,153698945,153696495,false,2450,0
15453367a83b0c7fcd632e5fec562dcceb98c8ee12d66635d3c903a59a9e7ee9,987107,2020-09-27 19:28:03 UTC,34903143060,34903133060,false,10000,0
c4dec4296c641cd052f45e2b0d98630f9d48e7d63ec2bd83c1138eb1dec58e63,987107,2020-09-27 19:28:03 UTC,104575801,104567258,false,8543,0
0b1f1be28cdf5425f2c1dfd89a928e2da9a4a0d067ddb37ec2cb521a3cfaad6e,987107,2020-09-27 19:28:03 UTC,113754155,113747717,false,6438,0
25c2cb80fb9641524b8754c8d70fa37b19952e34a6f6c4d0f0da68d7458e87b8,987106,2020-09-27 19:25:02 UTC,236040392,236037432,false,2960,0
cff49fc4b47a7d8233ddf1693794957abc2b9693bdc304f5259af19c29a3497d,987106,2020-09-27 19:25:02 UTC,16466839974,16466829974,false,10000,0
097d3f60741f5e0a6b98e4152b1a51cb456a45ab39a14fdfce4a7c75035136ff,987106,2020-09-27 19:25:02 UTC,734248611,734236526,false,12085,0
32accfd12d78548025e00f9ba225e19326e11df9248c6020e66ab9534ffab79f,987106,2020-09-27 19:25:02 UTC,206497319,206487319,false,10000,0
725b9ed4a4da4fe0d959a0a12b15da1c09fa6fc7f24408f2f4625801b2b72069,987106,2020-09-27 19:25:02 UTC,109534,91422,false,18112,0
87753118827c4dbb3cc033127c2d112265e660932c5dd997b4e9fb5cfd0ac87e,987106,2020-09-27 19:25:02 UTC,193871545186,193871543093,false,2093,987095
4eec3e7ef4f3c1be744e1c2bffb574eec571fd377f37a47ea185419c8712a412,987106,2020-09-27 19:25:02 UTC,104630378,104621835,false,8543,0
b39e7ee789b1f184d5716c65c94abb7352171fc6901382b7334fe8a129e672cb,987105,2020-09-27 19:22:41 UTC,10000,,false,10000,0
4ac39a74590c6f8376ca8d6987d91c60b7a3b10bf34effeef67b7dba380f280c,987104,2020-09-27 19:22:25 UTC,10000,,false,10000,0
9043c72f085ed9d03095d0d868ae4591fd2ef8eca3f12b33b0a7829263fd003f,987103,2020-09-27 19:22:18 UTC,10000,,false,10000,0
5065d12e13fd608209b7c1dc70014c526c1c8e846316c4058103b6f93d1a7599,987102,2020-09-27 19:21:38 UTC,3514500,3507720,false,6780,0
186bdbbc644ae6a27325b6149521d73fa2e6e57ca5f50d0cfbcd16bb1d6d235d,987102,2020-09-27 19:21:38 UTC,10000,,false,10000,0
6ed79812550869153d7f888ccbb97175ddcd6fc693b69d2474a5e059381b7441,987102,2020-09-27 19:21:38 UTC,104888828,104880285,false,8543,0
e3b7b681ac2ce20e714e1284f0cb22e8ec76375e324b249deff16fbb4eaf69a6,987102,2020-09-27 19:21:38 UTC,206535000,206525000,false,10000,0
0c7343c7f3c76afe70b6e346193c9f498901de2b6e437ca59f5a1a5e6a5b62e7,987102,2020-09-27 19:21:38 UTC,126984404,126962885,false,21519,987091
369afd729adf111ef4e31f74edf83264ab2415c278919f2efbb3768bcf887a92,987102,2020-09-27 19:21:38 UTC,161237096,161188239,false,48857,987091
e76754afa88cd62c8a7ec6dc0168172300f2493b930df3b42d00d0ee01bcb450,987102,2020-09-27 19:21:38 UTC,16797011513,16797001513,false,10000,0
75fe9fd56d6c8257b18b5bbc9afc46e528d318d6cd6fc27d9073269d7b8ac92d,987101,2020-09-27 19:18:58 UTC,10000,,false,10000,0
23f7fab27941fccf828260f676f41cb46a2f43e93ef67e7121d55fdbce0df6b9,987100,2020-09-27 19:18:17 UTC,16797021513,16797011513,false,10000,0
c8251624e84a90d8f0628adb0594c4d4b6b48774f1dbbc99e4303077941ae021,987100,2020-09-27 19:18:17 UTC,10000,,false,10000,0
5d82cd26fc264946471bb8912cab27f0239fb3cf90ee00c127b2711186df9fab,987100,2020-09-27 19:18:17 UTC,206535000,206525000,false,10000,0
628a28d87d3f60c13ba78bae9bff69a52bd32dd004462eb4eb5d020fb69cf480,987100,2020-09-27 19:18:17 UTC,143987223,143985130,false,2093,987003
06ce0b540eda25bf881553d1889f0c03ef3202818b067cb5d963c341e3bdc5dd,987099,2020-09-27 19:16:27 UTC,252171047279,252171045186,false,2093,987088
e528e68e92fb93081754058bd57ea61e585cfd1f288e3b2be8bbd88f4e1d42aa,987099,2020-09-27 19:16:27 UTC,206535000,206525000,false,10000,0
4e633b23bc435f425f9e61cf9885b37c5c543a659f1b480d230bac4b470cc208,987099,2020-09-27 19:16:27 UTC,10000,,false,10000,0
3be8268b534b20409afb513fbaffa75fa763915a5940801e4a050783330b2437,987099,2020-09-27 19:16:27 UTC,18023462982,18023452982,false,10000,0
e4370a75c71b197d1db0dec7dfbf54ae67954710f137e7ef80a9cdd1666a10eb,987099,2020-09-27 19:16:27 UTC,51403955,51401505,false,2450,0
da6bb210bdbeacd46f22b3a82b61e0700b63768d928f5f9abfbd45c59c779127,987099,2020-09-27 19:16:27 UTC,95344760846,95344758496,false,2350,0
1b40af12634f1091c96ca5458142c0e5ded575c6e7e1a4a3d1e5519cb07cf5fe,987099,2020-09-27 19:16:27 UTC,2020497740,2020495656,false,2084,987087
493dcd992d1ad12fd72de1fb386ae79e0878504acadbaef5336bf2c6026b9489,987099,2020-09-27 19:16:27 UTC,608847,513687,false,95160,0
cf0ee1465c366ec03913a6e485378ace075fb7f58548453d9455dd87270d194a,987099,2020-09-27 19:16:27 UTC,568991899,568911899,false,80000,0
a28f49bf736e14e2c906d31cce7bb7c912f0e00e2352c218c6f008aed6c58527,987099,2020-09-27 19:16:27 UTC,33304885,33301925,false,2960,0
22ae7f1a2f17ba75b4529fd07ee3cf569ae4b73065c0c163597a4053a7159e58,987097,2020-09-27 19:13:44 UTC,37697176,37690738,false,6438,0
850cbe425e4af9751eff8234ac99fec0d2e19bd8977a4e40f2a521e02aaf3b7c,987097,2020-09-27 19:13:44 UTC,10000,,false,10000,0
21a55257c6d8858d0435fa3c2abe6728ad5913ba25a17e7c4ee1c7d680e6ddc0,987097,2020-09-27 19:13:44 UTC,499990000,499980000,false,10000,0
7932ecd6e634fe25b1ea5fe057cd5b8d20f9df50ba3cfc5583264b9f31e66387,987097,2020-09-27 19:13:44 UTC,285928738,285828738,false,100000,0
01941eba6197b00fc2b01bb2efdd76bc7273d7a3bf9e1c76851462678e0e4726,987097,2020-09-27 19:13:44 UTC,10000,,false,10000,0
34b322cc22354e28a0c9e66e195411501cf90bd2a4ea005b04f42f225cddfac9,987097,2020-09-27 19:13:44 UTC,363340000,363330000,false,10000,0
a1f3a02c1fadf0fc596ef423317209ce2850510a2740cd1a33d2275c21829121,987095,2020-09-27 19:10:50 UTC,10000,,false,10000,0
b1923ae58cc5b811d7859f35e86d5318aa700fab4630d5a4b8ef4a6038bb11fb,987095,2020-09-27 19:10:50 UTC,186688064,186678064,false,10000,0
5f25f86bb47fa043f837cae3548af976b38f7ed4b818cbb9409a37e63934c8b1,987094,2020-09-27 19:10:34 UTC,127567158,127545024,false,22134,987082
70a7965385577cdf762bd3f82cf3ee7da92cf11aae987794f0dc2739084d4aac,987094,2020-09-27 19:10:34 UTC,10000,,false,10000,0
ffd73fc7838a36858881c9181bd260a75a03e1990d12b8ffa61b674fe4b29f64,987094,2020-09-27 19:10:34 UTC,162486810,162434775,false,52035,987082
4fb3100bd66b5ba66748b2b0afe881523971a530f6b18bee2daa231de22ea8db,987094,2020-09-27 19:10:34 UTC,500000000,499990000,false,10000,0
8a7d0c7cd0e13682f27c8aa6e6c604ec1db9e2d65d997c73cb6a9445ee330727,987093,2020-09-27 19:09:48 UTC,35912,29912,false,6000,0
aa001f37cedfdb31a97ff68071418c6c8d8498951bb7505c1184351789333b3b,987093,2020-09-27 19:09:48 UTC,236353713,236349834,false,3879,0
f6bdaee82ab28f6db8f276a949a3f3a9163b7e1470645fe284729371ed2df7f0,987091,2020-09-27 19:08:46 UTC,500005556,499995556,false,10000,0
8ebc3adb78c86740e0037c3d4292c8e0069b673f6437361579a2e69794fba15d,987090,2020-09-27 19:08:01 UTC,10000,,false,10000,0
ea7ed26fd5ab34f292e1cef6d94f8aa38bc382b11a7e5543951713a0d0e3e2cf,987088,2020-09-27 19:07:18 UTC,1500173260,1500163260,false,10000,0
c274f71a493297982c225a5e80046a97c018c94566dbc56418fce13c2837adfa,987088,2020-09-27 19:07:18 UTC,2000237611,2000227611,false,10000,0
cad701b4648a7764ec288ac1ed95e164a9cbe7b826f25ea18814c7477fb84f0e,987088,2020-09-27 19:07:18 UTC,10000,,false,10000,0
300e4ba01c2eb7a48bef258128461442942442c468d67b4ffde693dd886ff88c,987088,2020-09-27 19:07:18 UTC,252970424053,252970421679,false,2374,987077
479ab07f5474f9fe60d825786e0a1733238d0c98e8f4fee1035fc9d51d0d3c8f,987088,2020-09-27 19:07:18 UTC,500015556,500005556,false,10000,0
bd12dd3de42c0648921ef4c86c6d92aab26caac38b406867a1eef1733d2b0b6e,987087,2020-09-27 19:04:38 UTC,2000904246,2000894246,false,10000,0
f33a7d8365000215b18a561736f170cbf783ec3cc57c7d4116bdc62b7c262fd6,987087,2020-09-27 19:04:38 UTC,242677056011,242677046011,false,10000,0
89546a12cde9e6d3cccb391dec36b2529c6a984a1f0758c8beb775d4a0ab9452,987087,2020-09-27 19:04:38 UTC,33467856,33464896,false,2960,0
0f212ec2a3791fe824580e43d7603fff23ecce134d20fcf5eff4b868cdc7ac8e,987087,2020-09-27 19:04:38 UTC,52659381,52651179,false,8202,0
eea2c0b4cd461346e639ba693ddb98bd6c514d401a4ca9cafa146b09bd5a5815,987087,2020-09-27 19:04:38 UTC,225914300,225911926,false,2374,987076
861b9f68591f7d1ef4b87cbd8ebb5d847074759a10ee8b12fa87be9278a0e9a5,987087,2020-09-27 19:04:38 UTC,13992479,13984277,false,8202,0
dfd8f95902b0272e652bbd3f710beffd4c548e3f78a8e94ec2990ad9e686a1a7,987086,2020-09-27 19:03:03 UTC,10000,,false,10000,0
68f1da0b9cc406e039522c0b6d20e4deb487ea9bab65b9646309adfd997817a5,987085,2020-09-27 19:01:50 UTC,38460549859,38460539859,false,10000,0
bf11b96a46b9099216699b6252bbc8e60319f11fc8d9dd51ec6b38a1411e4d0f,987085,2020-09-27 19:01:50 UTC,32810500001,32810490001,false,10000,0
a11d3f2b2da366f61928268216f585962931f46bcb964b13538ac848d24ddc02,987085,2020-09-27 19:01:50 UTC,393530207,393510715,false,19492,0
5fce05f35df32222929b5cde9907c482aa95e15ee203575bbf2470da64e89555,987085,2020-09-27 19:01:50 UTC,128176880,128153003,false,23877,987073
6b2c719cb520fed5a9396d7cbedec31b8eaf034a0e95705e7aafc53a1dd22e22,987085,2020-09-27 19:01:50 UTC,18558399950,18558369950,false,30000,0
f4b735b24a05be344f174b9c71c1b218036717979668192f486e8539bc88b90d,987085,2020-09-27 19:01:50 UTC,97308355,97298355,false,10000,0
553c88eadae35a8c61ae58f7117c2363da0e25a016b83d330f4695705cc5d5b5,987085,2020-09-27 19:01:50 UTC,171500000000,171490000000,false,10000000,0
41eb042b90b55ace8ebe5826fc76eb5c8cf37f510525f356b529e4c845ac76c0,987085,2020-09-27 19:01:50 UTC,504940000,504930000,false,10000,0
11d1863ff529b10cbef5013d3320296fdda2f764d2ad94d953ae7654962ab1ca,987085,2020-09-27 19:01:50 UTC,53053999998,53053989998,false,10000,0
6a5fb6882d83ff4678568f0f5cbf93c7e399bbb9f0e2d3e20a45bb4ce2a70b3d,987085,2020-09-27 19:01:50 UTC,1027274679,1027271425,false,3254,987074
50a1ea3b16b2e5140dc41b8921906481694444e461ae9f9ac2a04e9d978655f1,987085,2020-09-27 19:01:50 UTC,253014126137,253014124053,false,2084,987074
fe52cdcbcc74bb3cfddd7920738b93f7bc094cd1ccc9eb5656b19474226dab69,987085,2020-09-27 19:01:50 UTC,10000,,false,10000,0
9506519d6b22c92857ca58c6d538be0b00cc6b30d24d0a216817db8698fcdba8,987085,2020-09-27 19:01:50 UTC,536297966,536294720,false,3246,987073
3c228cad41dd0822cc43bf63f1fe5a743cf135454c7db92cfae776134f7e6e1a,987085,2020-09-27 19:01:50 UTC,10000,,false,10000,0
f252f91f01d30851d6c0eceef66daa90109282cb006328d3f7db5cc70d6bdc20,987085,2020-09-27 19:01:50 UTC,163836665,163782622,false,54043,987073
23abf4d7be618f6400440e24bebf60205723ad5f44c4e7a87c894a34ea8d1990,987085,2020-09-27 19:01:50 UTC,100159289,100156839,false,2450,0
2d86ce4b03828343673430afea4a113fab39f21e233c2a1c3adc1fae29623a91,987085,2020-09-27 19:01:50 UTC,40011499999,40011489999,false,10000,0
b2de547f4f4dd15ac5c0a8fe9656420392f88c5f6b2c69ca530ec3997f87984d,987083,2020-09-27 18:59:30 UTC,97335641,97308355,false,27286,987072
8b6bdfb1cc3fc4e061c1627204628f9e57878fe15340020228366d145a6f0599,987082,2020-09-27 18:58:20 UTC,506186420,506176420,false,10000,0
c19aaa410855bc69146af47df376cb3fd44b013e545464225d65f73a86a63f0d,987082,2020-09-27 18:58:20 UTC,10000,,false,10000,0
629af6bc59b9467e86d560b5458edb7daa6f82d1c16ffe42a50981f16ce89022,987082,2020-09-27 18:58:20 UTC,3008482,3001349,false,7133,987071
6dde40bd0bbb2d92a11bb039217ea4e1ecb9783c89eaec163a0da3104fa8b046,987081,2020-09-27 18:57:14 UTC,1102664200,1102662280,false,1920,0
c1e9be23de29637ba701eb88c76fd35e581e3e59cd031a2610b247105eeb6d61,987079,2020-09-27 18:56:14 UTC,104918126,104909584,false,8542,0
ad924485acef24601d3af5d443b3b82be78db40c8bf2611559283ac685615e2d,987079,2020-09-27 18:56:14 UTC,231000000,230990000,false,10000,0
8171695d6fffaeec7ee54976df5dc9b96dcf33932d938453340408e5a0057a57,987079,2020-09-27 18:56:14 UTC,175878,163878,false,12000,0
8e4fd3ea20b49c25dd8373ec5e2fa513ad489605f9573807f4fca30d4f244a22,987079,2020-09-27 18:56:14 UTC,876468438,876168438,false,300000,0
ea4c0bed08b45fc220599f15ac6702e2bb84586ddd0b7a03653b4dc56b383d66,987079,2020-09-27 18:56:14 UTC,427511215,427442879,false,68336,0
6703f60dfdebfd89412e1765563bc989806fe7c1acbf3f224a215261062a2812,987079,2020-09-27 18:56:14 UTC,10000,,false,10000,0
ea077714f38ce79923d3942a529e82f46d3cce1deb238a94b4e86e492990cb3a,987078,2020-09-27 18:55:05 UTC,104963806,104955264,false,8542,0
095aa91d88d8ab511237cc1bf681baf7c8b42fae4773a8ca82f4592c06de142a,987077,2020-09-27 18:54:23 UTC,17732377154,17732356243,false,20911,0
40d0f9cbca928ce081604adb8e8f93d6837eeec8ad3e8454f3c75be080a7ea93,987077,2020-09-27 18:54:23 UTC,955866557,955864107,false,2450,0
f6c918f45cd106affc6ceb97dbd0a0bd513f0cb45cba56d92b246c373c37186c,987077,2020-09-27 18:54:23 UTC,10000,,false,10000,0
ab663749775470172b3c231e91e94d7bfed253dfe375149d5bd367f5c82276e4,987074,2020-09-27 18:51:56 UTC,236533320,236530360,false,2960,0
716723795e2f67f0aaa3c673858c9e6b5dee01971e8cf62b22af4708f9135b49,987074,2020-09-27 18:51:56 UTC,10000,,false,10000,0
746aa93092ad5e69de59ffe641ce4fd3db5a685c2023e06505607870a205ac89,987074,2020-09-27 18:51:56 UTC,10000,,false,10000,0
ac30d11e31b0255de7678b8968975e016c8de047dd9dc05cb99ec6eb875c22b7,987073,2020-09-27 18:50:19 UTC,164926470,164880250,false,46220,986983
bea9055b3c71131705e8de13659d8716bdb895c31316cc862c3a92f37a4cdce9,987073,2020-09-27 18:50:19 UTC,128743698,128725658,false,18040,987062
5a5915126294262f384456218541bd1420c83beba057fc81ca7b32725d5f82f5,987072,2020-09-27 18:49:32 UTC,21975236826,21975206826,false,30000,0
6fe7bd50bf42575882189b81c349dcce7cf7dc87df18d52e1b6c7ccc55f3a5bd,987072,2020-09-27 18:49:32 UTC,10000,,false,10000,0
e7366c259255dcfce936c15a51eac352ac0f0ae66dc5525daf2508edd2fd62a3,987071,2020-09-27 18:49:04 UTC,17023497426,17023487426,false,10000,0
67f6bef5f9c54334f8ee1d8f19a861cf48e1dff9f6bdea0f42f03be135dcde83,987071,2020-09-27 18:49:04 UTC,252857377,252853637,false,3740,0
7a488b25402ceb28bd5eaf8b45c99df7456689912ab0ffe696dad2e7b732d703,987071,2020-09-27 18:49:04 UTC,126136,103496,false,22640,0
9c497c09afa2704c406738652595530640fbdbc899352735d94ceb84da3fbeb3,987071,2020-09-27 18:49:04 UTC,803674257,802914217,false,760040,0
8b68bea02cfc4f5051accb9b74ce5fdb7ff8b4a2fcc596d0e56f02e53d2bc0d1,987068,2020-09-27 18:47:03 UTC,105187611,105179069,false,8542,0
3b5c02dd62177cd8a70e5fb17d5e3a054c64906827ac77906d9372acb5d54cbc,987068,2020-09-27 18:47:03 UTC,339116240,339071480,false,44760,987066
d852fc1b9c3baa7bc1a8f85b2a8185c2e3fc463b1898b042e8bbf277f07229b2,987068,2020-09-27 18:47:03 UTC,17911144458,17911134458,false,10000,0
91e61069c203e5bf1d98eab78d5d2219baf17759da241bab8fc7f68b8847ac32,987068,2020-09-27 18:47:03 UTC,807456332,807344614,false,111718,0
bec470afb8b0331605618bc87185c4dce90840e39a6598a33e0a60747c1791ef,987068,2020-09-27 18:47:03 UTC,253613628229,253613626137,false,2092,987057
a3cc4a7835f9794318b1f471d07e339b6f2982a016d7b5d69d805edd10491f7f,987068,2020-09-27 18:47:03 UTC,10000,,false,10000,0
ae940e3b156019431c00f499b04ae30d67266019579ca89b04e904d3f1fb1ed8,987068,2020-09-27 18:47:03 UTC,29855000,29853245,false,1755,0
5f6b4d743c785143909914a701000a89cbc5a13caac425c1da45a50c7a192021,987068,2020-09-27 18:47:03 UTC,500000000,499990000,false,10000,0
16b886f7676c2aebfc51c6b80e6728c47acba7f90f8d2dbaf7b4074494ad8570,987066,2020-09-27 18:44:45 UTC,105146520406,105146518056,false,2350,0
dbc1922e4ae6706725f4e8d86d30f7df97e59776638d3dfff2ea36d213920701,987066,2020-09-27 18:44:45 UTC,129427525,129403950,false,23575,987055
23523fcc5677d9024d95fb05ac09718dabb47710b9404260eec02268880b9a18,987066,2020-09-27 18:44:45 UTC,54232741,54211309,false,21432,0
d8e30ef20d4706684498ba2e8f36bdfdab8e7a3bb261ee635b3dfed52f9f4a38,987066,2020-09-27 18:44:45 UTC,22168493132,22168463132,false,30000,0
79c6fecdaf8fec59fc19c5d1dfc5c7ed0aeab446a3f3648a2db1e13bc22510d4,987066,2020-09-27 18:44:45 UTC,2806136,2800277,false,5859,987034
64df90e2ee63bf1056c62e324a8081505fbc65e99f5c5698fb6e40a45ea58785,987066,2020-09-27 18:44:45 UTC,10000,,false,10000,0
c77761b5f4cd8b7d33326716659ed4e41088e62dddb50664f5ea3e2489300f77,987066,2020-09-27 18:44:45 UTC,105660565,105652023,false,8542,0
259d250f7ac2a10c35017eea40f320e5e60a93b301d0c01c2f9324f708b825fe,987066,2020-09-27 18:44:45 UTC,33673519,33670252,false,3267,0
15905ad1e8660cb75e571a5c2001889a44a1a6d3f9fcf7d35cb865857a8f5b8e,987066,2020-09-27 18:44:45 UTC,10000,,false,10000,0
cd080acb7b8a3576fd72695a710136352cbf85dd3f193ecc78e8440af156f4c5,987066,2020-09-27 18:44:45 UTC,105706837,105698295,false,8542,0
9c396171f6b74c3b885f0b73383c83bdae362c9f7849506113a75fb2d18d5133,987066,2020-09-27 18:44:45 UTC,14500000,14490000,false,10000,0
53ee46fc330725e0d93d18fd886cd7f9d9a27050972d42cadcdb720d2e9ee41f,987066,2020-09-27 18:44:45 UTC,166197723,166144242,false,53481,987055
4057523e3a652ed1c4939b9bce945d6704aec2c4c08b9fd324536e39da1c5911,987066,2020-09-27 18:44:45 UTC,10000,,false,10000,0
efc8fbd948627a9dddd47aeeddb1faa4ef81bdb6c94c30fb61b65a7e280904da,987064,2020-09-27 18:38:44 UTC,102252859,102242859,false,10000,0
f2afa1cccdbfde0fd76efd87d75dd0a474727ef6fd4f8f85757d257fef718d2d,987064,2020-09-27 18:38:44 UTC,10000,,false,10000,0
6d3c8a00b89efc4f4eaf15ecced02cd26383afb3abda085cc655f9a3d5599556,987064,2020-09-27 18:38:44 UTC,285997074,285928738,false,68336,0
4a0b6121b797f6007064a85722c2aa458823c01e08b410a5225710cd3d7ccc7d,987063,2020-09-27 18:37:22 UTC,99768305,99765855,false,2450,0
9f7691c685640eef10afb027db8b62db1cac5be56d5ed97509f21001e1f33053,987063,2020-09-27 18:37:22 UTC,10000,,false,10000,0
9ce3adc6efea6bfd5debfde75e4f2cfe6bbdbc9a4f945ba6b8a7e09f4a79eefd,987063,2020-09-27 18:37:22 UTC,9000461,8800461,false,200000,0
b29d4c681d0edb9cd1fa518c3fb79f6a67cf205a968d5dee574365f3a6b979a7,987063,2020-09-27 18:37:22 UTC,500163808,500153808,false,10000,0
98da567aefd77ce3473f457f7e77014309f829f72cbe4140f8344ac7211d40f6,987063,2020-09-27 18:37:22 UTC,100000000,99997570,false,2430,0
e040683316021e3de93a38b1cd722ddeca7bad28dcb25c21c2d882d2606fe7da,987063,2020-09-27 18:37:22 UTC,245961604,245959512,false,2092,987052
4392145d4049ab7410c3e47493e91c7ec8755ed09101016643bb267a38048236,987062,2020-09-27 18:35:39 UTC,253913130321,253913128229,false,2092,987050
729f0a3680e07db6643aad6d17e7b0c770e2119a7ae0b5dba00f3964c82fe2a0,987061,2020-09-27 18:35:32 UTC,236726898,236723938,false,2960,0
3f3fefe893a4c5a6e3b77391b3092f747f1cb983f2f3e8623bc79b8bba2fe517,987060,2020-09-27 18:34:44 UTC,222893100,222888600,false,4500,0
84da691d238b7be4165454d27ec7e1cd46967cfd4959dbab463a8301d3b5951b,987059,2020-09-27 18:34:31 UTC,492500000,492498080,false,1920,0
0ca684ee28159d376ccc39d5a00741afde4882a5ebaf88bb0e63aaf0f428c787,987059,2020-09-27 18:34:31 UTC,10000,,false,10000,0
1f578d95fa234c6ba1c9bfc128694fc5dd300a8e337a02d87b7537bb28f5e506,987058,2020-09-27 18:33:28 UTC,167587740,167531064,false,56676,987047
d632485b2239d06d37d6b21a1cc5f6199ca2210855400aee347202e469b48716,987058,2020-09-27 18:33:28 UTC,264885,228885,false,36000,0
1fa6ab05354b0677d2b592efa9c357a33280a2b66f439a40179fae7116442e52,987058,2020-09-27 18:33:28 UTC,10000,,false,10000,0
4c8148db2a80838c9518c9a7dfb7916e24af6c5095b948490ae42f3e0adab657,987058,2020-09-27 18:33:28 UTC,100000000,99997550,false,2450,0
d8e444d8f60c9d0a84ee1e2ad85ca18b01088637931b2724b3c0ed7c40f536d7,987058,2020-09-27 18:33:28 UTC,499990000,499980000,false,10000,0
4c80180c0e3ad5687180c91fe12b3b32723616c901b7c0618476400a552f2329,987058,2020-09-27 18:33:28 UTC,10000,,false,10000,0
9b92b11994f75d12f2fe80d22c8715902ad01237e0da7abe84c75488643b2df0,987058,2020-09-27 18:33:28 UTC,33820173,33817213,false,2960,0
7c1eeb7c3eb4bf14d5b577953771fdced9cef6ea98e0f0efaefdb22fbf15ce5a,987058,2020-09-27 18:33:28 UTC,130065678,130042384,false,23294,987011
8a170bc575f7fc8970d2c69dd0f94efd4e43ab3b42c9ea3920e574837f6bd6cf,987057,2020-09-27 18:28:09 UTC,10000,,false,10000,0
a768bbbb82f3589461898958c75869d2a8f24be38fa33a6369f0b0a05e3d941b,987057,2020-09-27 18:28:09 UTC,885325759,885322359,false,3400,0
d7a2bc928bde6d685f4ab8a88f4772ef3b44ea0f9b308e8b8e7cedbe60d504fb,987056,2020-09-27 18:27:31 UTC,499571975669,499571475669,false,500000,0
2842d4c1d8ac13d293146e8a049df493207a0929cdede6838a75a8b2dba67295,987056,2020-09-27 18:27:31 UTC,236954168,236950901,false,3267,0
c3dc2c0b90e2ebde96a7f55fc21dd653c2c27166240025dd162c0521c82286e5,987056,2020-09-27 18:27:31 UTC,22274881496,22274851496,false,30000,0
8f7034545f566864cf7c31aa084b662001ea01f1837fade1b9d8a1711ae7ea52,987056,2020-09-27 18:27:31 UTC,105832600,105824058,false,8542,0
170ae4e7e3f03256fd45aa01eb49b9c5684890a4c25d065399649ec5ca423ca7,987056,2020-09-27 18:27:31 UTC,901768438,901468438,false,300000,0
0eb09687a61b4b7a1ca38ec6d42f89ab0023f5b78402247b8999311a490415c9,987056,2020-09-27 18:27:31 UTC,10000,,false,10000,0
17c3a1e576e1177ac742c0c5cd7b85a8fd198cd64e172a35616d2df52288b46f,987056,2020-09-27 18:27:31 UTC,10000,,false,10000,0
a75ff90e43915f0645e36a8ddd242c7fce28317c1ce3e5bce8d1885cfb4fea97,987056,2020-09-27 18:27:31 UTC,10000,,false,10000,0
f18136959114226807063a40b30c16a67a514c48edc574e6663f62738c53d1d1,987056,2020-09-27 18:27:31 UTC,105767855,105759313,false,8542,0
7aedcb4ccaaf2ac30d04fc64133b406627b5209a350c5d13b20a925c37f4d3d2,987056,2020-09-27 18:27:31 UTC,500000000,499990000,false,10000,0
cdf48380a7d4af7fbce2f1374e7b547d22de3bc00b5ce9bdfc97f628255bd0a1,987055,2020-09-27 18:22:42 UTC,130823475,130799037,false,24438,987044
c7b8ea811aaf3368c8e7a2bbbce10bebd98b336e3f0ffad374d6827fb7cfc500,987055,2020-09-27 18:22:42 UTC,168773536,168715699,false,57837,987044
dcdfa3bcac15f16b56da9cbaf53c0a1f309b2c22fee3112fd9667bf7ff6944c9,987055,2020-09-27 18:22:42 UTC,10000,,false,10000,0
c8c9b7dcf4e424eadaddc6d255e24c90d676d75e1a271cae74050f72a04d8591,987055,2020-09-27 18:22:42 UTC,10000,,false,10000,0
8e9f7607c42a91fce623fa35fae3ddfa07f0af7dc1c6368815c8b0427bdceddb,987055,2020-09-27 18:22:42 UTC,105875158,105866616,false,8542,0
7d8d5739a10e219da200f7bca17d6049addf8ed9a01e927af084c2082544a1b7,987055,2020-09-27 18:22:42 UTC,434382194,432718394,false,1663800,987044
f1811d64c0965b20dee767fd0d5250f67e085f506b19255001690156e7aa78ed,987055,2020-09-27 18:22:42 UTC,159000,149000,false,10000,0
46de5424223bc2501ae70186046d641d97de09c01b9beb8f3f77e9d541bdd07f,987055,2020-09-27 18:22:42 UTC,17411174458,17411164458,false,10000,0
4ac247134c0bb92c441e81c1045efd4455b26ee038bb70d7f3d33e358ff0ed38,987055,2020-09-27 18:22:42 UTC,106110579,106102037,false,8542,0
976f99776a8054d2678e3fc4b3ef460503d3921a2d02fb18572baf3495b9969f,987055,2020-09-27 18:22:42 UTC,15618543,15613922,false,4621,987044
6b75a3d088fdbf407d0c520b24062ba0743de191014d16d8e39ae1e6cef60a7b,987055,2020-09-27 18:22:42 UTC,284838884,284836800,false,2084,987044
5a101396b42b3bdb43ef93d05eede83289afc8c737789d1dc9dc47724b90e930,987055,2020-09-27 18:22:42 UTC,130000000000,129999997650,false,2350,0
355d6a83f11c52eb56bd31be60e4e4c173b2e4aaf62de60defa25234ee132ebe,987055,2020-09-27 18:22:42 UTC,134166042,134146861,false,19181,0
9841d7af97775c13b86060e1d9ba1020de870aa99b7551942193c27a0ccac925,987055,2020-09-27 18:22:42 UTC,2914851913,2914771513,false,80400,987054
0f6df7f0ab587faf30bc0670000921ec3d6b2cff3b990c5b943adf4acb04ea24,987054,2020-09-27 18:19:21 UTC,286013493,285945157,false,68336,0
c867e537c915d4702c01e37b12c7782d632e7153175f23d4fb48dec1b16c117c,987054,2020-09-27 18:19:21 UTC,33972225,33969265,false,2960,0
adf9ed8ac9492ae366cdd55047c19cfa30b383f318fc088d5d20d39fbe453927,987054,2020-09-27 18:19:21 UTC,10000,,false,10000,0
ef11dd7f23cf8e3db00f54badb9701cf4ec7fd202e287585845faf27b054cd02,987054,2020-09-27 18:19:21 UTC,17597305221,17597295221,false,10000,0
49ef18b2f1d9b3cb77826f94e209c3f9785f8b3abf7aabb4e1877b77e2484dcd,987054,2020-09-27 18:19:21 UTC,10000,,false,10000,0
285751f9e5ad63be1a81b5cba87858814ccaeebba49d9928e884275d1fb13291,987054,2020-09-27 18:19:21 UTC,106230993,106222451,false,8542,0
d8e5d8100de4e0bbf13368519d0769851f4daf3d6b7cd0158cdd3c94ea85ec3c,987054,2020-09-27 18:19:21 UTC,254013132413,254013130321,false,2092,987043
fd2281d675fb83fa37b7e7cfb9a77dc2f9037823ed8f61faa81369d61d0041eb,987054,2020-09-27 18:19:21 UTC,7087392,7085009,false,2383,987043
690bd81cdb841ebf2d284614b10f83b606ce0a6b95c5041e7b3a0e90e7a07df9,987052,2020-09-27 18:15:54 UTC,47490393,47480393,false,10000,0
2ff87dd1c2547648ac7ff5a16cb646632b4137cb019085aa72b303fbbde2fc1d,987052,2020-09-27 18:15:54 UTC,237175037,237172077,false,2960,0
97c091bab6e5c33f40a0ce7e90080778c79faea26694f860e3bc4d9a35267c4b,987052,2020-09-27 18:15:54 UTC,256690795663,256690793571,false,2092,987040
b1d54f4cc38d9803d3db37343b6f8aa3c7146fee8fc219e558c4be6bfe1f08e2,987052,2020-09-27 18:15:54 UTC,17597315221,17597305221,false,10000,0
3ac3309786466f96425f7b600707800728d1e726d77e62284027b29165dfa505,987052,2020-09-27 18:15:54 UTC,106330043,106321501,false,8542,0
7a7b1192982ecdddfcb9f4d5f7a34890152d80454d03e2bf52f686327edc1127,987051,2020-09-27 18:14:51 UTC,10000,,false,10000,0
a646b56c047a629487be822191d7253a45fa48dee091c3b251a05aea971140ba,987051,2020-09-27 18:14:51 UTC,1000074603,1000064603,false,10000,0
a9e1e9d5d2b9033646e680d250240dcd9203612cc5cba96ee64fc501e5822a7a,987050,2020-09-27 18:14:10 UTC,20083659,20080749,false,2910,0
a3e78d764fdfb24c8d2a3a445e4dd3c62fc96a01dfce83ad80a62ef4e30cf3e8,987049,2020-09-27 18:13:54 UTC,14510000,14500000,false,10000,0
77895a67a72aa692c6d2be0b9c725e4ecbd218f8694264106561815216943e6f,987049,2020-09-27 18:13:54 UTC,2702272760,2702262760,false,10000,0
f3a405d88a277f5a8f3793d7de00136f7d9a01972b08692c6eff7cf6a120aa3b,987048,2020-09-27 18:13:05 UTC,106457598,106449056,false,8542,0
0c93f3b564f086c3b4f9172dd043688b0e86f416bba65fb2d955ad9e71618be6,987047,2020-09-27 18:12:39 UTC,10000,,false,10000,0
47ac545169b90f76facca34850c240dde8cdd7cc3611c89c29407d1ea6cd853d,987047,2020-09-27 18:12:39 UTC,500005642,499995642,false,10000,0
7aab2110286ab00102930eeb4b87664bf992bd7041ffa05525a5e63515b7ae4b,987047,2020-09-27 18:12:39 UTC,100000000,99998080,false,1920,0
f2df72ba5591b757298c5cdafdc51145406ee818ba2f28872b9c73488a426371,987046,2020-09-27 18:12:13 UTC,194500000,194498080,false,1920,0
34c98d6f186bace818bfa460c70929691144c12d3749efc9addabeae8ba08b94,987043,2020-09-27 18:10:43 UTC,500088961,500078961,false,10000,0
199beb681a5976d4512de74d770ef1580f47c5e60adb98411a28bb25ca2bfb92,987043,2020-09-27 18:10:43 UTC,500015642,500005642,false,10000,0
771bde4b6cf7bef9f342690f42242a3f71f4d626cbe846f58a905408e14efff0,987043,2020-09-27 18:10:43 UTC,170215494,170155692,false,59802,987032
d05b29f603a4f8ede2205b56bbb405eeb90101c09ad06a26bec56c47331c8832,987043,2020-09-27 18:10:43 UTC,10000,,false,10000,0
f59610fadf5090f8a061e1c140ec5e825ed06d572cbe5161b25b07637fdb674d,987043,2020-09-27 18:10:43 UTC,131478479,131455476,false,23003,987032
5960e7f47c8efbcdc970902ffdd291fb98b46f9531f38603f9160b2945d6a922,987043,2020-09-27 18:10:43 UTC,34129176,34126216,false,2960,0
4574f32561319a8d4ca87d9c09ece667566f2b13c5bbbe371c58e0899360c9a6,987043,2020-09-27 18:10:43 UTC,6427100000,6427097908,false,2092,987032
7c7fadab9d82472a00205154db9855ac74f4de82af41ac16b8c6de9839a76fbc,987043,2020-09-27 18:10:43 UTC,81003472,79250272,false,1753200,987029
7fb68a5e64011d06a2562bafbcb9f0a296a0f2af48417e42ef3ea98552b2d466,987042,2020-09-27 18:08:53 UTC,3796728799147,3796728762486,false,36661,0
8c46239896f19ebd8827c9b97b4688ab1166cc708f10fdcf7eaa2ea0a4b7e845,987042,2020-09-27 18:08:53 UTC,188092,147692,false,40400,0
2b71cd069b2a2a2953d59eb1d23600178e5da387dafb75db0832b1f3429f4812,987041,2020-09-27 18:08:28 UTC,10000,,false,10000,0
8056d1a64f67e33f1af7691540b031124bf21292ae927241179a6d40d2b013be,987039,2020-09-27 18:07:51 UTC,500098961,500088961,false,10000,0
098039211a398a583eebebb35080bfeffde056465de5ccebd1ab79261b27a1ba,987037,2020-09-27 18:07:04 UTC,530418000,530412000,false,6000,0
7b5a06340e3b6df5f9549d2de873703ff3fc1d33174ba735240424bae841a03b,987037,2020-09-27 18:07:04 UTC,10000,,false,10000,0
1c188841d54caba66c8e2a852142fdb2798e53b54095d662c9347f16b87106a8,987037,2020-09-27 18:07:04 UTC,1000042085,1000032085,false,10000,0
b08841194ca1f8877592d888146bf2053eb365e1cab1af8e7d13e14756fc565c,987037,2020-09-27 18:07:04 UTC,5402282760,5402272760,false,10000,0
086b02047975e062911e2d126529b4df8595d5502438863ee3941cd68ef54ae8,987036,2020-09-27 18:05:30 UTC,10000,,false,10000,0
97ffae9c8bed29238caf11aacca4f6d2942f6cbce3405c4b49c02f8352661129,987036,2020-09-27 18:05:30 UTC,2000247611,2000237611,false,10000,0
efd5e1cde2e09cab788ed8699f4ba7192da6314591dfd7ae38046f5f20dfcfeb,987036,2020-09-27 18:05:30 UTC,1500002184,1499992184,false,10000,0
4111b8b86fc67f6d048471c75c764cdbb184167502d84b754ffaea96e918b3e4,987036,2020-09-27 18:05:30 UTC,241816241000,241816231000,false,10000,0
be196d5f9da38cda254f460a5416170fc7c7b9f684a8fba73c7caa9e69a77fb0,987035,2020-09-27 18:03:15 UTC,237427101,237423528,false,3573,0
c89106729ede8bd6b8c922b78d0664e8d576a6ab1cce3f73f4cb040a5d515bab,987035,2020-09-27 18:03:15 UTC,65925120661,65925120561,false,100,987023
ae86db95e8c140f458f1b3e44c6f439a678d843049387a025fc40fa4320557fa,987034,2020-09-27 18:01:58 UTC,106558190,106549648,false,8542,0
3c7d0a58f0d20c64bca8416b0152175c629e2e65aa3dd44a109209cac1e9b779,987034,2020-09-27 18:01:58 UTC,144484276,144415940,false,68336,0
043869db277493bca7ba85e56aa4dcce832806b1d35c89df79bd8f91d704c5a4,987034,2020-09-27 18:01:58 UTC,106526744,106518202,false,8542,0
32391e4dd12f6d2bdd57976647510d3ac4c0e13e1045489648f305f53befe782,987034,2020-09-27 18:01:58 UTC,132104732,132081199,false,23533,987023
2ac615d2f5796111b97dec7b58ffb4577a55894e5b0ac01bed92b0c9b1d204a4,987034,2020-09-27 18:01:58 UTC,256710796355,256710794263,false,2092,987023
f9d402d5e34997d12fce7249d925d0b67c19ca72f9de22beba6bcf8439721a9e,987034,2020-09-27 18:01:58 UTC,34293026,34290066,false,2960,0
23c27450fedbd05bc8ec9b4b6188a8231f6359f136cef9b18bb8abe44390c86f,987034,2020-09-27 18:01:58 UTC,2110446210,2110442375,false,3835,987023
b85ea58886e5c4d3381c756cb15a0fa187cd72867b9b464dc3f43ba619effa03,987034,2020-09-27 18:01:58 UTC,10000,,false,10000,0
42ce048740759de480f69360f4062504a2152666aeb6516e81fdb921123fbe5e,987034,2020-09-27 18:01:58 UTC,10000,,false,10000,0
60036ab5c28c589723a9855214618c08b54ef14cb977c674f40080ae162b76d6,987034,2020-09-27 18:01:58 UTC,579213394,579210721,false,2673,987023
3e32c58a86b1203e8ef92634bcc169d7491d2f4f2eb0e8cf26bc28c40ab1aaa1,987034,2020-09-27 18:01:58 UTC,171706896,171643865,false,63031,987023
a16c105ed3311ca4425e97017e5a16307a80edc0236b245940cecb2ad221b53d,987033,2020-09-27 17:59:35 UTC,10000,,false,10000,0
b9195782ec89d63a226f97dec6f37e11b02fe34bd1a0ce4c446bec16c3b01ecf,987032,2020-09-27 17:58:48 UTC,10000,,false,10000,0
31f72e70e44aa7a7eb75b0d191d543b676afa4b19a5436d64033040c7eba2d98,987031,2020-09-27 17:56:26 UTC,480929974,480927524,false,2450,0
ab599968b54c1c0c38a248a7329a9ceafda4950c4f1e316347673add45b97a60,987030,2020-09-27 17:55:46 UTC,65283022445,65282992445,false,30000,0
2c469ab21f6cf3c186f82e6e972749469084415dbbfa4cd39e61b63e67fbdb78,987030,2020-09-27 17:55:46 UTC,237588795,237585835,false,2960,0
22632386d6bfd68eeb563af51a2f0f89db799e431f8cac04367f60ffdad7d1dd,987030,2020-09-27 17:55:46 UTC,10000,,false,10000,0
c1799784c3745c56d6dd2a8848e2490025f2ef322d180f623962ad57cc9544e0,987029,2020-09-27 17:54:55 UTC,500000000,499990000,false,10000,0
1ead8183f82a8879aa9889dc1bddcd865904bba1c77493da563441d0946ff422,987029,2020-09-27 17:54:55 UTC,23118911496,23118881496,false,30000,0
de82fd7247c678ad82537d83c07e0af57adcf86c495aebc82ad51ac2123f639f,987028,2020-09-27 17:53:45 UTC,10000,,false,10000,0
fafc2a54c4ee7c0e184dbb09c21727830e62bf33ba3fc37326a0a41c820e30ea,987028,2020-09-27 17:53:45 UTC,34644274,34641007,false,3267,0
f29619bc558c1ca7b054d4be9e77fd8f34ba15e12a58e5b1eef68c32331d48f8,987027,2020-09-27 17:52:59 UTC,10000,,false,10000,0
f8eafedd0855cf5ff19a908b9aee224ca604a6506d2bd797071f93c10023709d,987027,2020-09-27 17:52:59 UTC,106596374,106587832,false,8542,0
0b7e4402eeb4acc2468b94b69613bf9dbb99a7b9db8539c20be81082b046b685,987027,2020-09-27 17:52:59 UTC,2000000,1990000,false,10000,0
cd740850cd3351e61c836a34ebcfff6e0676c64fb031591dda747611c79be2ce,987027,2020-09-27 17:52:59 UTC,835501555,835497815,false,3740,0
413e185cde4d7ad3db8077a1a967fb3d3437c327cc60f8c16743c93f7c2aa1b4,987027,2020-09-27 17:52:59 UTC,184825802,184808952,false,16850,0
5b9856c53b6f8eb34f803e5fcd5c8c11f9296ebe09963539945673756822c280,987026,2020-09-27 17:50:13 UTC,172997622,172936094,false,61528,987014
8ca20cc9474a08a9aa4ba4b67d11cbbf989acfa88327a3b977fe1eacb02b4a83,987026,2020-09-27 17:50:13 UTC,294863605,294861513,false,2092,987014
4fbba74c4ba6c69b09810b34e9030459279d7fafb1e5dc97b867a00b5e656ad2,987026,2020-09-27 17:50:13 UTC,10000,,false,10000,0
c0b8d14dd7e93331ef8d1474b8e3c86cf7294ff9efc1b20199c36df412ebe269,987026,2020-09-27 17:50:13 UTC,132842336,132816172,false,26164,987014
c4c92271eee924e40a53d051d247dcbf499cb8163e2f055d45955a063760d82b,987025,2020-09-27 17:49:44 UTC,237747573,237744613,false,2960,0
99c6a8a41c33bea955303b1e17ea964ecc060e31369ad7d90a3c99b40f304af5,987025,2020-09-27 17:49:44 UTC,17586084240,17586074240,false,10000,0
0bad9961aa4286608e5d46fbac444a9a2404d48b1b4383dcea7862eab62b99f0,987025,2020-09-27 17:49:44 UTC,61275578923,61275478923,false,100000,986961
0e703eb19640a68f0860684cb436185c333a65e4d2bb1c604d1ed7ce58d304c8,987023,2020-09-27 17:47:38 UTC,17901110382,17901100382,false,10000,0
95f27f4e0ba374e4642f9c31e796a6cf4693005c720ade3f1ca74c0c00517250,987023,2020-09-27 17:47:38 UTC,10000,,false,10000,0
601132da482cf109b6934f1d26b0d5dcfbb9eb27911e53d31c6ac86d06d4fe0a,987023,2020-09-27 17:47:38 UTC,1831000000,1830997464,false,2536,0
359b9359155135d15b15e99b46f9d24db43271cec98aaf65302233daf0e6dbdf,987023,2020-09-27 17:47:38 UTC,800659112,800655701,false,3411,0
6c050abc1d3ac3c259cd84b01b699fe01597e52405d5ce1d680563c2d4628b37,987023,2020-09-27 17:47:38 UTC,10000,,false,10000,0
c693b7ac6d79952cb1fa3c4f98c2548bf68d8d758360da7f145681986265a4f9,987023,2020-09-27 17:47:38 UTC,99000000,98955240,false,44760,987022
a5dc2f5a4c5298708d7b4cc7c61b397f99914a2d28718f60f2ad10c9b6cb9502,987023,2020-09-27 17:47:38 UTC,106899832,106891290,false,8542,0
14ca4adeeb54e29500acee25818657008992c54686f277650bee94b3874dc9f7,987023,2020-09-27 17:47:38 UTC,10000,,false,10000,0
5801d1120742ad3f43501cf20cb34fed7f8030d710064b378ad720771cf1c533,987023,2020-09-27 17:47:38 UTC,1831010000,1831000000,false,10000,0
2bc632007fe306a2e25ff5cbeef658e81dc9c16ca90bf75f2d7c3203cbb87807,987023,2020-09-27 17:47:38 UTC,103062,97062,false,6000,0
e5e6385a03a50dfe102db26cb0a74bc230786988df4ae94da388a79fc73495bf,987023,2020-09-27 17:47:38 UTC,68303284,68300854,false,2430,0
5e3f96706814dcf059f59a5f7252db5eda6634afe04366468b2dcecb9541c3ed,987023,2020-09-27 17:47:38 UTC,106865831,106857289,false,8542,0
bb62d5e6bd6170beabecf3946fc127db124f893ed117391a074c5b83a10c1634,987023,2020-09-27 17:47:38 UTC,34852523,34849563,false,2960,0
39b7db5c8c3aa84b6f00f09120c91e2caef086ba1ab71deb49c603a27e6929a3,987023,2020-09-27 17:47:38 UTC,1719049484341,1719049482249,false,2092,987011
92b20485ad998a53930bcf1755a8011300200a0bb98cbc757fee40e95763e4b3,987022,2020-09-27 17:43:18 UTC,133545642,133519743,false,25899,987010
da027c82085721e16cd015308daa2c914783e2344348a41f85188392610548ce,987022,2020-09-27 17:43:18 UTC,257710320447,257710318355,false,2092,987011
4c34a80aa42698291ca4c00ae60b371ce67e4e7c36017e18c1362e75b1d719de,987022,2020-09-27 17:43:18 UTC,478845382,478835382,false,10000,986998
93166027b3e234e35019fe542a744dcde3d88b3f38bc9278c1386299772f5b1b,987022,2020-09-27 17:43:18 UTC,238308034,238303849,false,4185,0
cf9d33e4395b82cd73300e00f7e18ba8356ee5b80da27a9584d48a7e8bcdab57,987022,2020-09-27 17:43:18 UTC,10000,,false,10000,0
20aa6f9c7b728310f827aec25c55115d30b865cac2e8519b8132aa5a3b0b254a,987022,2020-09-27 17:43:18 UTC,202278150,202268150,false,10000,0
aad90b413f6248d9f7a476815315010b11dcd820574ff68b2345a0e2947bf8b5,987022,2020-09-27 17:43:18 UTC,102582,100132,false,2450,0
87e250f6d53a2c37ba87979d5d5780960691be8840d21e37f52e818c7de12c23,987022,2020-09-27 17:43:18 UTC,2266075377,2264799474,false,1275903,0
86178c599994be1cab7e3a39f453af106326d8b6232b8a438cb2e13f6e43a2d7,987022,2020-09-27 17:43:18 UTC,174644561,174579181,false,65380,987010
cc848d7cfda446e611d2d6d0a188bb5a0d970964df843865d06067a4cd0c1639,987022,2020-09-27 17:43:18 UTC,100000000,99997570,false,2430,0
de1006549e97768fa383570546756a8ebd45d34bdbd62c15bfa47fc49e4aa0e7,987022,2020-09-27 17:43:18 UTC,10000,,false,10000,0
422d2c69f380eb82fbd61a0594ec0f88363f8ac1e168e6ea5b1b7a3780391b0f,987022,2020-09-27 17:43:18 UTC,144497514,144429178,false,68336,0
4a18631f24963a4e64848fc23410055582cb92ae2862882a80b2a08ba9fd60d3,987022,2020-09-27 17:43:18 UTC,7165701,7163271,false,2430,0
cb23a3a81ae7a5126485b1324816031f69cb0f2b493e60957f7331107d54356d,987022,2020-09-27 17:43:18 UTC,10000,,false,10000,0
102eadea5d5474be5bb1a62af641745768137ed3224f947142ab1ff679f2a7f5,987022,2020-09-27 17:43:18 UTC,100965011,100949771,false,15240,0
1ce982921fed8443c0957daf516c2fd75d8fc2cd47607fb9fc93c917d90adaeb,987022,2020-09-27 17:43:18 UTC,21020585,21014709,false,5876,987010
bfd6e3ca37a7018136873feb79c243de8c0694133ca8983571260c6dc8e5961a,987021,2020-09-27 17:40:17 UTC,35162904,35159944,false,2960,0
93c4dfb452b50a51eca9c00b605a0cacf91becbf2136799117fa05982dc830ad,987021,2020-09-27 17:40:17 UTC,238560378,238557418,false,2960,0
c702eb46b2189823c923a2e05f2d1c170b6e62d73007e7cf9da843de4040b4ea,987021,2020-09-27 17:40:17 UTC,12373764538,12373725338,false,39200,0
29ca3375834191b90f2c2cfb906ef733ed4eac93e3645ac674173bbbb4e8df06,987021,2020-09-27 17:40:17 UTC,100000000,99997570,false,2430,0
ee2585bfe3a16569c8d651b7ebbde9e426352657340fa90a7d2d1f26aba1af7b,987021,2020-09-27 17:40:17 UTC,10000,,false,10000,0
20454c327cde94d39dd01f491e0c226e4647741fa6780279a76a9393bd3e3db9,987021,2020-09-27 17:40:17 UTC,17901120382,17901110382,false,10000,0
ba43edcd5458c3a780d1faf86982213739077f6505679229052d5574a044dff1,987019,2020-09-27 17:38:11 UTC,320750879,320748795,false,2084,987008
3148e82820d50afef244dba2dc86ca46d755fbba97c5ef65391bdd834d993bb6,987019,2020-09-27 17:38:11 UTC,11971022437,11971012837,false,9600,0
a1d5b6650988d7dec1a5cea2a7ca3a530f085df7d794c4a763476b28cf6a5514,987019,2020-09-27 17:38:11 UTC,10000,,false,10000,0
f88adca61a68b93c698eceef3e30385726d6a343504325ced1837388daa0a467,987019,2020-09-27 17:38:11 UTC,10000,,false,10000,0
bff4b26a0d71138e302f64765a49e42ddcbded16ff15c2064b6ed4b0b8097655,987019,2020-09-27 17:38:11 UTC,84793870268,84793854688,false,15580,0
b2b40ac554e331bdafef5b4ca42f37206cb8a973b3fc69ed7b45d1ce568972ec,987019,2020-09-27 17:38:11 UTC,18176367938,18176357938,false,10000,0
1e22e59c364665eb3d3723a61ee1cfab60c23417a4dc05d060b42172952b9856,987018,2020-09-27 17:35:32 UTC,35361914,35358647,false,3267,0
f5f79383e626c6ccb70ef660555ca4081904f643706c110bc7330b4e8f72a17c,987017,2020-09-27 17:34:34 UTC,499980000,499970000,false,10000,0
fce6e324bc13bee37a05bdc762165f7354ada25c95662e52719e008748b90e30,987017,2020-09-27 17:34:34 UTC,1043560,1041130,false,2430,0
9ad5c740a5ccd08debf4cad4364d31901e261afd1b485a4edf530f272f390a77,987017,2020-09-27 17:34:34 UTC,18176377938,18176367938,false,10000,0
3a0f674969d1455ba5f288bb60f7ce3b6856f652863b9a2102c1c661efec24f0,987017,2020-09-27 17:34:34 UTC,106937459,106928917,false,8542,0
a912efb3224450038fdd9e35440838511c3e8b827aa2079c91605c4dc289b68e,987017,2020-09-27 17:34:34 UTC,10000,,false,10000,0
a089a4c6fad5b0ff82edc74d01e98152947fed0615ba791e50bfc7b2b048e0a1,987016,2020-09-27 17:32:51 UTC,18680263294,18680253294,false,10000,0
34c79aa8ee895fc5abe9543e9351a0eb84ff39c492028dae8351d29fe0ffb29c,987015,2020-09-27 17:31:58 UTC,499990000,499980000,false,10000,0
1f3315438d8f2d5a8809317b60120bfe080d401584645de9c969ee95d68d54ac,987014,2020-09-27 17:31:31 UTC,18680273294,18680263294,false,10000,0
1510599a0fdbf0ce68352f1d13c1ea3ab4e6af75174bcd34a061e5a4bf3a1149,987014,2020-09-27 17:31:31 UTC,10000,,false,10000,0
19c83860903518d5da8f8ebdfe987a57df59c4a0dbb70693a9bdb57997ad0a99,987014,2020-09-27 17:31:31 UTC,176348323,176285275,false,63048,987003
e25b8a1a7c5cfaedae660f203125ac7b3c4114154a1ecb7c3e7781b2739c2a23,987014,2020-09-27 17:31:31 UTC,300910567,300891386,false,19181,0
cfcbcb0a8665f085367969b0de4c70e30c02b0cf952e17fdca59dbe939ca2983,987014,2020-09-27 17:31:31 UTC,208491505,208489585,false,1920,0
2747705663dffa43acafafe3e27f63496ee146933f5baf2150acc6458d7b28a0,987014,2020-09-27 17:31:31 UTC,7175701,7165701,false,10000,0
09cec651d89871830ee28fefc75b0b9165419e2dba73f894660a8a96c25c650e,987014,2020-09-27 17:31:31 UTC,134555424,134527227,false,28197,987003
37de4c3bb5746784f82983b0921f599fd81a84cc19efd6f571f94856407e02b7,987013,2020-09-27 17:29:53 UTC,18841486912,18841476912,false,10000,0
dd1a38f7cad2d468eddbe346cfed5e647b827513fecd7716b9397b67a1c2a711,987012,2020-09-27 17:29:23 UTC,238745821,238742554,false,3267,0
32a29e9d71c3e21bc27da954c0001c818602d23bb8416e3c57cda9e6fda053a7,987012,2020-09-27 17:29:23 UTC,500000000,499990000,false,10000,0
2dc701c9c73000473b9f88784abc6ebb24c5987147b699bf0a059eed0638f47f,987012,2020-09-27 17:29:23 UTC,994990002,994980002,false,10000,0
62a4e082921137b226e99b2e937312a40690b4d5412ca77eacf080624c4c18b7,987011,2020-09-27 17:28:56 UTC,10000,,false,10000,0
515285d85a2257ef14bec979ad50cdab5ba14a1acc4d16ac55ea77e35491085b,987011,2020-09-27 17:28:56 UTC,51916631,51914181,false,2450,0
2f926776212f7321d35327232428f7b5c71c551d854a55fd7463f05a06c56a00,987011,2020-09-27 17:28:56 UTC,101018571,100990007,false,28564,986999
1db6490d134b605cd48809114ed147071a9575bf3fe58629f47a5d035a0cd938,987011,2020-09-27 17:28:56 UTC,825389222,825386962,false,2260,0
3198f1bad15833420e7b9ddd86eadb02d85cbcea058198d6391db36847bb8eca,987011,2020-09-27 17:28:56 UTC,455992016,455989756,false,2260,0
5277a9040047c05e43311d0a4bf694395fc11055f4418b2983716fb778279287,987011,2020-09-27 17:28:56 UTC,10000,,false,10000,0
74877d4fdbb97f4569a5d5ad550c2d0c5111c9a0876b5034a0db7775aae29e45,987011,2020-09-27 17:28:56 UTC,18841496912,18841486912,false,10000,0
efb60ec96df3eb1234a727db91f5719a7019ef7a6cbc90d629a36b7189b40786,987011,2020-09-27 17:28:56 UTC,21728450,21726000,false,2450,0
e83f6529be5a9010383fcd128c632b24e571a5075316d377a854f650a6c9490d,987010,2020-09-27 17:26:18 UTC,1142487695,1142419359,false,68336,0
8dddb3cd8814b2125efc111dd5d9f1ae8f3064c70454fcda1e9f9f0c3d95aefa,987010,2020-09-27 17:26:18 UTC,10000,,false,10000,0
51d714a4f04cdae6988a7c750169bb4cd17b763c78bfaaaa9a9fe825eef76300,987008,2020-09-27 17:25:23 UTC,907799284,907797024,false,2260,0
34ba7aec5e0a30ec9433d5cee95c7f0b105ab5f2b27995f75131f204f173253d,987008,2020-09-27 17:25:23 UTC,499980000,499970000,false,10000,0
7c8b60b78380b10a3d68d2b8b27981647374dc3bff22bd73c105468d03c003f0,987008,2020-09-27 17:25:23 UTC,35511304,35508344,false,2960,0
8e6fcff1255ced7495197e01de5a8db51202c0ddc15fa62df6d0a3b230fedb7b,987008,2020-09-27 17:25:23 UTC,1014228421,1014226161,false,2260,0
fdb47dc2f4de9eece786271f92d758e154062915bcbc2668e2f5fcd7e10b40f5,987007,2020-09-27 17:22:36 UTC,10000,,false,10000,0
8238498bf11bf854c559cad47270729975a597d5a8a6c483ec9344acffa9d9cc,987007,2020-09-27 17:22:36 UTC,1231562617,1231560357,false,2260,0
8b6e8a4bb6b2cfd0648ea03e1ebc683b567797e529720bfba94ea15e98ad1a20,987007,2020-09-27 17:22:36 UTC,257779172139,257779170047,false,2092,986996
d1109a1858f410b3be34d922f8e306fa36ae27adb564611b3a24fe8e455453f1,987007,2020-09-27 17:22:36 UTC,1112697827,1112695567,false,2260,0
263c2d21ebd8c8bd7b59f0a7eaff8854327142ff28c6e03ddc581c09b1b26767,987007,2020-09-27 17:22:36 UTC,40264,34264,false,6000,0
b4cde76b14dccf48ad0a5a3ab4160a65bc2372329b97695592529a2007a1e298,987007,2020-09-27 17:22:36 UTC,10000,,false,10000,0
ebe929920bc185a741b2d242f16a3108480a019a853f111d81eac614291eb45b,987007,2020-09-27 17:22:36 UTC,999992960,999982960,false,10000,0
6757b89d2ef0da3b6110b74ddf4e98a5f6add20c6be43d979175bdafa1da1648,987007,2020-09-27 17:22:36 UTC,1137476940,1137474680,false,2260,0
14629c59b9394fa2a36e4df1155b10142b393cdf7c9fdc767eb1629c455b8af9,987007,2020-09-27 17:22:36 UTC,239052741,239049781,false,2960,0
690fc7515130589dd3c841db0ab825b8b6bb1f59d8b98388eabdcb651c2b5b74,987006,2020-09-27 17:20:50 UTC,1241554877,1241552617,false,2260,0
09857dea2dc032a3e9e7adde697edfef33d1f9ac986f8d47f758668f92bc0a0d,987004,2020-09-27 17:20:15 UTC,1000002960,999992960,false,10000,0
42d8416175d836a2aee7c47ff8530e8c311602a827f69950c62c0e614af7344f,987004,2020-09-27 17:20:15 UTC,177589507,177532011,false,57496,986993
b9cf83eb700724c94bef5ef81e5d01dc8dfa5304135bee1ff631de6deb5fd6fa,987004,2020-09-27 17:20:15 UTC,413102967,412934967,false,168000,0
3e32162b098981bbb5eb41c7da200909731825b8dfd7a0905fbe8286d995c4a0,987004,2020-09-27 17:20:15 UTC,499990000,499980000,false,10000,0
8fcc00a2e919f8f1dd44900f6ac3589f22854ddf60778ba6154c7f69e49624b1,987004,2020-09-27 17:20:15 UTC,136112587,136084664,false,27923,986993
bc2223bcb40a61f4f128e02a3d49d7d64c9191941eaf6be6f371d3c9aa7851c7,987004,2020-09-27 17:20:15 UTC,239206135,239203175,false,2960,0
5dadf3a60b16cbc20e8c41219231e7d9a4583fc0b80b87079ca5a62fc68dd2e1,987004,2020-09-27 17:20:15 UTC,343458363,343456271,false,2092,986993
e3e6685cf706f5c3b427e4012603dc0cb667aa08ef02c31a7522fc5d146564dc,987004,2020-09-27 17:20:15 UTC,10000,,false,10000,0
13ef87b23d57369af0d0a5ce34aa92bb6632328cd96f720a9a3c797c11c15e35,987004,2020-09-27 17:20:15 UTC,10000,,false,10000,0
9c38128245d8623dafc049232d2e28a8ed5d18dd661c2fa1c28f2aee5ee93d2c,987004,2020-09-27 17:20:15 UTC,35815236,35811969,false,3267,0
a4c7b9ac4df1a3034ee92a1a3016571d8c3bc0a4759aa1f7bff460054c1b2150,987003,2020-09-27 17:16:52 UTC,5867547412,5866990004,false,557408,986991
3d422d5d5721e7af0f44d2838377d81a19092fe3809d1b072b3a5ef961e95a3f,987003,2020-09-27 17:16:52 UTC,10000,,false,10000,0
ec427c63139158dd260915ea25d29830bf915347bcf5eccd4e712bcbb8987d63,987002,2020-09-27 17:16:17 UTC,500000000,499990000,false,10000,0
2cd03e54b03d156db39bdb93078591d2f4ed00c9cd65b31ed4f9745a04b1b5d6,987002,2020-09-27 17:16:17 UTC,239535556,239532596,false,2960,0
96ee10318891d631210d63d96a15db3b199b7d7aa169ef2b4076890a4359bafd,987002,2020-09-27 17:16:17 UTC,500000000,499990000,false,10000,0
1893f620f857f87abcb8c4ca0039b465479e6e867bc4a1ee32ac945202abd1a2,987002,2020-09-27 17:16:17 UTC,107066076,107057534,false,8542,0
c46c64050d16ab7a556aa83f6171265b5bd2ef9ea20a0c74e14327616b5a0ded,987000,2020-09-27 17:14:51 UTC,10000,,false,10000,0
655dffa0bc86d9dc29d6e97397b2fecdfaac4286e6b48f66d4cc1b2b6292404f,986999,2020-09-27 17:14:19 UTC,1000000000,999990000,false,10000,0
70dca174a85ea71a36c48443412698257e5c3632f75384a9e55dd8553851408f,986999,2020-09-27 17:14:19 UTC,31892849900,31892839900,false,10000,0
09317c1a43562603f847bdf88238f8fffea0e0422754d1e322fc464289451b2f,986998,2020-09-27 17:13:34 UTC,35997348,35994388,false,2960,0
564c0f83a2825e414eac2b0d26c0f4b2999e9f991e6eb82327d65c7b9100491f,986998,2020-09-27 17:13:34 UTC,500010000,500000000,false,10000,0
2a011450c6acc7c75aa1baab86af9e65d8d83bfbfe27cf5a827ad3b653d63207,986998,2020-09-27 17:13:34 UTC,107366635,107358093,false,8542,0
7c761eaf6d8ef3ab68e7561626357a5483f2446d8b32a8c292190957739690b1,986996,2020-09-27 17:12:43 UTC,10000,,false,10000,0
77bb676c3b28aea97cc5de3da20e4bcab4eaa688040bdf9a849920b6ae4dd0d7,986996,2020-09-27 17:12:43 UTC,107430311,107421769,false,8542,0
b1df183af7f38af41e65bf30bf11fac0626bc8c4a853ba8bc6265fbcce1ecb61,986995,2020-09-27 17:11:24 UTC,17301564458,17301554458,false,10000,0
2148224c3afb8ad164ca3739c21c46840711ee6c44f30ab9e0de753472e7d81e,986995,2020-09-27 17:11:24 UTC,14807208,14800093,false,7115,986982
7ce798067005c07699b40d2c5d34c1daa486c5c308a87920fdecb0cebb06b16b,986995,2020-09-27 17:11:24 UTC,240058222,240054649,false,3573,0
f133112a34a2eaa346d12e30f1afc69aaaad0b4a3568957f0c685a844bdd2a11,986995,2020-09-27 17:11:24 UTC,5866010000,5866000000,false,10000,0
2f87aa8bf6c94f7e952c19c0d0b049ec32b198974abd96d48e9d7af0a5d34b74,986994,2020-09-27 17:10:21 UTC,10000,,false,10000,0
e842063155b6482395020924ebae328e72680de39ebf357a27c5522002802443,986994,2020-09-27 17:10:21 UTC,178901614,178848765,false,52849,986982
3a149ab6b78395bae5fee1f28bb43e68ec01a165d5cffa46ae93b3b9f0f9787c,986994,2020-09-27 17:10:21 UTC,137602294,137574097,false,28197,986982
e679cb22f3926bac2ba53752d44cd48107b69bbec7d1411af7365338e8563348,986993,2020-09-27 17:10:03 UTC,2500880397,2500869257,false,11140,0
c559be0e128290c2430daf1226daa0be7d586889f361d0ebc500dc504d92af64,986992,2020-09-27 17:09:23 UTC,1939243946,1939175610,false,68336,0
a6f26f70e93bc49ba84106078f4dad908b00f4d65efd81eee4246936ee09b90c,986992,2020-09-27 17:09:23 UTC,26928,19088,false,7840,0
a6c7e45c75da04ca1a1c6ed704fe77b3a2d6f07da18f2041d31ecc21334b5fe0,986992,2020-09-27 17:09:23 UTC,17841001254,17840991254,false,10000,0
29a76ba636c4553865acef75a6988fd0240f0d36f0d867c2446514e91ab38174,986991,2020-09-27 17:08:16 UTC,10000,,false,10000,0
02177bb0cb61f533ed501e289611d87f603c7e1a3edf265b6e928264d128d900,986989,2020-09-27 17:07:10 UTC,4500080700,4500070700,false,10000,0
12cf84b2510f1b4c91b3c00997f2a4fc33ef8f460ba81773977cb77fa60323e2,986989,2020-09-27 17:07:10 UTC,632666411,632654326,false,12085,0
5f767bfe126efc3c0e76308f3f00ae31042422b9431093410d1d1a093a1e066d,986989,2020-09-27 17:07:10 UTC,500010000,500000000,false,10000,0
bd659cba986d4fd4e996991012cca7a647d7a40afbd3d813eed01a596aa5f727,986989,2020-09-27 17:07:10 UTC,1010000,1000000,false,10000,0
1f55770d9cd67371fff0719263d6a015dd3829d8498f0172aaf411c5130dcb40,986989,2020-09-27 17:07:10 UTC,5040812,5038382,false,2430,0
92e028152979067e3d8754124a8b0aa4e1db7d1440892668749cf73442643836,986989,2020-09-27 17:07:10 UTC,380257583,380255200,false,2383,986978
0129c1d2366d206679acce3a33c25740e4a0bf212e70c8be262f903b285221c0,986989,2020-09-27 17:07:10 UTC,2001033491,2001023491,false,10000,0
40b5a9abacf376dae0ab41d2a4b609df19c2db46ce9ed115eb246d77a241a269,986989,2020-09-27 17:07:10 UTC,10000,,false,10000,0
a9351df954be0567631a37eacbce915a6b68ec04f1bc2ca4404d751b11a1baca,986989,2020-09-27 17:07:10 UTC,36434675,36431102,false,3573,0
ddbc431232418668d235559d07a2fec169c415c0f69098d2d092e239837b8f71,986988,2020-09-27 17:04:34 UTC,28965277,28964277,false,1000,0
fb8fc45455dbe65b59ec3ab5d2cc5f1a9915488cef07f9a6c04be8e9428377d8,986988,2020-09-27 17:04:34 UTC,240067905050,240067895050,false,10000,0
8face33746f2d7988aa48fa61019c6c007007c10cd972dd6ae342c18966286d1,986988,2020-09-27 17:04:34 UTC,1500012184,1500002184,false,10000,0
418174a5f0f2f1defb3059b54900a59e77be11064ab0de2a60082a79ab83346e,986986,2020-09-27 17:04:02 UTC,415502,409946,false,5556,0
ec76ff9f43b42ac6973e0e0b990a02072a8097c4521989767c7ba4a57f204fdc,986986,2020-09-27 17:04:02 UTC,10000,,false,10000,0
73380cf93e0f94501838f0cb8ef568a380e22af1efdd4ede2af7e5323cb0efcd,986985,2020-09-27 17:03:31 UTC,10000,,false,10000,0
75300cfbedc718a917f2bf20731919ea02dc16aba6387e39275c54d2c7f111c9,986985,2020-09-27 17:03:31 UTC,1456024120,1456007536,false,16584,0
a3340ebb71d887ba06919e4599a75abb0457308ceb2dbfbbea93f2cb2f1b950f,986985,2020-09-27 17:03:31 UTC,28764915,28763915,false,1000,0
53166b27fe4fe739ccc642ac422333f8b261492ef507863dd95e8a55d79c4bd4,986985,2020-09-27 17:03:31 UTC,235199616,235197696,false,1920,0
58b04fc506d8a6a75a747a6cadf709bbf2878cd0ee762faeab1b86141b009f6c,986985,2020-09-27 17:03:31 UTC,139283265,139252420,false,30845,986974
9ac7de9c57050dd4654c97da58a529a039a34ea2627204a50e6e1e3a9ef3697b,986985,2020-09-27 17:03:31 UTC,235197696,235195160,false,2536,0
f90bc3ea3bb3660b5d82f7acf765a00bdaca9a8e762ee7a015257c989ea5ef65,986985,2020-09-27 17:03:31 UTC,180522716,180456456,false,66260,986974
53d03c7cdf121c9cddb6ed22591f007cc65944639f057f12bcade355c04e5882,986985,2020-09-27 17:03:31 UTC,500000000,499990000,false,10000,0
69556f16c6bb13716b0328ed2010e074cf268faf08b0732410d1855654300506,986985,2020-09-27 17:03:31 UTC,7491379773,7491376818,false,2955,986974
461c65b94231f8c748d74bbf44348b111af3e52dd478adccfd75f3c2ce92db8d,986985,2020-09-27 17:03:31 UTC,100000000,99997550,false,2450,0
33f7330370786f66df192bcdbe4ec78548d39f8b7976ece89a65100b2718d7b8,986985,2020-09-27 17:03:31 UTC,100000000,99997550,false,2450,0
638f80424a7dcb101515733cbb78700645557c0f9aca310daf3d513aa098bf5d,986985,2020-09-27 17:03:31 UTC,634847494,634844530,false,2964,986974
41ef8b2280473e652ff391ab3a9e9b6ecab905ffd757dcf5e127aa75c494aab7,986985,2020-09-27 17:03:31 UTC,107469539,107460997,false,8542,0
502801cd9ad7fe31ea52495fdb461fdcb4edd063bfb5f1346b5af4091eb29bf7,986985,2020-09-27 17:03:31 UTC,10000,,false,10000,0
60bdb32dd4ef7f084da94bbe31de3213c9a546ed39d5a1437933ceae7d9e7842,986985,2020-09-27 17:03:31 UTC,107689913,107681371,false,8542,0
0a7b1e77be382d875abd904ea6ed03003f180aca5ebbc8468186fd7632a152ef,986985,2020-09-27 17:03:31 UTC,110033008,110016008,false,17000,0
f39fa4036b5e740a462c6277705e96209e80c1e731265cdf444248a90f89770f,986985,2020-09-27 17:03:31 UTC,451144189,451000001,false,144188,986974
03201de8b5967624d5f9b8a82b8ef060e4956286f1b40b1c8bb811aa80140d51,986985,2020-09-27 17:03:31 UTC,240265023,240261756,false,3267,0
9027c7631aff15c0955441c364a40c9ebec266c55605bc8b5db02e8b14c706f4,986985,2020-09-27 17:03:31 UTC,101694486,101664427,false,30059,0
51d2d379b3fe8ff193b28488fb7121be53015cdf7dc499e1795fec219531b6b0,986983,2020-09-27 16:58:15 UTC,466847438,466840000,false,7438,0
48b20562ccaf9b534eef6d081b23beaab99fb385ff2f5a3f7d2a7d732ca4c2fa,986982,2020-09-27 16:58:10 UTC,10000,,false,10000,0
2862d6cad9483f481c7a873681a96e0ef5cc40fd00ec3ae561a270a8086c044a,986981,2020-09-27 16:57:45 UTC,258517018027,258517015935,false,2092,986969
aa69cdbc690adfda19f3d89287ea44e6105ad4acf6684061bd89fc321d876775,986981,2020-09-27 16:57:45 UTC,107848943,107840401,false,8542,0
ca160bd718e1d5b7c43189db5037aa191f9b9761ca643fe41166b4d7f10c5881,986981,2020-09-27 16:57:45 UTC,899997550,899995100,false,2450,0
35552841cf0d2271d6bdb7dc3b0d172e03456c7754974c972df17a0ec0175d6a,986981,2020-09-27 16:57:45 UTC,971832558,971830298,false,2260,0
0f290396b6fb96c90f2d12133b93d5597cbc4f799366796ef875e85c8469da50,986981,2020-09-27 16:57:45 UTC,500010000,500000000,false,10000,0
8a54c1908e7a8dfad9b9db0fdc6f833a56775fcf556ef2fc0e585bf1f386546f,986979,2020-09-27 16:56:25 UTC,10000,,false,10000,0
1ebe47369b47ecd6ebb2f47c06f3ac4a0624a59bd11418ac91420263330f85f0,986979,2020-09-27 16:56:25 UTC,112051079,112048629,false,2450,0
57d745b5d208fe7ce843a171c6cb4fab9d334c3be93016d7b64a20e937c62054,986978,2020-09-27 16:55:22 UTC,1188185124,1188183010,false,2114,0
75c9a06af1999b36ff441db1779cf12e823c0e9df14dd8f58a9e9ee53a762451,986978,2020-09-27 16:55:22 UTC,10000,,false,10000,0
0fce51a9c311ce4734d27eb477fffd7c9168d155e44c442b1b40dd76c0cc47b6,986978,2020-09-27 16:55:22 UTC,500806616,500796616,false,10000,0
f44b1fb408d42cef8e04a9254a6a41e90a5a9932e0698c7412c98c05dff8e877,986978,2020-09-27 16:55:22 UTC,36605616,36602656,false,2960,0
ca0abd7b9b4d2b56d35508657b4d8ddb1e0b44200afc46df31910caa36e2dc59,986978,2020-09-27 16:55:22 UTC,499535000,499533080,false,1920,0
1e1a407d2069c05f12f9dad1c76abab1b90fd5ad8e091802b7de9ed74d117c2c,986977,2020-09-27 16:52:51 UTC,107885049,107876507,false,8542,0
dd99fa552068f56f5cfec1242892504a08da90c08df8ca1cb2ee0cca90cdf220,986977,2020-09-27 16:52:51 UTC,297516520119,297516518027,false,2092,986966
277e6f6e6eb777c5aff0319fda3550b00852b1e0e03a7e91d4238580f769b043,986975,2020-09-27 16:51:51 UTC,993715000,993646664,false,68336,0
5554fceefae2d98bfebe945f8dbe0010b000784f4d0a7c4f48b086e44ec001b6,986975,2020-09-27 16:51:51 UTC,387762648,387760556,false,2092,986963
4b9cf4dd2c76e1fc92429e4dc52deebf751d8f1734bcbcb86e6ac9139f4ed52d,986975,2020-09-27 16:51:51 UTC,193155,169035,false,24120,0
edf18fce99f7cb46ddb8aa1ac2cafb9d75fb3be8d8677fbae5a3e8fe2618af33,986974,2020-09-27 16:51:31 UTC,140655524,140624714,false,30810,986962
57d1aa7735671c29cfcff7d50a2c3d8979afb19c67a03ccd269e67a441cca91c,986974,2020-09-27 16:51:31 UTC,1020919341,1020915601,false,3740,0
15b7cfaf7b96694e6840f942922687f52388aa37d360c0eff1c9f29f28185795,986973,2020-09-27 16:50:14 UTC,181997102,181935848,false,61254,986891
a9f325aadcb37270cf2aa460b12b121a41bfcd0ec206465271b1a0d820b26383,986973,2020-09-27 16:50:14 UTC,10000,,false,10000,0
58cd2f4250abce688c7dbe50a6f64040dce0d19849ef331608f48493029c5b6c,986973,2020-09-27 16:50:14 UTC,2256377543,2256277543,false,100000,0
5f81cf1e9c08b3404894fc69bcec2aa022637bba6607258ba6256154f49d98c1,986970,2020-09-27 16:48:31 UTC,10000,,false,10000,0
a9c87f0943acb0b92b7c1317f3c8d7d7166837a839ccb47da9c8975638178ae7,986970,2020-09-27 16:48:31 UTC,2108070920,2107970920,false,100000,0
71f30ef8c614088195648ea1d19ac3c13a26addb56d249d3f0a11008fcec141b,986969,2020-09-27 16:47:23 UTC,99850000,99840000,false,10000,0
b0805022b3f8f53a71ccd9f83ef7cb46243f881c50e95229ae80e390ebc1cb9c,986969,2020-09-27 16:47:23 UTC,2500343413,2500341493,false,1920,0
0a30df63bd9e16f5bf4a26ba1eac7457c871e30c1acb2cc8fcc1999a71595b69,986969,2020-09-27 16:47:23 UTC,10000,,false,10000,0
572876fe20987cbc253921f9f593abd780dee6df0c33e8ce73699818f2d0aceb,986969,2020-09-27 16:47:23 UTC,53655608,53648908,false,6700,0
06051f3f9660c358c0b4fb8b483b8e376aea4d5266bb94be44ce699e099f8c56,986968,2020-09-27 16:44:27 UTC,301267696255,301267694171,false,2084,986957
1a5f68bab7c3ebdca6b449b6eeb324fb95ec50c0fa9bf896cf054b82ffc5ddae,986968,2020-09-27 16:44:27 UTC,99860000,99850000,false,10000,0
e7e300e090383abce191c915cc41abafc5c3a3409dc02308f21a587fc84a7acb,986968,2020-09-27 16:44:27 UTC,500035761,500025761,false,10000,0
fdc11f434660642232f7e7027887e2f08e5a43987f448042d4ea78231d3aebe3,986968,2020-09-27 16:44:27 UTC,360460,354000,false,6460,0
eae7ee28f7f6291407a896699e61c88f3d7bebac89be5acc985a648125ccaba2,986968,2020-09-27 16:44:27 UTC,2500345333,2500343413,false,1920,0
7514a5a3db45801c6fda0cee56b1be12311e7d184cdeff88a1cb608cc7548210,986968,2020-09-27 16:44:27 UTC,240422758,240419798,false,2960,0
6c284baf1ab5cab4e5513e819b5f2225fa16617fdb4e53ba39f9bea16cd3b2af,986967,2020-09-27 16:41:50 UTC,302266198347,302266196255,false,2092,986881
7796dc7f29dc4aa3f0eca3c34bd35399065b5fdc6fb83b113bb461feca695af2,986967,2020-09-27 16:41:50 UTC,10000,,false,10000,0
047f5240c44e87317a8ea95b2541bba14b050930f02d62cdf90d8a1c297329e6,986967,2020-09-27 16:41:50 UTC,183537753,183466881,false,70872,986956
f04147f810fd96730d93fdd3c1d5d53f52938227b6f3ffef5838fef9e9029616,986967,2020-09-27 16:41:50 UTC,128995,126545,false,2450,0
d1e1e6e793d69981bf341ad7b1d6525f11fec9910b5337e5554a8c371e7b940a,986967,2020-09-27 16:41:50 UTC,142518670,142484357,false,34313,986956
315097d0051911a6121c9d3dc0cba114f3b2455da316649262401ac8431bc463,986967,2020-09-27 16:41:50 UTC,10000,,false,10000,0
3c34bbe7a3ca0b57642128ec1fa4083722ab4284633fe887b87556ea0e5c7876,986966,2020-09-27 16:39:23 UTC,17035276,17015926,false,19350,0
15ba1bfa43a233dacbeaa8f44dda63f19380addce70ed248783e20eeb60a1468,986966,2020-09-27 16:39:23 UTC,300650653,300586853,false,63800,986954
598d71190febfdb2d6a2987306a050a8458f9369828234b999c95b64c5ce3f06,986966,2020-09-27 16:39:23 UTC,10000,,false,10000,0
4ff2191e6032a817436378ad392d62656fb5aa9bfd26e69165d4d320fff124af,986965,2020-09-27 16:38:14 UTC,107977124,107968582,false,8542,0
896007ae57a8eb769c34644bb2b1a7b5f5f058266ae6803819c66325d86cc075,986965,2020-09-27 16:38:14 UTC,1139702694,1139700244,false,2450,0
20ebcccff694c994f4dee43db96a793f2333ceec9c315d3f9aadbc3af8beddd2,986965,2020-09-27 16:38:14 UTC,99913796246,99913793896,false,2350,0
4700d85193575fa31b998c9fc65fb38917e69e2248935829e52f514b9a7a5e51,986965,2020-09-27 16:38:14 UTC,17341021254,17341011254,false,10000,0
307d0edc5522e24962f1d3ac5afd7e54326d29d2bf358f84b221b2979e403292,986965,2020-09-27 16:38:14 UTC,37500000,37490000,false,10000,0
beabda209dcab889b86b3910d1b4b3a91f00ddf2039a4cb79cc61d70000108df,986965,2020-09-27 16:38:14 UTC,107917011,107908469,false,8542,0
4714fdf9395ce2ed50f3eeebe2f294efce7212a3accdca7a3b0332bfcb076001,986964,2020-09-27 16:36:46 UTC,10000,,false,10000,0
69eefdcf2b53e5dbe1c3ee497ce36dfb107ea7e1b3d85ea3fe8b254a0745dc86,986964,2020-09-27 16:36:46 UTC,10149420,10143825,false,5595,986952
21144912a03fbc3b997fce42ebfd09dc03b88059702f3e19f08e1c4d2227c9a1,986964,2020-09-27 16:36:46 UTC,108034707,108026165,false,8542,0
1695acd7974e0731ecc71c1608e08c5b96c6b96b422593b5845b5f5ae0bb4be3,986964,2020-09-27 16:36:46 UTC,2206173431,2206166346,false,7085,0
7559e80bac456d921de3356ecd184b656aafaa43a9694ec9ba809353aeafbff3,986963,2020-09-27 16:35:47 UTC,910501580,910433244,false,68336,0
64ed7fb8b38ee2816bc91f1d9b4bcc8f019e16f9cde42a8a23120513101fe56f,986963,2020-09-27 16:35:47 UTC,10000,,false,10000,0
45334074a890c7a122ee17d6dc6f45b6e52206876b65e32f8e96dc2137825755,986963,2020-09-27 16:35:47 UTC,1000022084,1000012084,false,10000,0
12edd6af8b95e72eafd00d8546047fc1894417e42be871f07fee496cf8c5c91d,986963,2020-09-27 16:35:47 UTC,17612814933,17612804933,false,10000,0
e796e63ccdcd343b7b787018b3bb66cd28d16093382150d9e0e0edc03066af80,986963,2020-09-27 16:35:47 UTC,36847560,36844600,false,2960,0
a60250ea9a34707e584e4d95be1a29d8f9e3e7be76544ab136f63bc11bad5069,986963,2020-09-27 16:35:47 UTC,524004,516948,false,7056,0
0f0e397324c14c552f4d22d3bb9e9421a31018fb66fbbd1d65cda7f8aa6bbd4f,986963,2020-09-27 16:35:47 UTC,456334858,456271315,false,63543,986949
37da23767cdf5752d161c15c4c595a8a201ff6b0d93615835071af709050fbdd,986963,2020-09-27 16:35:47 UTC,410145452,410143368,false,2084,986952
d80fcef562de2f12e7ed36dc5b80c0ae650c6c8ae6a76b7a60f2c8457001106c,986962,2020-09-27 16:33:14 UTC,10000,,false,10000,0
a5fa28499f806c948b000166f3420c36385a72ad6a94f0a37a224178e1962686,986962,2020-09-27 16:33:14 UTC,23486535,23478130,false,8405,986949
a6102aa1d668d671066874228d40165425ac77b62dd029f8b1cdb1c097c6263f,986962,2020-09-27 16:33:14 UTC,201099992,201097542,false,2450,0
44443c6be5ef55411e748724a5e0de6003b065db14e7033734cdfec2b53a55fd,986962,2020-09-27 16:33:14 UTC,5000010000,5000000000,false,10000,0
b53a74984b8c5a3adb81c87daf5a1f52a8d3e22a089829d55efb0656e42ecba4,986960,2020-09-27 16:32:36 UTC,143461307,143433409,false,27898,986932
2d7d72ed1d5be6bfafe77824c48af2dc290a2659d209690cea727590f02eccc0,986960,2020-09-27 16:32:36 UTC,17612824933,17612814933,false,10000,0
6df801d7877fce233e8e3d9c9f83277aaa77fe73a05ab1b84369c58d3a951e9c,986960,2020-09-27 16:32:36 UTC,108064004,108055462,false,8542,0
61c46b30d53bbcca6d03d01656564eacb9c6cf5ec60e3b637281d50d74a23192,986960,2020-09-27 16:32:36 UTC,10000,,false,10000,0
e319747cc658898d7782dba8074be7c5c35a298e457a2de33ecafdd7c7c55f67,986960,2020-09-27 16:32:36 UTC,240577235,240574275,false,2960,0
fc529a89fc82b6a4f3e72053922c4faf01088b6c5068bcfb6e2997beb66f817d,986960,2020-09-27 16:32:36 UTC,500029500,500017415,false,12085,0
133200faad1f40578a35653116932b4181b15d2f223d90af51354bbfd81637f2,986960,2020-09-27 16:32:36 UTC,5042634857,5042631117,false,3740,0
6f18e650f4e15992cbb007045b3f698d16cbbe8ff0710d3c31df338d7bcd5a32,986960,2020-09-27 16:32:36 UTC,38290,28290,false,10000,0
ef3de18ffd3684d77404be67c4aa9c1493001349f25143803267cae2bb9b4bd8,986960,2020-09-27 16:32:36 UTC,21685886100,21685876100,false,10000,0
fb98257dc73b4e5caf25b705a4dc33d8752ac4a67ce249417faff778263ebe36,986960,2020-09-27 16:32:36 UTC,185000582,184931999,false,68583,986930
4d8526515a276ed49912dbe3a7e90e73fd8423c9d223cbdff203f1e1cf185072,986959,2020-09-27 16:28:10 UTC,10000,,false,10000,0
353b2f1566609ebae8b6a02cb011feed85c3ad7b71240ea2bcb18d8aae760504,986957,2020-09-27 16:27:15 UTC,37048048,37044781,false,3267,0
a0d24b6aa8d261e6a57beb27b6637c14ddb0aca957525d69eb3b5419d6670adc,986956,2020-09-27 16:26:38 UTC,499980000,499970000,false,10000,0
ab20b6235764e18d59c88ad80d52e793c69e578b85f2ff0693c3a224d8c91030,986956,2020-09-27 16:26:38 UTC,100540937,100539017,false,1920,0
5f23f5031aa74bb550ed16995dda633d08f665973b874904f62e02f013295be2,986956,2020-09-27 16:26:38 UTC,1686121266,1686119182,false,2084,986945
10c06ff1a223b6274a6418f8fe16a3a072b6d207f2baf8183959e7b045c1f954,986956,2020-09-27 16:26:38 UTC,302360677241,302360675149,false,2092,986945
2b768d942597728ad9612600c1fa8ed3578c6d2dbc6b6099787de40f410ad3a7,986956,2020-09-27 16:26:38 UTC,10000,,false,10000,0
72a0ac5b1a96206e3f4be3a0e418b7029513e0a1bb60a2937dfe59563af3637d,986953,2020-09-27 16:24:34 UTC,10000,,false,10000,0
b360b141ff367d1e1dcd9c12a64624085d53f182e1316aa7b65be96bd24baa55,986951,2020-09-27 16:23:56 UTC,302391083325,302391081241,false,2084,986940
ccc9d64ea3ed6c14db20a22698aad95329c60897d988b37f07061fd764d8164f,986950,2020-09-27 16:23:09 UTC,10000,,false,10000,0
bb09fb3ffc41a14f67ab44a035bcc1fadf15a4c09e1d94e47a9292d5e36aeac3,986950,2020-09-27 16:23:09 UTC,1723456595381,1723456593289,false,2092,986938
0b87a1405241fb3731661c09d52036b19cf529a36ffe5527f4e0994ff24c297d,986949,2020-09-27 16:21:27 UTC,155351168,155350716,false,452,0
5b535393920796f7182691746159c0115c3dc17e3acfb4f39d90848cecf69ce6,986949,2020-09-27 16:21:27 UTC,10000,,false,10000,0
c381d3b3b0bf830c64d81d36af594053bfaa4668724a66e6679bd06371459c38,986949,2020-09-27 16:21:27 UTC,499990000,499980000,false,10000,0
ad7ed0e51490c9cebfeddcfc53c2f6e3b72456e1e2901a206f429c324ff11cfb,986949,2020-09-27 16:21:27 UTC,2388184,2368504,false,19680,0
4fa5e3cc631857db7b8e8958143ea56607276afbf566d5c2ac01f3e682dbd96c,986949,2020-09-27 16:21:27 UTC,760228588,760202988,false,25600,0
6077e52f34eb089906365f0d53d726ea9e40d6f81ef023abfee72c077fce50bd,986949,2020-09-27 16:21:27 UTC,181652352,181649902,false,2450,0
1ff3051e62ddabdea1b2d704d9272a8d3c70911829c1277854af2b2160c29fa5,986949,2020-09-27 16:21:27 UTC,144395019,144370307,false,24712,986938
c255643d1b9dc96eb6fd4d963b64ae67b99d60e0bc05cf71875761698e58fadc,986949,2020-09-27 16:21:27 UTC,107814044,107785073,false,28971,0
ecf4f9ca65ef4362e3f7d45c7de3f297b0c8b326143cc856958c8948caccff64,986949,2020-09-27 16:21:27 UTC,186731278,186660713,false,70565,986938
4e58c77318ec2ff5aba9ac2ee16860783c30714f1afb4a5fbfb70c9e1f873e24,986949,2020-09-27 16:21:27 UTC,304821325409,304821323325,false,2084,986938
7c62a3a3e5247a610f3d7e4aa1a957489ae777b59fd304029481869444460776,986948,2020-09-27 16:19:03 UTC,21590677,21586056,false,4621,986937
47c288ccf25982f9129764793ab47118263ff243256bde0fbbc9941cedd432af,986948,2020-09-27 16:19:03 UTC,500000000,499990000,false,10000,0
c60cb030ca35e1c83fa7fdf506f32f51d1e7268cbbdd61ea66e31292c1209f52,986948,2020-09-27 16:19:03 UTC,17513624076,17513614076,false,10000,0
66a0e35db6497e8b281b30bddd2bf587e1c68a3354d304a9824d32c7c9a8aaf1,986948,2020-09-27 16:19:03 UTC,108109999,108101457,false,8542,0
1c48049abd6ef84bff6b97be30753c23c13aa577dd701a01f8c81159986f0b92,986948,2020-09-27 16:19:03 UTC,2488544995816,2488544993732,false,2084,986936
b09176124f51caed52dbe90aa6576e45c7f7c7f702c953b7749aca8b7fe76d23,986947,2020-09-27 16:17:30 UTC,304858827501,304858825409,false,2092,986936
560e76a382ce2207a459804395f30595af035845bce74a519651d5bf54b3e1d1,986947,2020-09-27 16:17:30 UTC,108148886,108140344,false,8542,0
dbb91329ff68ecb381c1da97e0b7c61d8949ff640ab820c167882e9c0429e364,986947,2020-09-27 16:17:30 UTC,2000000000000,1999999997908,false,2092,986936
1cb8009ef099cffa8b6665de38a0ef6ee1f9f6fea2c9eebdbf451ae0adf3b83c,986947,2020-09-27 16:17:30 UTC,1735550000,1735540000,false,10000,0
dfb93aed34fe12b549c1754af066056f1ba168441bdc811f742f98ee70ef135c,986947,2020-09-27 16:17:30 UTC,485241648,485225878,false,15770,0
2c8d747e8d85196b419b08debbff4de5db7b2efc17ff550db8cf92b5b53aee5c,986947,2020-09-27 16:17:30 UTC,1823717197764,1823717195381,false,2383,986936
3ba13d127577757916c692c2161e76e0788f40e1de9f529a865a24cddc45c283,986947,2020-09-27 16:17:30 UTC,10000,,false,10000,0
7cec06f2e726c007b9634498c8be26f4ca989159ef082b97c5797066056a1da6,986947,2020-09-27 16:17:30 UTC,728823964,728813964,false,10000,0
1d7550fb62fc9deafb0ed54d241de2e79dbd01e5e768d01764674feabf32455b,986947,2020-09-27 16:17:30 UTC,240759566,240756606,false,2960,0
e101c01cf0818a2874f64eddd00bd4e99659fa2ef761928ede25d6e30b20efdf,986947,2020-09-27 16:17:30 UTC,7230255,7220255,false,10000,0
1b48c9e6dfcaa1842edb113ef5160358bc6205a38625d623dcf56a4e7d3a35b6,986947,2020-09-27 16:17:30 UTC,344960797,344955577,false,5220,0
1c4278d921c1e3d501f24936b684bb0652f35aed7a09cd68d835c22a7ed65619,986947,2020-09-27 16:17:30 UTC,57189870,57183870,false,6000,0
bd191d21f54265302367fc06eb27019f2d08a0c05ac2adfde4fc7d7389ae8423,986947,2020-09-27 16:17:30 UTC,108267978,108259436,false,8542,0
e84536e04f2ecb9d241fa0b95ad29999d48ed55259e9ba3813b6e99257a4cdc6,986947,2020-09-27 16:17:30 UTC,14804175641,14804152258,false,23383,0
04ac0afb4b846490381a013fcb6a273a4e2cc3b24400c2b7cc7ac78b1d3f4ff5,986947,2020-09-27 16:17:30 UTC,378825000,378815000,false,10000,0
bad42aa5ba05164da5e5080f01dbc773cfb1411d98d62e66a1e03bc16971bf2f,986947,2020-09-27 16:17:30 UTC,10000,,false,10000,0
87d87b8bd44f7b13980596bc3e8985164a275dea599a221742703d9231e8f79d,986947,2020-09-27 16:17:30 UTC,10000,,false,10000,0
2e87fb48a99818fe2d028e028a463e13f68c562a8277f7153a4e538a41be0738,986947,2020-09-27 16:17:30 UTC,22636491,22626491,false,10000,0
37a3749badf625d3fef068cb55097bcf07c7e96f61243a276d0273172e836b59,986947,2020-09-27 16:17:30 UTC,852173336,852105000,false,68336,0
cd1cbaaf98604c3cc92744c0d2c630f07a220ae9ea30793e93161cdfa2fabc6b,986947,2020-09-27 16:17:30 UTC,17884565334,17884555334,false,10000,0
5757814ebc551a22442fbb094a2087be548d9b8881a43636fe1a63cbc5046dfd,986947,2020-09-27 16:17:30 UTC,10000,,false,10000,0
f931171daffb1c0fd3af741fa8062c537d3dc3fa75d78829f25337f372722577,986947,2020-09-27 16:17:30 UTC,499990154,499980154,false,10000,0
9e103aeb04ab2329ea8304343a7d29c1ed370e395e0f5356cf9ca3f4b9b2b8de,986947,2020-09-27 16:17:30 UTC,37551300,37548340,false,2960,0
7a7bdf90fbfb151fd7fd442d82a242fe84ef5c35c16ec5e5cb29fae8db64aea5,986947,2020-09-27 16:17:30 UTC,2118792438,2118782438,false,10000,0
39519fd376111a0f0ba29946cfc6d44d1c73baebbe684c7762cf3f467f277a39,986946,2020-09-27 16:10:36 UTC,188431503,188369634,false,61869,986933
c06732bd2612b3011593b04f453c5d299e60e213fc181c2abbaf8f502e64a0d5,986946,2020-09-27 16:10:36 UTC,145575293,145547968,false,27325,986933
d3e8924479b0e7a2d8e462f13e7ba776baacd815e949a0d0ab8e843d13bffe07,986946,2020-09-27 16:10:36 UTC,10000,,false,10000,0
8b0e891d283a886c6f50ce94dbcf9503b03a7cfc25d48467067b727943f2640e,986946,2020-09-27 16:10:36 UTC,108488407,108479865,false,8542,0
59c52a615ab167e2a29a0ce3df7ccec0db34c10f4549ebbf0ccc423dc24f8d78,986944,2020-09-27 16:09:37 UTC,10000,,false,10000,0
f13bf536b95b36f88ef861b46effb067de269430b76277248a9348848f81b522,986944,2020-09-27 16:09:37 UTC,17884575334,17884565334,false,10000,0
bba03bc19cd7b9edf8f4a1c3bc2402c0b5a7746da29e0f27073aa11368342edf,986943,2020-09-27 16:09:03 UTC,10000,,false,10000,0
8c777a15f62bd78af048fff006a7bf6cf75eb09fe2fe293086b1f48d69ed2731,986943,2020-09-27 16:09:03 UTC,10000,,false,10000,0
3699674bc920a0f33b1ef5cb057e80d8e96c611133c2ba6f37734e8961360efb,986943,2020-09-27 16:09:03 UTC,70920,36440,false,34480,0
63803932ab5f6c7290f769ff5d43189dea422238db7535dc5cd4b3e40a2add90,986943,2020-09-27 16:09:03 UTC,116972021371,116972019021,false,2350,0
90570ec7938d6a43ad55a2752552c36065eb4a44b5c3f93af970ae257bf27ce4,986943,2020-09-27 16:09:03 UTC,500020000,500010000,false,10000,0
053f5d87cf72d2a6d74965370ac70ddcb72623ce3acf82631f53128b9bbd0517,986943,2020-09-27 16:09:03 UTC,999983678,999973678,false,10000,0
411f6559e09934b40edbdb6e836084ed1403f4d0c6b3de56a10e98df9cdc2d5a,986943,2020-09-27 16:09:03 UTC,62167,59717,false,2450,0
55ac02407701360dceca96ca3ccd12f416c6847a9cb5ea583b049a24394fd953,986943,2020-09-27 16:09:03 UTC,242655194,242636654,false,18540,0
a3382c7eaa387730404d75cafef80cea9de8838f0958ebabd103a15f3f2255a1,986943,2020-09-27 16:09:03 UTC,37744217,37741257,false,2960,0
3d444a8772842371dfefacd75869247c27871148f9e3f77dfe01cbd5f887b5e6,986943,2020-09-27 16:09:03 UTC,99935741,99933291,false,2450,0
077d88d83d45b85e63e5875f81b51c5e0e1c4c506bb11e7c4f54ebc2187869bf,986942,2020-09-27 16:05:55 UTC,2122070920,2121970920,false,100000,0
16524724e30267717a249c8239bc905f30d145f03fca1c4628df1ff5763a476b,986942,2020-09-27 16:05:55 UTC,3804915788,3804913704,false,2084,986931
53876d52b82c80b41cb46c318f6127ac03cfd2154c541f020cbd444d22bc67ca,986942,2020-09-27 16:05:55 UTC,240930032,240927072,false,2960,0
93e369179d5cb80bde93a52fb901345658cd6d6f5b4f7234cfc501e5f7050400,986942,2020-09-27 16:05:55 UTC,500000000,499990000,false,10000,0
8b7e4914149b9227aacf47bfb3837ba09b5896aac2bd173e4a070d04048de52b,986941,2020-09-27 16:04:57 UTC,435126434,435124342,false,2092,986928
d1b6c563614c87c800d54810e1315ff31b308ec65510d65966dcbb8c7c0a2427,986941,2020-09-27 16:04:57 UTC,46709681,46689681,false,20000,0
c9ea706e9ee061e63853d87491eac7a6caf56367fb6a3a296f115883ce0a5f2c,986941,2020-09-27 16:04:57 UTC,2245384633,2245255649,false,128984,0
fd996b920bf280592cb13d11344a5a14d41b9dfd79512d6cb4bc1f06981a3889,986941,2020-09-27 16:04:57 UTC,99997740,99987740,false,10000,0
21c515a7463adccba54d1823261f9c7f7a610cdffaa8c568235e36a3fd53aa22,986941,2020-09-27 16:04:57 UTC,2001043491,2001033491,false,10000,0
9b848d002002a68656e18ceb70cd43c9dbd951e6e6caa11dcef369c0895b206b,986941,2020-09-27 16:04:57 UTC,500030000,500020000,false,10000,0
6f49d6334f782577f99b57e2744c6f6d1e54b428d2c8803d13361e955c99599d,986941,2020-09-27 16:04:57 UTC,10000,,false,10000,0
6041c191a1676d6662c1ebe1c31bc4853a8d82533b7fd754a71dfca463e28519,986941,2020-09-27 16:04:57 UTC,6220000,6210000,false,10000,0
8c42cf57ab8661def13f2998c02c796e6590cc1699fbbe33df728b3b53ce0498,986941,2020-09-27 16:04:57 UTC,2134170920,2134070920,false,100000,0
07bc2abcf36b22bc7ee3bd5f10e63655c08ff22e5f01ad8f981fe147252f66db,986941,2020-09-27 16:04:57 UTC,72469681,72449681,false,20000,0
cde29e3440923d6d60353b4f5a7f23b8db5c5b809f050f47fe4fe267b9fe6058,986941,2020-09-27 16:04:57 UTC,2500128460,2500118460,false,10000,0
45a1056fba41402a873ee73e6a566b21667398392f189f11e27e2519bb201316,986941,2020-09-27 16:04:57 UTC,16914,6914,false,10000,0
c2e4d8603776be41703b0531d739ee1941ddff45c07d3be2e2737d3ee701417b,986941,2020-09-27 16:04:57 UTC,10942620299,10942610299,false,10000,0
2fc46dbc3a58b70c16c9b5703bf4cf20bb32503b1c79cab832d114ba75ff7ac9,986941,2020-09-27 16:04:57 UTC,101325571,101315571,false,10000,0
aec10eaf9aaca107bd19b66051d5e4da9198300a2f47cf399c4b0efe7a6bc3c8,986941,2020-09-27 16:04:57 UTC,1012303,1005523,false,6780,0
bb8d306d4153d291229773c1aaf1865dd66f2e9127459a76a2d123b0325c1b3e,986941,2020-09-27 16:04:57 UTC,238111252026,238111242026,false,10000,0
9f2e46fb6ae2d7ad3b10d12aa632963e7379ea73b742e6c23f5354725122b231,986941,2020-09-27 16:04:57 UTC,10000,,false,10000,0
1a1b33a9abeda8357fac496ad1cd0c928fc0ecc18c29b4d518fbffcd14612567,986941,2020-09-27 16:04:57 UTC,34563,32981,false,1582,0
be57a4f89f4355ce8f38068a81884e744e436efae723b3ab5e719f1d5a074779,986941,2020-09-27 16:04:57 UTC,30889129,30869129,false,20000,0
08f37fcfb49632dc829310f947436d8c59666a9f3dc9e864a1d9b08ebf4eb79c,986941,2020-09-27 16:04:57 UTC,728889012,728823964,false,65048,986930
a2fe3bdb1aab07b572e82c4fefe64a3924c1abfaac271e717cf19d407f26946d,986941,2020-09-27 16:04:57 UTC,732642796,732638680,false,4116,986928
e248a8a5da51ee4bc3bdcde2405b01d474595c435d24eef5bd54e42d056af6c8,986940,2020-09-27 16:01:12 UTC,63129317695,63129305320,false,12375,0
d56d26c0996c79f715470fad3fd7a90b749732ba1c9c5c9d486a878ec9b760a9,986940,2020-09-27 16:01:12 UTC,37961727,37958460,false,3267,0
467f5e738f9b189619ab0a21532ae603240adab01db5f157865b211b7cdca572,986939,2020-09-27 16:00:59 UTC,318546329883,318546327501,false,2382,986850
5fbfe65909bfa70746fe048551d144238031bf0a280596b0c677e3e788cbccbe,986938,2020-09-27 16:00:38 UTC,10000,,false,10000,0
26d71292812dbb922e0e9ce6bb1185237716037db5fcf41c408ff5f9d2f67db5,986938,2020-09-27 16:00:38 UTC,8301012167,8301000014,false,12153,986927
88766cde63d5dec4822e1d15bbe82a4d1a42ab0914a396fccd09ed2ac1b202b0,986938,2020-09-27 16:00:38 UTC,100157945,100155495,false,2450,0
ddfdf3469d3d3d07579a2620ed3241578a8e2f352df0921dcf4a1bdf6db7a383,986938,2020-09-27 16:00:38 UTC,959318173,959315218,false,2955,986927
798ea22d074d1d8edd56830df1a9f90f67311eeafa8f53b12458be456c495d63,986938,2020-09-27 16:00:38 UTC,146443309,146415081,false,28228,986926
9e9b38db65b7dc6354714b6f0dc9e8ce153dc67dfce5b1cebfb6d302b7473485,986938,2020-09-27 16:00:38 UTC,190303419,190232213,false,71206,986926
1584834d26414df93a3f0261a4cb911080558be62d52e17c47e1b86ce5ba1e3c,986937,2020-09-27 15:59:30 UTC,108551812,108543271,false,8541,0
c480e5ed4cb26c1229e461a0adbb3c265fef115c3efd35874ec44fc7e0fa91ad,986937,2020-09-27 15:59:30 UTC,4271765318,4271763226,false,2092,986925
1c977e6024c28bd78666d9a48fc63b688d1db60dcc4f7e15efb00141c71c9ece,986937,2020-09-27 15:59:30 UTC,10000,,false,10000,0
85e76048c6932e46ae5d06694f85ef072df46363557db189bfe63e03c16b6212,986937,2020-09-27 15:59:30 UTC,499990000,499980000,false,10000,0
dcb9448a07f4b3ade2e7dc7d6c948f09fa71e8007f9d4ec35168520fee19a0cf,986937,2020-09-27 15:59:30 UTC,768959908,768891580,false,68328,0
b20311b966d651239592c9182bc523720df7b08ba775905b1d19bc057dbc64e4,986936,2020-09-27 15:57:44 UTC,500000000,499990000,false,10000,0
7e22e90fd33693f929fb37c616b8bfba3a752a60c965370231a021a6557a3a09,986936,2020-09-27 15:57:44 UTC,500000000,499990000,false,10000,0
7bc814c1ab6898b887a5229ea3432d3064c4f4b25a49119426927f36f324aa16,986935,2020-09-27 15:55:43 UTC,10942710299,10942700299,false,10000,0
dea41a2edc3c075a5858b1ade17d9e406886ecea4eaf44f0b50021f2d348b445,986935,2020-09-27 15:55:43 UTC,10000,,false,10000,0
9f36b1463a837546a941241ec6177579f6c861da4683caff92e08813cc0fa2a7,986935,2020-09-27 15:55:43 UTC,212378315,212376055,false,2260,0
86964842efa3115b548e517bcb738243776646ce04899f38f3678a33eea4f19a,986935,2020-09-27 15:55:43 UTC,10000,,false,10000,0
3fa244ff2d3e33ed3b8c13ce67080aeb3994b0b1e1fe374da49cc4fb92215c3d,986934,2020-09-27 15:54:24 UTC,62814858,62814090,false,768,0
80a07248911b4528d58b2fc8b3e7fbb97cceaea363d18d9e9157f45256ebda55,986933,2020-09-27 15:53:11 UTC,70959000,70955652,false,3348,986848
a369278436c51b15e0dd96b462798643faba40d788f540ccbfdc656a0748ad96,986933,2020-09-27 15:53:11 UTC,10000,,false,10000,0
93ae941e5965365f6c6eac8c1de226085eedbfd053ec77e20b2c48f614d1da84,986933,2020-09-27 15:53:11 UTC,475257820,475255438,false,2382,986922
54ac7b20f2a166ffc1c710e3c915e98eac99f39d288cb8d07a325190e11c2800,986933,2020-09-27 15:53:11 UTC,329614831967,329614829883,false,2084,986922
5c436bcc40de94388589be2926f2189b25596ddf64b300b7ab93b73c681b044c,986933,2020-09-27 15:53:11 UTC,241286343,241283076,false,3267,0
4a134e45890b2aa455f0491aeaac6a54daec38db026ab5d095c828c851838f70,986933,2020-09-27 15:53:11 UTC,11115303895,11115299896,false,3999,0
cfe6069b8a0657349cf62958bcff792abd60a2a2097b4e150b51c36665ded025,986932,2020-09-27 15:51:11 UTC,15568733,15564130,false,4603,986921
0abc2239e46870943314004992c58880dad4b74bc1ee8e12281a7da6072ebaf0,986932,2020-09-27 15:51:11 UTC,191727262,191668304,false,58958,986921
24165dcb7f671ac779b9ebe703485d79da6f07aa7dd551fc4c034b5f9be6b27c,986932,2020-09-27 15:51:11 UTC,10000,,false,10000,0
f318a46f544899236fa0b49372a442f8290e6c9fac313894bbc6ba49c123b0b0,986932,2020-09-27 15:51:11 UTC,500013678,500003678,false,10000,0
40ae8863484ad0ee5cfb9babf31f57ab2d2aad5476b3888b96306abd722971d3,986932,2020-09-27 15:51:11 UTC,100000000,99997550,false,2450,0
e12625b1dd3f963fa3f6c1692bda12033a4c0459749d90c9a73bc2f47162345d,986932,2020-09-27 15:51:11 UTC,108763079,108754538,false,8541,0
c8703fa8fb8881ed14abe61abdab2f8bc972f5c8f9359e4a98660bcc87b7d180,986932,2020-09-27 15:51:11 UTC,186213699,186192343,false,21356,0
2aa534c857b5344101b340cf6e656a8afbfc5a90a0b95e427a21e5bf5ebfed24,986932,2020-09-27 15:51:11 UTC,62824858,62814858,false,10000,0
3c5ad21f6e216a8e02fbd0c24ef3df574156d8ce259bbddc1cb8dc7641e000b2,986932,2020-09-27 15:51:11 UTC,10000,,false,10000,0
36ab5335d499692bdf0ffccfa196cfc1652b651740b894b7958e7fe5e9960758,986932,2020-09-27 15:51:11 UTC,147272342,147246745,false,25597,986921
0883ebe6665387037d2886695277ad068c131e124fadb31d2a29a9390e20c8ab,986931,2020-09-27 15:48:20 UTC,272628181,272616096,false,12085,0
5a38f03329eb475118b2a3af974204fdc3b27e08f2f352fdd6c53d45c9b02442,986931,2020-09-27 15:48:20 UTC,70144858,70134858,false,10000,0
4207559c41b9a38323dcf02c6897bc90be9a7009909e2513c73dcff85f8486bf,986931,2020-09-27 15:48:20 UTC,500023678,500013678,false,10000,0
b6761544f7a994b006de611751c0256b42204d23cc26a77b1871d40685751031,986930,2020-09-27 15:46:30 UTC,10000,,false,10000,0
8e1ae464a45cd7843f1df240ef6ccb964304bf4593958cf624055956e846cad0,986930,2020-09-27 15:46:30 UTC,201806225,201804305,false,1920,0
d1b0bc684b072b7f5d03e401580c38f0ca4bcdb60a3d45c7311af6b3d6a6e554,986930,2020-09-27 15:46:30 UTC,38160781,38157514,false,3267,0
05f94b71513402058b5e22eac1e6429bba7e843fb7309dd509ff3bd3b4142954,986930,2020-09-27 15:46:30 UTC,16912455481,16912445481,false,10000,0
13ef25f5e8dd6f5aff3e3fa325ab6af5ba02e4e27a077165c22caff349b6eb75,986929,2020-09-27 15:44:48 UTC,18178861345,18178851345,false,10000,0
f4ac3c7f5e306dbcd5ecb9e3f9eed71928521fba4292f66cb1d29cd870971536,986929,2020-09-27 15:44:48 UTC,10000,,false,10000,0
3ce7db21ed7b727402e81105ad6081efb7319b3a89e4369313496dbe333f517c,986929,2020-09-27 15:44:48 UTC,434594274,434592354,false,1920,0
9da43fbbdbb7c95db76e4c0c0cfd10d30c978af47f79d0ca6998bd30fc0ab9cf,986928,2020-09-27 15:43:26 UTC,101804681,101744681,false,60000,0
a2854e0ebe1cad2cf8c2fec3d05e8d62b5c839d6a7b6419f6b7828a5daa2e315,986928,2020-09-27 15:43:26 UTC,333110724849,333110722467,false,2382,986917
53c31be0d1015ad9b7bbb4d8e6e3aa280da022611f1f912a06b2b46321790dc1,986928,2020-09-27 15:43:26 UTC,100000000,99997550,false,2450,0
1d2ef21b08dfa3431834072c3e49bf02c8142d2ab60a5986ff00502cb51a4481,986928,2020-09-27 15:43:26 UTC,100000000,99997550,false,2450,0
6b8b50b6d7560252ccbc6b9ad45851fe2157b42819542a84343bc9573665d84c,986928,2020-09-27 15:43:26 UTC,710631664,710563336,false,68328,0
45178d463f7c29d18fe82c00ab6a5bb40e22b8595a12965d34240d55a61c7a52,986928,2020-09-27 15:43:26 UTC,18178871345,18178861345,false,10000,0
9fb1d4184aa3bcfaae5c7fdfc78d09cbb24221c6803bf5b50e9d0d3c5a983c64,986927,2020-09-27 15:41:45 UTC,10000,,false,10000,0
ecbbda1d699d083bf5a660efa1ad680a158164447ee4fdb635d2f35cf5bda04c,986926,2020-09-27 15:41:23 UTC,10000,,false,10000,0
158aea77b75b52f6674407315c853f038a08e28dc2248d56c9e1f6458ef4cb08,986926,2020-09-27 15:41:23 UTC,241448030,241445070,false,2960,0
933a0e1aa246e9f86341bd976e0c504bbfd4c73c1d651bdef405317334889749,986926,2020-09-27 15:41:23 UTC,18661956035,18661946035,false,10000,0
d24d72ecba99f5ddeedabb9d3bbcc4fd3d17389dc0803345b39ca17fe0580cf5,986926,2020-09-27 15:41:23 UTC,99973500000,99973497650,false,2350,0
e61e687b2f576c9baf0dce3dcd67c106294cd4fdba3cc5d7fca8ed372429c1fc,986925,2020-09-27 15:40:21 UTC,72161348,72159088,false,2260,0
b864fc0c9505770077d9638a20f991fe583b92fa7ba6e6231f6743aec51cc271,986925,2020-09-27 15:40:21 UTC,148014071,147988175,false,25896,986914
2212d3c7557ff06d874665a94003139d108819d17666a3bf7603691e2726de01,986925,2020-09-27 15:40:21 UTC,193257865,193194261,false,63604,986914
b68582229dfea06f73df31a8daefa4dd2973e8e5d9fa910e443524a5816fd43a,986924,2020-09-27 15:39:27 UTC,549548900,549538900,false,10000,0
7416be5fe2ccb0514c116e41f96d761899e302b15d60cd694a4cdb76f9d094ae,986924,2020-09-27 15:39:27 UTC,52000000,51990000,false,10000,0
bb803a16549c2dc9254b2959c1010d655ca1bdcc9bbae2cbda10b2fded882547,986924,2020-09-27 15:39:27 UTC,18661966035,18661956035,false,10000,0
029003d0b6e2dce35ac5d973922f7412e590659c33e76469235c1d8a94b209ca,986924,2020-09-27 15:39:27 UTC,38355444,38352484,false,2960,0
31b92eca3a6ce6ab3b80600c81aa05326f59de3b4877fe27c940132c1f10df46,986924,2020-09-27 15:39:27 UTC,10000,,false,10000,0
3916105c2ca1231d5ded0c8e9f1bb83629526d6a0c6a624182fad2558a172334,986924,2020-09-27 15:39:27 UTC,53815558,53814558,false,1000,0
ad8eb761e42a4b6e8f75000d8d52717350b0b4ee72d6cd7a9cb382ee2a334baa,986923,2020-09-27 15:36:44 UTC,10000,,false,10000,0
229bfd466db351a40289b9e1d7c7e90ead01ae1898297e8e223cc1065c276c44,986923,2020-09-27 15:36:44 UTC,18308903363,18308893363,false,10000,0
24c5707cc691b1d8bac30a48b02c80d6fee23e53761b6b5312ae71b8542c3d6a,986921,2020-09-27 15:35:45 UTC,1000037350,1000027350,false,10000,0
da671e196756c651680bd1fa38eec4ef9c5fe360cd7c050d2b3db526968b5931,986921,2020-09-27 15:35:45 UTC,13906395999,13906385999,false,10000,0
299ca7074f278dfc48c546bdf3d364aba544563fceeab1952d49b7669a7ad383,986920,2020-09-27 15:35:38 UTC,1500058936,1500048936,false,10000,0
a3295b63c4a47dda562df9403ac75955d55b18926403382cb4cb068b3ee16e15,986920,2020-09-27 15:35:38 UTC,10000,,false,10000,0
aec5f0ebc8668cd1a652cbd823c30dfb2f2019db21adcf78ee5c38fc8b7674ad,986920,2020-09-27 15:35:38 UTC,23305629560,23305599560,false,30000,0
efe117d103a8ad5f7b3c01015a55cf3ea23ae75aea38ee97af5404cf572454e2,986920,2020-09-27 15:35:38 UTC,108979623,108971082,false,8541,0
2827517f36438959f4d2424222da0a74928c269e4bd6fef0c9de53d3262d62b0,986918,2020-09-27 15:33:29 UTC,15949051540,15949049090,false,2450,0
8e2ebad16392830a21fc391ac51295304f7a481a9c05373eb0345d5a141c0975,986918,2020-09-27 15:33:29 UTC,812634,769274,false,43360,0
343558f615fd871403557c63c5cb6e673a7a0575873bf07f9bfecd3aa9e92670,986918,2020-09-27 15:33:29 UTC,52010000,52000000,false,10000,0
3bafb82d658fbedd8a27e8ece67befd5ed5b674a6382be69d3e88220d5919f15,986918,2020-09-27 15:33:29 UTC,499990000,499980000,false,10000,0
f508fe532966238f7a0e109e3fae30150342afd37f3f1dccb198f2ec064ce035,986918,2020-09-27 15:33:29 UTC,241647150,241644190,false,2960,0
0e7601e4842beed046abe77807b9ba38238f5cb87b606bd3325cd077f7bcd601,986918,2020-09-27 15:33:29 UTC,109012992,109004451,false,8541,0
a56d743afd2fb219d4197bbb765146050de18abf00dc46e856a04a13bccb7eb6,986917,2020-09-27 15:32:21 UTC,803548425,803538425,false,10000,0
1957cc5da6c36c48cbd0bafc1391a3f8cecb3ab60fcf47ac32ecff5807ee5de6,986917,2020-09-27 15:32:21 UTC,10000,,false,10000,0
86ecfe3f64b2f154b2ae81a5142a6aa6e4ecf92009a70d75ee086e147e8eef75,986916,2020-09-27 15:31:26 UTC,194591461,194531350,false,60111,986904
b83a0dd8b183b732cbfb1659446e4432d91f5b7a7f55bfb4e038a7e8fcb22504,986916,2020-09-27 15:31:26 UTC,500000000,499990000,false,10000,0
44c160e9f9b9c123965c87cecb1e75c4330d3cbbc926979273757ab1d4d4d3ec,986915,2020-09-27 15:31:08 UTC,148523968,148505323,false,18645,986904
3bf0aa163cfa4185ab43949197803b73d3953cc734d2ba18bf3a50de2897658e,986915,2020-09-27 15:31:08 UTC,671874,566014,false,105860,0
40cc675def2419fc082c6c5399a17a43a1aadf7b1b431f0fc58fd21dcdd96b68,986915,2020-09-27 15:31:08 UTC,13906485999,13906475999,false,10000,0
c0f02792568faa2c31d7b2f977dd992e64fd71d3d3f9d9802a67afeaf3b66a46,986915,2020-09-27 15:31:08 UTC,10000,,false,10000,0
7e946a116fcbbada7b555f068914716c0d665504ce913df6475de00a00512ab8,986914,2020-09-27 15:29:40 UTC,10000,,false,10000,0
fd08b3918a703e29930a0c4a5201b1dd3587e9ceeed6db7fef84c80a160e2e0d,986914,2020-09-27 15:29:40 UTC,39753211754,39753196174,false,15580,0
cbf5bff8b69d6afa7a552d4684d9990bacfeb452ca37090a3ab220107771537d,986914,2020-09-27 15:29:40 UTC,38507246,38504286,false,2960,0
2b2c9ba9c585458a288cbaabdf39c843c4e701963e8dab8706f1bc99361c2e7a,986914,2020-09-27 15:29:40 UTC,19136442,19131830,false,4612,986903
aabbdb08c9b8eac4fc98d4e4c779c316dd6cf6aa080d21f1d8357ce9dc2cc89c,986914,2020-09-27 15:29:40 UTC,10000,,false,10000,0
11f9f1037d6d0717b71c75f064e6d07d3125c3d4373b7bec587ab4d43cf9d18b,986914,2020-09-27 15:29:40 UTC,3547500000,3547499929,false,71,0
0c928577ce179bd0fb21ee3e5fe89289516ee6dace5e76735ee8082211e10c12,986914,2020-09-27 15:29:40 UTC,35525607,35522697,false,2910,0
63c3ecfbd11663a746f995a34bae4f4bf26b438de81ec2413951e70a4dbc3fa2,986914,2020-09-27 15:29:40 UTC,333115756933,333115754849,false,2084,986903
959aafd77d29e81cc9fa80b1b1ce7109f89da17f405942d06b6be8c234df217f,986912,2020-09-27 15:26:04 UTC,10000,,false,10000,0
72bc171b2be1724c62ff60f4a6f6aeff64be7b7e88567cb5c2007968cbb0988c,986912,2020-09-27 15:26:04 UTC,1000088936,1000078936,false,10000,0
ecebcf13f407e806bd3f3f19a64aa0a1be1385fa66c2ff4a55f90358a59ba861,986910,2020-09-27 15:24:55 UTC,1000098936,1000088936,false,10000,0
5e444d8ff99be6e3a9f4fdec519ba72e8184e7ba2eb4e111fd02130af744c35b,986910,2020-09-27 15:24:55 UTC,10000,,false,10000,0
5225584bc74c2cdbdccd812fdbb3b493605616925c0a693399077db581e04320,986910,2020-09-27 15:24:55 UTC,627418236,627349908,false,68328,0
389a1a57d4e8ea27849a920ee1bbedb7c1ae9eb69ef63a486c431a80929e0cd7,986909,2020-09-27 15:23:42 UTC,21600,11600,false,10000,0
4018dc158e1685084c2a0173b1ccd754c32461541c4bb02de6ec3ac11ec535bc,986909,2020-09-27 15:23:42 UTC,10000,,false,10000,0
7a12125f4b356d098d72523a4fffa40479651ef2d417fdb72dfa5be912fd4ee6,986909,2020-09-27 15:23:42 UTC,1823775540939,1823775538864,false,2075,986881
7a1e93e44e8678b769c6b0f9d10f2cb456f37b32fe3678c0406bc7671d3c23a4,986908,2020-09-27 15:22:31 UTC,110752509,110720430,false,32079,0
5c9e9b58a87328a643c0c1c9ac8b198f475091337c7b1743f5696db226c6cdcf,986908,2020-09-27 15:22:31 UTC,109051344,109042802,false,8542,0
b5287270fffd9fe8bb2b55b0b1a942d717b28cbab050c44040eb58e94a8e4f1f,986908,2020-09-27 15:22:31 UTC,196168557,196104074,false,64483,986896
1df1a0c833d70d35d3a58305ff7a4d66fba6bb86e27e2d8161ed884599d3ae88,986908,2020-09-27 15:22:31 UTC,341635429025,341635426933,false,2092,986896
1dfe54c63cd616fbfef113743e6179a231730621c9c1dce073193fdd2bd16c68,986908,2020-09-27 15:22:31 UTC,14760126644,14760120508,false,6136,0
457cb19df23e7cceb42af4b0b3ea914d0730043e1ea6e7c1318779161e99d15d,986908,2020-09-27 15:22:31 UTC,149230215,149204923,false,25292,986896
259bfeb3c2011846f5d54d1879df10d836d6af719d426e1a31301d0d8a32d21a,986908,2020-09-27 15:22:31 UTC,55486981,55435101,false,51880,0
472ae94c1454fab5a3441cd4cd0dc8e89f38204eb92ad2585fb8ba015c409eae,986908,2020-09-27 15:22:31 UTC,10000,,false,10000,0
2b733f9c77b0b9cba2b5afe70b679712d7859dea7dd23a2e503264e1c787784f,986907,2020-09-27 15:19:55 UTC,1853827917,1853815832,false,12085,0
20c86b820ad94f7a488953776a429d1f4069085c70c8f8d90db543efab4fc884,986907,2020-09-27 15:19:55 UTC,1029371,1026014,false,3357,986896
1acdf8590e6d7bd558e91ba918618c9fed66aca67a642f12f819d9eeb1b942a3,986907,2020-09-27 15:19:55 UTC,3700000000,3699997550,false,2450,0
87629c5aa93915511bd39a4bfe541efe0319b8d775c820c33e9960cc8d1211f7,986907,2020-09-27 15:19:55 UTC,2294113,2291663,false,2450,0
1f2341f216e20454538127931bf012e2fd989fd9470d566341873e32b98f4592,986907,2020-09-27 15:19:55 UTC,10000,,false,10000,0
347d2d97c226fdbcd06704b73bb881115db2f976e3656b4ea1a57dd8fbd19fef,986907,2020-09-27 15:19:55 UTC,10000,,false,10000,0
a32519b0e6325f90d19e5d65c254017c57597db2cfad0a605e09020cd7ee10b2,986907,2020-09-27 15:19:55 UTC,241835637,241832370,false,3267,0
9e412b837b72f4b08049027356e8418df9bf4520292f2bc251c54ddd3eed1e9e,986907,2020-09-27 15:19:55 UTC,10000,,false,10000,0
edd6ded48a7e7e111e270a71865e9255fdae67c8ce666e6bdd7b753a31f22ff7,986906,2020-09-27 15:14:42 UTC,10000,,false,10000,0
d83058a3355e2ce3e93fadf5b3e149166a3b1b04a4c4163ff2e9218c629848e5,986905,2020-09-27 15:14:03 UTC,250,,false,250,0
9a57d6d9d119fccc80b38a0bce73cf2290cc7c2de718bccf5e6fe3669b850352,986904,2020-09-27 15:13:52 UTC,70704691,70698691,false,6000,0
8cc4257b31d118f8e35bee90f9996131f53faaa88e91089ea365f0da028fb7d4,986904,2020-09-27 15:13:52 UTC,189497740,189490000,false,7740,0
96086ce44f9f56876acc6ccf4105279688034c9d4328a933c920d0b45d803571,986904,2020-09-27 15:13:52 UTC,10000,,false,10000,0
82b8157e3553267eab06fae9425a3d4312faac271582b7ad38d16baa5c1bde56,986904,2020-09-27 15:13:52 UTC,42317,39699,false,2618,0
084f5a85753c9e00533de19f26216b99ae1a0e6829cfbd5dd96a57605cb2f225,986904,2020-09-27 15:13:52 UTC,109530516,109521973,false,8543,0
766c08bdd712871148c678f5df5b56f3070ef5b23558ae372b731030c4b8466b,986904,2020-09-27 15:13:52 UTC,109498737,109490194,false,8543,0
b221099c900ad534c7423eb509196c3f04ed9425797a2496cc52edf2b03c6550,986904,2020-09-27 15:13:52 UTC,10000,,false,10000,0
aa0876b8a28cb7af57043cb884d15cc0c0e5d548ddfb55b29ac8dd827e3fe4b5,986904,2020-09-27 15:13:52 UTC,11779143,11777109,false,2034,0
e0811453a190d68dae21c62765ec7cdd7365b4a263b9465102d9ded5c0273c90,986903,2020-09-27 15:11:43 UTC,38788819,38785859,false,2960,0
a67143df0a2ab7944320fdd4eff668f65418ad5935994263023c456900816cd2,986901,2020-09-27 15:10:48 UTC,109603621,109595078,false,8543,0
45147336ad32fad447fee0c0b5e49f7a2769176b3c1ed4579f02db01c936b4d0,986901,2020-09-27 15:10:48 UTC,500000000,499990000,false,10000,0
4e643b4dfbd643d7981c30cff6514cdcd8acadc87f551eb0f274932d25be2c24,986901,2020-09-27 15:10:48 UTC,349634931118,349634929025,false,2093,986890
3e6de77221b85d947a112f838bb952fcae2e2d3fd2da70b27e222c69d510ad54,986901,2020-09-27 15:10:48 UTC,10000,,false,10000,0
54a2a25da9d471940d37b388450881073682af520a21870e39b70c8ff3152b59,986901,2020-09-27 15:10:48 UTC,6264477070,6264474810,false,2260,0
256d7db4023a1f69558d5fc4d113e730bebf3545e53a2cbc30c27ce611030099,986901,2020-09-27 15:10:48 UTC,258850000,248850000,false,10000000,986888
40dc16c75f28d6cb52aa26b9a37ffd6f210b63601d5797f56f762ca074e7b182,986901,2020-09-27 15:10:48 UTC,569101664,569021664,false,80000,0
cb68511bba9129411c5f369044852c7f3fbeb89457e2e839a285a6a1bc998694,986901,2020-09-27 15:10:48 UTC,121922380,121920120,false,2260,0
6ab91d9d23cbfc30c1ddcef44800b18e39cbc1f4c0d2d2b56854b1210680ee5c,986901,2020-09-27 15:10:48 UTC,10000,,false,10000,0
31d17e121fee61ec9de92f43a35b60d57865ae2c2a2519b91bd9cb0fc9f63e17,986901,2020-09-27 15:10:48 UTC,197735251,197669633,false,65618,986890
2a24850c76d3df07822239894c673faeb18a0b38237df5fbdae31686b765f422,986901,2020-09-27 15:10:48 UTC,109639026,109630483,false,8543,0
fbbb86e51a502f7b3a7b3fddf1623566063cabe2d46b8b0faf16975c40769944,986901,2020-09-27 15:10:48 UTC,149766646,149745383,false,21263,986890
76ce3ca7ac52564fa6554f04d53cac4455e7e9c990d837db606f7680320e8876,986901,2020-09-27 15:10:48 UTC,599125779,599123329,false,2450,0
90ea54588ee53980826585cd5627e7b63b080442db62ab53865c40183db6bfb7,986901,2020-09-27 15:10:48 UTC,10000,,false,10000,0
358d2044e06474d61e579e84ccac91283f618931016647f310657fad4afbee19,986901,2020-09-27 15:10:48 UTC,109566574,109558031,false,8543,0
dc275bd9609b2856276f9dc609c9f944ac5fa67e5db71f47052b976ce7f8a511,986900,2020-09-27 15:05:29 UTC,199500000,199497740,false,2260,0
bc7aee432d5acb3ff6d339f8c282325f50e4672cd6b566fef1f0684b07dd4780,986899,2020-09-27 15:05:11 UTC,109689966,109681423,false,8543,0
39714c5dcf6b962791e08e6a0af1f11a4786c9d2152573e3e131491634a5759a,986899,2020-09-27 15:05:11 UTC,2500138460,2500128460,false,10000,0
b30b6684f8cd2cb6bacae141d3f5bd83e7597b68465784c8ddf23acf312a2d73,986899,2020-09-27 15:05:11 UTC,499990000,499980000,false,10000,0
96958b13d0b5c54eaee0c98f39987cc3f96a7570880395f5dba1b75359082542,986899,2020-09-27 15:05:11 UTC,238728019975,238728009975,false,10000,0
b7938cf89f8783b4ce8f36e733466d3581d6114aa37b6bc2e25f92d163ff1d9f,986899,2020-09-27 15:05:11 UTC,500006520,500004427,false,2093,986887
771fc9e810a4ad4c662fefca718325b343cf55a307083686c07fa7dcbd8b2ab5,986899,2020-09-27 15:05:11 UTC,10000,,false,10000,0
66dc99052544dc3ae45c31ac05a0c5f5e79f95366aad423ffa81194620089ae8,986897,2020-09-27 15:04:01 UTC,82695199,82694199,false,1000,0
8b18dc0b66ade91366e39ca5459e05e048fb92e26fadd2b962d8f84e68403c6e,986896,2020-09-27 15:02:23 UTC,10000,,false,10000,0
c72476f68abdcb49bd0b3faedd48d7d29c8990480c4dbb18d588f95b487e725f,986895,2020-09-27 15:02:01 UTC,242008404,242005444,false,2960,0
6208cf8550319977f3e00e979bae4ba4dbe5d8e6b7779226c78352f6898a6270,986895,2020-09-27 15:02:01 UTC,10000,,false,10000,0
977e274ca5039d081eb4647fe5be64b3c9cb9fc8e67b1faff289314fbfcb7bb5,986895,2020-09-27 15:02:01 UTC,298000000,297997464,false,2536,0
0d6b5b5687d285a13e85a80125b992e559208fb28a4d92540144e033ef5c6cb4,986895,2020-09-27 15:02:01 UTC,1881915421032,1881915418939,false,2093,986884
9134fe5879bbdce00c427eee2337b60c961917c661029d9675be80644e2890e6,986895,2020-09-27 15:02:01 UTC,2990227543,2990224289,false,3254,986863
8a7e6844087d2001a823824f43a6c1b535c9f435120cab4c97b5d6afc726087e,986895,2020-09-27 15:02:01 UTC,970444281,970442188,false,2093,986884
907d1fe77eb7d7708947af57ba4749ba85838be3ac1e38664634df771dba9e82,986895,2020-09-27 15:02:01 UTC,150473701,150447227,false,26474,986884
4df1a57634419ffa82dc12c3915ac9a4a9a42ec43a3fb8e2277a58a8ec5542b4,986895,2020-09-27 15:02:01 UTC,199631656,199564047,false,67609,986884
d17d1acd7fdc029485b4e317f199c1d9454628fac3b1f85bc7ac965f3988cc3a,986895,2020-09-27 15:02:01 UTC,36929244560,36929234560,false,10000,0
ffe71680c460a3bdd0b58c9d0bffef257285286ae5582fc62c4af949f2953c8c,986895,2020-09-27 15:02:01 UTC,109728354,109719811,false,8543,0
08ab32cc4113909d06a9be101d1e196ed3be8be9da9e031e313899fb86928205,986895,2020-09-27 15:02:01 UTC,4196,2406,false,1790,0
883d249e886b6264994cbe70cbc80901545e9b1329c18059d38156533863d931,986895,2020-09-27 15:02:01 UTC,351183933501,351183931118,false,2383,986884
2801cb0ba2474db14047b3a7e570290d459e1e65a719faeaf78e86efc758b6f8,986895,2020-09-27 15:02:01 UTC,161473068,161463068,false,10000,0
4fdeb4328081baaf6d17c3ebdbd609adad8ca0718c4d1c7d7265c3a84e81d98a,986895,2020-09-27 15:02:01 UTC,9019902110,9019900528,false,1582,0
719bcaa1b4043738a4f9818b9343064750f220b6ffd5f560269a6b18e4f57e94,986895,2020-09-27 15:02:01 UTC,109760744,109752201,false,8543,0
ee0c79e4846131461805e51d132672642f9fa9dc12b73bd6d0a2eeef18c0051e,986895,2020-09-27 15:02:01 UTC,3475394578,3475348793,false,45785,0
0d29bd3dcc5c4c0bbe59d48335620b14d7fbbd888ae877458ada68917074144c,986895,2020-09-27 15:02:01 UTC,10000,,false,10000,0
7952676768ceae34ad0a32dfd1dedffe7c6642d910fd247d601937ddb5245c29,986894,2020-09-27 14:57:34 UTC,112793027,112791107,false,1920,0
8b9ed12e5cef2c50d57b818646e110052e12ed1ba2bbd617719116ca454d3eb5,986893,2020-09-27 14:57:26 UTC,10000,,false,10000,0
0ff96d8fd5894e2a5e65159f793dc81c463c3f1163ea56c12a34386c41efe1ec,986893,2020-09-27 14:57:26 UTC,39059507,39056547,false,2960,0
5d2fd67d4f1a2dc88262fe8f9fdffbe868d3639eb36794f851fe4fecf4919ad5,986893,2020-09-27 14:57:26 UTC,69288975458,69288970508,false,4950,0
346ba2e783dd242aa61918f0a3090c3a0785295aedccbfcd94f0f5b86cb61656,986892,2020-09-27 14:56:17 UTC,500005425,499995425,false,10000,0
0c72a5bdc977dd588b7817f95bb2ec72604049eab6669eabe5947ab34caf70d7,986892,2020-09-27 14:56:17 UTC,303382968,303370348,false,12620,0
60a6640f3730335f1cccb7e45f4b2644bc4a98b2c03a571cb2632452440d8390,986892,2020-09-27 14:56:17 UTC,5136226262,5136126262,false,100000,0
863aa0f88c2a2288501759d22298e45c9efd3ef0628328fc9c8f1dabb23c7f6d,986892,2020-09-27 14:56:17 UTC,50000864692,50000828574,false,36118,0
367b94ccd00ef98b203949a9603fb3805a96cab433193faba1ea29a116cbf1e8,986891,2020-09-27 14:55:06 UTC,10000,,false,10000,0
02004bc5cfdc3d38f7d9385310dd5e8fe0373994f7a06470372e479d4cf79ca9,986891,2020-09-27 14:55:06 UTC,373509812,373504592,false,5220,0
0ac357c92fc7e36a24c76213d32810d26395d0acde74937d70f8a38ea9ad52dc,986891,2020-09-27 14:55:06 UTC,10000,,false,10000,0
29b7053161932c2fb173752a4a1c38858a927b3f43ff15358c844ce121f6dfdb,986891,2020-09-27 14:55:06 UTC,10010000,10000000,false,10000,0
8f1619713ef218c1f25a055f8e31f3fa82a57060f363b2e801c4381e3a651431,986889,2020-09-27 14:51:19 UTC,242181522,242178562,false,2960,0
e65078289f17dd923c2c0a747adfca6c0cbbba27d3f9dacc8b85b04519bae121,986889,2020-09-27 14:51:19 UTC,151215642,151190330,false,25312,986877
c3fce8b8e9fbee6153766b328c3406dc57a8eeb6ce986e4b637958ed4c76dbfe,986889,2020-09-27 14:51:19 UTC,201253873,201188801,false,65072,986877
4ecd6cb19107f15449aa074faceb6ef330c4ec89f0da64a8f5be3be3425bcbec,986889,2020-09-27 14:51:19 UTC,1484357686,1484347686,false,10000,0
987e774f3f58ecb542a717c3b4b69f0dd594fd2c4a27cce9ee98df6b1393cffc,986889,2020-09-27 14:51:19 UTC,10000,,false,10000,0
8ce44106c78d569d8b48867a2b2a98d5d706b4198242775aaf3fd2128da84b14,986889,2020-09-27 14:51:19 UTC,352360250601,352360248508,false,2093,986878
061aaed6d622f562ef86bf67c10c95dd84e39ba6c9af6435f78490159a4b4a75,986889,2020-09-27 14:51:19 UTC,927068438,926768438,false,300000,0
63336cfa3ebf4f71130872f38be2cb823fcecd07f7efc672e787eaed5bbe675c,986888,2020-09-27 14:49:55 UTC,10000,,false,10000,0
72b3d500bbe3b7e00633a6cfa7e66ca37123e06c97511a8b70bd74fd70a48c04,986888,2020-09-27 14:49:55 UTC,482013628,481933628,false,80000,0
3985af4258e5bd8ae3698f229aa6bef9ee95ee4c230ed624bdfb85d7899e0a75,986888,2020-09-27 14:49:55 UTC,39241249,39238289,false,2960,0
0de39c1cb945f1c6a6e48cb554cbb1e320849fc665d7866494d9e12149887533,986888,2020-09-27 14:49:55 UTC,212380235,212378315,false,1920,0
bcf46609c336d5fc9b97256ce5120e2d87dda8d38f286df3b6045d02d9bc1a1e,986886,2020-09-27 14:46:08 UTC,110111158,110102615,false,8543,0
292328aa2e736500cea5b65bf3cebf5133b7f9e332ef4e4872fa80afbaef04b6,986886,2020-09-27 14:46:08 UTC,30008389,30000000,false,8389,986875
d078df7c6aa11af8bd78712d5258305680b173c4c1c484d64675eebff3e735f5,986886,2020-09-27 14:46:08 UTC,10000,,false,10000,0
6e6d5bf9adaf29d74000e2d03120e751c796f56e4e52c5f2cacaaf2a69250c60,986886,2020-09-27 14:46:08 UTC,10000,,false,10000,0
272aa849008b92badc2a8970aaa755289cdd4968e078f8e940b1bf033cbb58a4,986883,2020-09-27 14:43:35 UTC,232172492608,232172484762,false,7846,0
e170d4917f3ecfa5873cef022b95df97d909b38ed945f8b6d2f1ce8c574ce657,986883,2020-09-27 14:43:35 UTC,10000,,false,10000,0
3bfc8c8b6875dfc7616afb0daf1d40b8ecd847e6d9ead1b4c227566991e3bbe3,986883,2020-09-27 14:43:35 UTC,500015580,500005580,false,10000,0
1b4027a8d230be40655d3bf743566fac67f8b2cd571b0e72c6c68c9b639482c0,986883,2020-09-27 14:43:35 UTC,151985042,151955971,false,29071,986872
a9156e1b519f67ff67cd6271bf389afd264eabcfa49377058897002750fae3ce,986883,2020-09-27 14:43:35 UTC,1490022278,1489805758,false,216520,0
273ecb859548dcc4ef8e887546c99499f4998dbecf3e2415c2225729c4a5c948,986883,2020-09-27 14:43:35 UTC,969622,890742,false,78880,0
4fbe43c2b10f34903f52500534ee7f1f56fd44327e3d6c68c36b6c890ffccaac,986883,2020-09-27 14:43:35 UTC,10000,,false,10000,0
745ea1c1142607b922fe127796e7ae0fdee96545242631ff8d524bc024fff32b,986883,2020-09-27 14:43:35 UTC,38327307,38317647,false,9660,0
04a90cb628e3156033f109110a2848b2985e8bb07334c13ea1c2b43cee3f07ff,986883,2020-09-27 14:43:35 UTC,1500108541,1500098541,false,10000,0
1beca48dd3b098d53dd621a5f60e8cb2bd45f9f24591e9f2eff9c8b2a932d843,986883,2020-09-27 14:43:35 UTC,110140807,110132264,false,8543,0
f1c55a52e5d25b78eb3971781583e721e4989ff14484f3772f7c36a2e8e0a1e3,986883,2020-09-27 14:43:35 UTC,202851436,202782008,false,69428,986872
805266f9bf91036f0d1b1357ebfe83ca9a290ef9b4c7f26f927dc2f02965f531,986883,2020-09-27 14:43:35 UTC,171666030,171663770,false,2260,0
3ce13e3adc115c06540bc3d6af0f3c74e93e7bebe0e5fe4dc8ebf2fad56819e1,986882,2020-09-27 14:39:31 UTC,242394971,242392011,false,2960,0
6695dd8030330f1805dd3073b512a4491449ffb6010d660eaf6cc6bb1158cbbd,986882,2020-09-27 14:39:31 UTC,2374638,2371298,false,3340,986871
cf0788b2ecf6922b695933eb27d2b70e6a80aa52d4484b084ce8527a94aecfca,986881,2020-09-27 14:38:42 UTC,10000,,false,10000,0
d9689122bbbea1616e9ac41c1256c6efde4c77857b89fb9121131eb745476f01,986881,2020-09-27 14:38:42 UTC,5660106373,5659907936,false,198437,0
4cd850fff576d9cc576c554408cd4990d0123c5bf574fa68473ff605f7703138,986881,2020-09-27 14:38:42 UTC,20569856709,20569851489,false,5220,0
975c43b2ae50d2caec4f5af4043eb89c1aaa47b057fc390064184a2776e99c20,986881,2020-09-27 14:38:42 UTC,20265358,20262334,false,3024,0
faf9db715728e766f37bedd343b9a36d2d19e4521a6aba986b7b99a335d6fb18,986881,2020-09-27 14:38:42 UTC,10308509522,10308507262,false,2260,0
56d9517aa2eeaa1fd8a183acc3d723dcf4e5831866d82efb1ebbc6bbe5e2a5a1,986881,2020-09-27 14:38:42 UTC,26763185,26758564,false,4621,986870
cbd50feae702c83a4584085e2eebc67a216da8bd294d15e5ef3a95e870944582,986881,2020-09-27 14:38:42 UTC,62032999,61832999,false,200000,0
b1f976ae51929e7863774356251a0af2006288113351e87edf711227245a9f38,986881,2020-09-27 14:38:42 UTC,1500025580,1500015580,false,10000,0
92022c07233c153b8d160c667d7a75262ee321ea45bcd499a60bca8993ee5e71,986881,2020-09-27 14:38:42 UTC,637911684,637901684,false,10000,0
3de15a7b680f2a9dca5727e9b0542804d37466f4a3d23d5e1510c7ffd9b80193,986881,2020-09-27 14:38:42 UTC,97868052442,97868022442,false,30000,0
f5d61399b8f29d1007dcfc409ee12a5c7eee365baf80af54506fe1d8eb46c955,986881,2020-09-27 14:38:42 UTC,10000,,false,10000,0
09a140df17663685593280da0e0b2e9ed5b7ce2dd194e21aed30595c740b0bf0,986881,2020-09-27 14:38:42 UTC,5152280620,5152278360,false,2260,0
a0f011a66a33086ee87054de93d9a684eb31cb7bd86dc3a1312a5c81b5874722,986881,2020-09-27 14:38:42 UTC,10000,,false,10000,0
b811db59073a6152f66b7b2ddcf22161404f842d50affbff5f5c485c16543cbd,986881,2020-09-27 14:38:42 UTC,61560510,61557162,false,3348,986870
03a06985372cd479e4e101bfcf4abdb4054180d19ccd55c47987ad5d20e95bb0,986880,2020-09-27 14:33:35 UTC,221346179,221343919,false,2260,0
75c0fd700ab740d3cd3522201df3965781ede6473600db89489dda1435ff6ed0,986880,2020-09-27 14:33:35 UTC,39416520,39413560,false,2960,0
f343c3c3fcfcf86a72cb9d6f4f7540e85dc1f356c60e91fa66729c40523a1374,986880,2020-09-27 14:33:35 UTC,362756787103,362756784729,false,2374,986867
228d740e69279e64d111da7f35790e4a94ec42043da0e086c96a42b24d0469a2,986879,2020-09-27 14:32:20 UTC,10000,,false,10000,0
a00ed352ec0909ac877a7ae8c4ecf595d4a2c42c57e3bc5767e6df8eeb8b0129,986876,2020-09-27 14:31:31 UTC,18308913363,18308903363,false,10000,0
c1c3d6cf442188714787b75e2cac734014bafbac8150324e01c6dd93a4ee371a,986876,2020-09-27 14:31:31 UTC,23530254338,23530026338,false,228000,0
4e10956c6e9ac463d19744e8d8463113bcb7a4af24d9a719c9a5912b3dc93b47,986875,2020-09-27 14:30:19 UTC,25603870,25598870,false,5000,0
2506b827e4ed998202c30cbcdc135f9988668f12c24ca6a84ebf2f52ff584da1,986875,2020-09-27 14:30:19 UTC,204619763,204547396,false,72367,986864
a5678d53011c1707dcb28f113ed68083af53e151b223d23da4233a52c5b65576,986875,2020-09-27 14:30:19 UTC,18438248229,18438238229,false,10000,0
6eb58032380e9cdfb9c397c2b440482bab521891903ae6f109d33e4b6a54db50,986875,2020-09-27 14:30:19 UTC,427571664,427491664,false,80000,0
d2df0043e8d72c0b1203bdbb6ee80c85bec525ed0b40b89d04f03332a8731482,986875,2020-09-27 14:30:19 UTC,152543245,152521709,false,21536,986864
6c6851dc6a8206be5d7f4c967178479ced878125f3ebbcfd2d7857327c8b0ec4,986875,2020-09-27 14:30:19 UTC,67494760074,67494750074,false,10000,0
c66b8a78bd3cc643ba5d3108a7faac9ffaaf76f764ac25fb04968254aa0fdfb8,986875,2020-09-27 14:30:19 UTC,10000,,false,10000,0
dd2f90a06d2b1589bdfbf0fcba176ae79bcb237f7eee915c1d8ac4cae56770cb,986875,2020-09-27 14:30:19 UTC,10000,,false,10000,0
a23ad8a236c2cdb859c0047c77afc4c6071d682270e363a7fc3736c851941166,986875,2020-09-27 14:30:19 UTC,1506292047,1506290127,false,1920,0
e98fef1020c74760d76d0affaa1a826dcf159b91ace5435d2731e486275ac996,986875,2020-09-27 14:30:19 UTC,161336808,161313431,false,23377,0
d775bec2e4f2c4c2aa651ac936d6ee91333c67035e7aa66341945c5543ac1d9c,986875,2020-09-27 14:30:19 UTC,21169520,21159520,false,10000,0
d9a24a1bf4fcb8be51cf93c65ab61e57f910c5e3a25b65b27ba89fd4762a8a51,986875,2020-09-27 14:30:19 UTC,373018131154,373018129070,false,2084,986864
e8d73ab0849458a2ad00288454cf5760aa04e4ab4fe6da64e92c63cac4067d61,986875,2020-09-27 14:30:19 UTC,721483220,721480169,false,3051,0
0cf4fd0b4d65f22fed6e6ddd143f95e8079e5d064a3765a4e6988ace293404de,986874,2020-09-27 14:26:46 UTC,10000,,false,10000,0
ffb961a16e0e9d48de1b5a87b4beace42596ef3ac98a44907b8663bcd41618c0,986874,2020-09-27 14:26:46 UTC,525000000,524998080,false,1920,0
9612ba667c91a0d839f3047740e2b8ef42adb67451a31423d92fca7debed89de,986874,2020-09-27 14:26:46 UTC,1031033408,1030979946,false,53462,986863
ae91d1c925cd3b8ec6c7322d3577ccd2e5bb9e719e69832ddc13ee1d25bee84c,986874,2020-09-27 14:26:46 UTC,18438258229,18438248229,false,10000,0
565918fb6911f7f06f5d7c8b0c67b8693f8de5ea2759fa65a651e53b40face09,986874,2020-09-27 14:26:46 UTC,61305677642,61305577642,false,100000,986863
a7eda2cdf5d3969ee44c7065adb16f6e5e14a951605336b1eb0c87e9f161fbb0,986874,2020-09-27 14:26:46 UTC,242605571,242602304,false,3267,0
a5d517f0eec47db13659b3a11b848ee3baf2cb2572da7451a9c97dd640ef248b,986874,2020-09-27 14:26:46 UTC,85775878124,85775875774,false,2350,0
ff15bc93265035d36d6ab55c0f295fa86a676ffd5d6199e4cafcb609c04f2236,986873,2020-09-27 14:24:12 UTC,20181652,20140822,false,40830,986842
2b20e6611cad7149e1e69497c45a05f4e35896234c25ff245928e2d1640ab981,986873,2020-09-27 14:24:12 UTC,73577196,73575104,false,2092,986862
c24416e8ba066e1a2d9f37b7bf1f11fb2c1e45d3bf99ff9ffe6e723758bd6589,986873,2020-09-27 14:24:12 UTC,571894,561894,false,10000,0
02c64011fec82c248cdb4c6979490fc0a5a1d8d82cb2fed5bbf883f33c9d63f4,986873,2020-09-27 14:24:12 UTC,205948915,205882143,false,66772,986861
e5e34b03080fad55648944f4ea4af83cb248427e21f5d27efb102e558a11792f,986873,2020-09-27 14:24:12 UTC,10000,,false,10000,0
4b728facd49193eab63f7853f7987eacbd5b3e490fa690bf2daddb51b29513b5,986873,2020-09-27 14:24:12 UTC,10000,,false,10000,0
e4a7d9c3c49b071147153c466890af87121c462fc3df286b7547d40ed891211a,986873,2020-09-27 14:24:12 UTC,10000,,false,10000,0
5353c2f9bb5d905677e3f5ea0d3c647331da176cc7d9f91213bdc5a74f20b67c,986873,2020-09-27 14:24:12 UTC,153114068,153093995,false,20073,986861
4c69ade11a1f7039b181708839df2f63f590efc90a11c460cbd042f3a5ca6143,986873,2020-09-27 14:24:12 UTC,110583383,110574841,false,8542,0
dffb29e09738cbb51609ce7cfdf96650521ceae283289b3a74f27839b20c50bd,986873,2020-09-27 14:24:12 UTC,1116049093,1116045353,false,3740,0
b8720664c3a65b6773f4557d5723320b11d079be453e7cd17e95aa84cf1e94f1,986873,2020-09-27 14:24:12 UTC,374843737407,374843735024,false,2383,986862
65ca085b6e48e3562d009c72e9808c03e4bc4ce716bef49354e6d1cbbddb5d47,986873,2020-09-27 14:24:12 UTC,39576963,39574003,false,2960,0
ef7cdf1cf5d4a23e2922fc9b2faaf83190cbb7658c8d57804602fcf0f9b3b946,986873,2020-09-27 14:24:12 UTC,19030628170,19030618170,false,10000,0
a9f2987996eb48f98f7b5b3af7b22c7d11d17a2d2b69b6879e3c720ef2b289dc,986872,2020-09-27 14:20:04 UTC,110638331,110629789,false,8542,0
11dc5e175acfb8059818cc9be166a04dc0497389a439a86266c1eff475f3d457,986872,2020-09-27 14:20:04 UTC,493553936,493550196,false,3740,0
175b464be5ee58f9f1535e72d7bec14dc8b1f617e6ead19a0c5ed022b66fcb82,986872,2020-09-27 14:20:04 UTC,640847551,640845291,false,2260,0
7b485323adc126efc3b4f4ec8808870c8d6614aba9f92e614330e787a252cdef,986871,2020-09-27 14:18:32 UTC,270874728,270872468,false,2260,0
d65cb2adc15f955484c0d22769b45f6f28c032b2469a5c4708584ad1b731b01f,986871,2020-09-27 14:18:32 UTC,500005359,499995359,false,10000,0
41cd5db16313ae3b39eec8de0ccbf781f11624a58a4cf556d55d5c94b43e493a,986867,2020-09-27 14:18:11 UTC,67494765800,67494760074,false,5726,0
e3193e9912f7007403c474beea4152792aba23a702e073708abccacc8fec62b4,986863,2020-09-27 14:17:18 UTC,500015359,500005359,false,10000,0
f8425dc5d7f49119fc42f1fe06ea9fc8fa78d7aebea75adc7f6e2016fda9ffe0,986863,2020-09-27 14:17:18 UTC,10000,,false,10000,0
a5a2992bffe86b304e62c59a1d38f61f34d2c25f8a1d9c4dd5520367c05aa62b,986863,2020-09-27 14:17:18 UTC,18530642811,18530632811,false,10000,0
bc1b4364df00b11f90030ecb1dd8f6de01b4983066174357cd721da0afa43f20,986863,2020-09-27 14:17:18 UTC,1029999941,1029989941,false,10000,0
b35db38ed7035d13cbc2c1ec0b1695161d26f5457a3b62269d181aeabc624c26,986862,2020-09-27 14:16:12 UTC,17099362,17099262,false,100,986851
15cdd8c3d08997b770956f2bbc7bf8f256a428db6a958ef56583fb0b30cfbe42,986862,2020-09-27 14:16:12 UTC,10000,,false,10000,0
889c66bb8b92c806292c189ac0e8611a01b20391ee74473d4ed8f4dac84509b4,986861,2020-09-27 14:15:21 UTC,18567952016,18567942016,false,10000,0
0fbd1b744f4482ea58d9d37c5fe81ab262662fbb4eea5a5703843694a918592e,986860,2020-09-27 14:15:11 UTC,242754542,242751582,false,2960,0
8939207ca248ecee8c11303ec5d8433e8491a3252713fd0b41b56546e3605b19,986859,2020-09-27 14:14:57 UTC,10000,,false,10000,0
fe8183a310257eb680a77932ff6def14f4f1b4cde34a1662a3613e0949f50daa,986859,2020-09-27 14:14:57 UTC,3807826606815,3807826554404,false,52411,0
bafa8ae5cb0f385205695810b1a5f50e8585a81ec2549345d74a2a9bec5cc91c,986859,2020-09-27 14:14:57 UTC,31533,21873,false,9660,0
539a1dbb67c92b0c6ad3144d8658c37b4a0ca1d96defcb66ae8c33ae31d9a172,986859,2020-09-27 14:14:57 UTC,10000,,false,10000,0
23f0c76360ee4d44246474c4cff23715e9b4f0a7ae1a810d1c0e38ff7aecf010,986859,2020-09-27 14:14:57 UTC,293351549,293283213,false,68336,0
44d1ab21a26b590ce358889c61f1f5ac41150f6c888e19e36ecdf4aff7559984,986859,2020-09-27 14:14:57 UTC,374867687019,374867684935,false,2084,986848
ca5459462d7fa1a055eb59b09b3d2c80d683c036dff67b15ba87a301a9af69f7,986859,2020-09-27 14:14:57 UTC,39848738,39844859,false,3879,0
d64542f823f9e4f8546ddbc001dc633e4c131dee888c1ffca2dff14b00f547e3,986859,2020-09-27 14:14:57 UTC,1508000000,1507999548,false,452,0
0961ad78c82381000a1a0e55a636fa3472c634292a6a5e4214f0379923d03331,986859,2020-09-27 14:14:57 UTC,1933356417024,1933356414932,false,2092,986848
5718cbcdc81f47f2afb4ea31ff0ccc1367cecaffb568840c2b71560a970e9d7c,986859,2020-09-27 14:14:57 UTC,16562005,16552005,false,10000,0
bb549f57e7abb8bf2947df656f73a2bb477216b78e8d4501a5b3bc892158d872,986858,2020-09-27 14:11:51 UTC,375961867339,375961865255,false,2084,986845
02b4dade457bc95d19e00a2ed4d9f09788986c876ed1e8a96ad1fe827a09ad9d,986858,2020-09-27 14:11:51 UTC,3350816,3340816,false,10000,0
fcc2808f079edfcc9cf2d9dbc7112056eb4513c968ab9b56f841c421004d29ca,986857,2020-09-27 14:10:44 UTC,19321015,19313891,false,7124,986845
2a0acfb7aaa0015873103db65d47c2b4f804cc1e151dccacbf99066fff55d7f1,986856,2020-09-27 14:10:27 UTC,207576521,207509766,false,66755,986845
a0bbdc5f37733458d64e2af4bdb2918a50712649fb23f9c06014aec19635a42e,986856,2020-09-27 14:10:27 UTC,10000,,false,10000,0
15ccd996b2e0867352230a1ed0673a6fdf719843810bf8bb54e85e4b9939a936,986856,2020-09-27 14:10:27 UTC,153951008,153921342,false,29666,986845
fa6408f21dc595d29b0e122ff51615c785aba63c21954255733426435f7ceddf,986855,2020-09-27 14:09:27 UTC,504439518,504432818,false,6700,0
ad0d9c71ef5ad05e63f62a553dee63697ac2d47569c4914bad57639c89df877f,986855,2020-09-27 14:09:27 UTC,209990000,209987550,false,2450,0
83b11a53356e26ad2f2aaddf3faf2cbcef0e77cf7f1348a9d1aada3268169309,986855,2020-09-27 14:09:27 UTC,242910554,242907594,false,2960,0
d541012ecb497c071a194f80fbb6a91b2250e3b5a40cf2dfe8e0daef9114649e,986855,2020-09-27 14:09:27 UTC,10000,,false,10000,0
04f922954df3468f0ceda81bfa42862fb034b47669dbc3f322841f01a1c26914,986855,2020-09-27 14:09:27 UTC,1999997740,1999995938,false,1802,986844
da7c5dfaac5d86aacb3376879fc3c4bb2acb05f561a2dcae0d08e8af4ab4efbb,986854,2020-09-27 14:07:05 UTC,17175,8770,false,8405,986843
ff5d5956eb46d878049fa98b4936352f7550ed28b1fd07bca1ad142491c84cf7,986853,2020-09-27 14:06:49 UTC,376761145054,376761142970,false,2084,986840
ae2cbe03320cc87e02f5b5dc3baee60feca20c7e84fe0971f5de566b02f563d1,986851,2020-09-27 14:06:22 UTC,1000269639,1000259639,false,10000,0
493b4fdf9f6937ea9a863bfbf50e60872da9475857e3cd69369208f0b854f6b7,986851,2020-09-27 14:06:22 UTC,10000,,false,10000,0
39506bd7fc8b6074ff91259457f6e52b81d757df3f4e9da249d2c80b23576ad8,986850,2020-09-27 14:05:33 UTC,110905329,110903245,false,2084,986839
e2d9b5a19f53bdd64a1b0d1e5bf1b3ad90411fd171e10a5ece554fc836ed74f4,986849,2020-09-27 14:04:50 UTC,52622778,52612778,false,10000,0
89e609afc4eefc6f57eff9a59cc4c511747428d960aff9ecd25c17baf03e836a,986849,2020-09-27 14:04:50 UTC,236774310779,236774300779,false,10000,0
4fbbc73180c23b8cbfdbc9861182cd4d30ee8c2b171a695143986dd9ed4a8c31,986849,2020-09-27 14:04:50 UTC,110724280,110715738,false,8542,0
298e0b2b5736ffcacbe957f7a1aafc506a842a2721b6cd15e4d6b7875cf82198,986849,2020-09-27 14:04:50 UTC,10000,,false,10000,0
df1033f78d954a8944e69f4673f0af4cd957a0264d26dcaee0a81c8f5ce4c9de,986849,2020-09-27 14:04:50 UTC,2000167503,2000157503,false,10000,0
e572cf090183a72517b1f3f36348fcfdb813240e311e4720590133d7c8e8c91d,986849,2020-09-27 14:04:50 UTC,500000000,499990000,false,10000,0
20ebd6a236d352484d1b6c7af590fbe93aaa491e64d86bfca36d6502371f6197,986849,2020-09-27 14:04:50 UTC,499992960,499982960,false,10000,0
e2514dc00e9b2f3ab4f0927ab35d0393e62d90e3e5f9190504d7bd8a7691d4c7,986849,2020-09-27 14:04:50 UTC,1071870350,1071868258,false,2092,986826
cd614ba7f065867bd7a0888bdf177ed949aa06ee2ef24bc5aa4216df7bf4daab,986849,2020-09-27 14:04:50 UTC,18567962016,18567952016,false,10000,0
96fbb54492739d14099bf6c77f1ac5efcce1a42d6b7a55d46174fbeeae59670a,986849,2020-09-27 14:04:50 UTC,40134400,40131440,false,2960,0
fd36080133de1804082fbd6e0522634dda5dd1d497ee09c76611d57b4b7d88b5,986848,2020-09-27 14:02:56 UTC,320332733,320330473,false,2260,0
0ab710274211ac4ceb5d94b21f58cf49bd7d010c41ad66c1131d5708502ca26f,986848,2020-09-27 14:02:56 UTC,37656760,37654840,false,1920,0
2b612ffcfeefcbaaafd06fa3881bd6c2be8474abb50bc350e26de414385f90f1,986848,2020-09-27 14:02:56 UTC,131638256812,131638254462,false,2350,0
5a8aded9fc3d6565d05e2c9903049becf5380513651a556b3c6b5bf93f219b62,986848,2020-09-27 14:02:56 UTC,10000,,false,10000,0
16fa9583fc8523e2f0bee171133e699848ac61425b1fde142da9c427104e87fd,986848,2020-09-27 14:02:56 UTC,499980000,499970000,false,10000,0
153e18c7082b92dd83dfea43988a87cfaaacce4e1d8633daf242275a7ab22693,986848,2020-09-27 14:02:56 UTC,376852917129,376852915054,false,2075,986837
0c22b8a30ba250c4536de7a3b3af0008c5953029688c8722bdc84ca3689cebbd,986848,2020-09-27 14:02:56 UTC,419219560,419217300,false,2260,0
c54cbbdcdcac5b48ae7c36bfaa5a3e421751e4464699000aa0c99dfccb24a2ca,986848,2020-09-27 14:02:56 UTC,2000044800,2000042350,false,2450,0
a469db7d1f66dbf964f2d294e7d07186d995ff2ef188d5094a42345ca7654078,986848,2020-09-27 14:02:56 UTC,10000,,false,10000,0
62dcd7c2d122caad002390aa7d18ecef035d1e31d0117f39076fd49f94a81433,986848,2020-09-27 14:02:56 UTC,369776390,369774130,false,2260,0
5b04c4786ea781c0822be70e26014ea3a8048eb5800290323857121e9292f117,986848,2020-09-27 14:02:56 UTC,1105580450,1105578067,false,2383,986837
5e10bcd3d484d771bf3b57ef65a469879cdf18f8c94474e253b51fc337eda29a,986848,2020-09-27 14:02:56 UTC,20320517,20316777,false,3740,0
71a6d41d970081e709cf246a312f055632e45c85802e488cfea30bd7286d7981,986846,2020-09-27 14:00:38 UTC,175951228,175938948,false,12280,0
f2e4ecdb0c5a82bf5d2c89aee8bada1a47263aa4a9d0195a59076516c68da565,986846,2020-09-27 14:00:38 UTC,10000,,false,10000,0
b54cc2b027275ceb99c0bfce15db6166cdaf8430bb68716c17388093a1d4152e,986846,2020-09-27 14:00:38 UTC,104684915,104668221,false,16694,0
cbbe576a8d0126fbc6f7931d8297e6df8c7301624be360abf475d3d9c32a2989,986846,2020-09-27 14:00:38 UTC,10000,,false,10000,0
f3eff1ede2810aec93ffa5e983fb9a3382420c5720a73849747bada6070f3b5c,986846,2020-09-27 14:00:38 UTC,243075942,243072982,false,2960,0
224cf0517b0f532f2a1910bf6c2aa58ac0ffff61751c8c2360578459784606ad,986846,2020-09-27 14:00:38 UTC,154335755,154317706,false,18049,986835
12463de75eda9c6d9da75c4f9ea30a36e96a93043a3d822177162dfb47073df3,986846,2020-09-27 14:00:38 UTC,209693971,209637654,false,56317,986835
3ff8fb60a3aa3cd030749eb7871a64d48ce9054b6f1cdd1ea63f340352ae11ee,986846,2020-09-27 14:00:38 UTC,383473179221,383473177129,false,2092,986835
08bda25713bb45f0343c67817e8d44cb71a8e3e7c0c2916824ed1a299cd19e10,986846,2020-09-27 14:00:38 UTC,10000,,false,10000,0
932932939d5ab43536902c17eee9acfc635767ffd29cca740fbefc5ffdde1e30,986846,2020-09-27 14:00:38 UTC,5997740,5995820,false,1920,0
7db65e6b0b4973fdcc80b23011ce13a1099f8b9a9acc5b66b5e6cf32580f4bfd,986846,2020-09-27 14:00:38 UTC,1117651509,1117649417,false,2092,986835
88566326586d4af1735d5e2065c957d65257baaa8792fee13eeb0ab65791ca72,986846,2020-09-27 14:00:38 UTC,40291256,40288296,false,2960,0
c6e6f3b13244719be7d05e2bb6205e1b5effbb162dca2912fd32ee6fac8a19c2,986845,2020-09-27 13:57:12 UTC,2379120368,2379116628,false,3740,0
16e556db60892e303df624841acbf5353058ea5a864fb7d12cecf1404f189cf5,986845,2020-09-27 13:57:12 UTC,1000047143,1000000000,false,47143,986834
931822c7a47d84952e46eb6db2abb8f4234a458c4a1966c6e4959487706c3751,986845,2020-09-27 13:57:12 UTC,14240950000,14240940000,false,10000,0
c1d8f48de2c930f0b9de08f935f9f1992559dab34e7b1476b680e28ec9f46d31,986845,2020-09-27 13:57:12 UTC,383526151313,383526149221,false,2092,986834
2b5aef46ee7d5b0a8f4ce014daf54325bc3529c87c38ca29fe4637c5e6ddc8d0,986844,2020-09-27 13:54:58 UTC,48825,38825,false,10000,0
5c581ca657190cdf42ed48c3519fec492de80e2dbcc9dcad58a61d1f9fe7fd03,986844,2020-09-27 13:54:58 UTC,286041664,285961664,false,80000,0
fc0b60066045149cde247d457d44a08fd74aceb2a95854f75932118a46302614,986844,2020-09-27 13:54:58 UTC,4234686,4232236,false,2450,0
de915cb3eb054676084abde1ef58d20bc5c7f75f300ae081d12fb52a3d2ea90a,986844,2020-09-27 13:54:58 UTC,468668054,468665794,false,2260,0
2b720c6593177046367985c702d7213903429d72e0b912fdc14d3f4922fc9372,986844,2020-09-27 13:54:58 UTC,10000,,false,10000,0
658f944bb9813ea017188c3c7096cf39b702e1f12eaad31437d40f01b7804484,986844,2020-09-27 13:54:58 UTC,19300960000,19300950000,false,10000,0
1bd51d14f4567ad423e06945ba23393ad26c017f945b204e9d070b91f1873ef3,986844,2020-09-27 13:54:58 UTC,385882899176,385882897084,false,2092,986833
7432631e125e9a6dc914bb601e9382660b3e875aaf307f5fb58bbeac1231c6e2,986843,2020-09-27 13:53:02 UTC,10000,,false,10000,0
fb18153bb30084998d49e6cbab6da5b0563afc68870cb48266e5e169df7e7ff1,986842,2020-09-27 13:52:48 UTC,10000,,false,10000,0
97153463f7081f90a3f7268f15bdb86d8ed049ead66d77c3d06799e9dbda3698,986842,2020-09-27 13:52:48 UTC,133023912,133021820,false,2092,986831
8f1262bd812dd96759e417e7cd77ea0e1397aae152b6d12a865bc926476d37a1,986842,2020-09-27 13:52:48 UTC,386182101268,386182099176,false,2092,986830
642ac5082b57e4dbd55d908df086847a0f6419406861c1da55b01fcf0fc09722,986842,2020-09-27 13:52:48 UTC,39100970000,39100960000,false,10000,0
edad3ec86ea904c61deae09a8beae4e53380ae863288b2a99de1a0ed83f73b97,986842,2020-09-27 13:52:48 UTC,683152,613152,false,70000,0
8dcf5f07aa3bdb6bb3c0b21e6da26fc32577532dfd194fd4150a7e0e58b57e28,986842,2020-09-27 13:52:48 UTC,154890047,154869094,false,20953,986815
6fc6c537ad74381cf5fc9bdc4574d5d4a6a07526355bb860a1cc08b60348bc0f,986842,2020-09-27 13:52:48 UTC,211104989,211041958,false,63031,986831
9625c338a014f19f6719fa96e8a947c616a3987b0993ad1c6a7fce9425a6594d,986842,2020-09-27 13:52:48 UTC,500002960,499992960,false,10000,0
895ddd3265963c4cc6a3cc9cb4747cc8282b5df7b30428c15697205f5216f199,986842,2020-09-27 13:52:48 UTC,4748365,4745915,false,2450,0
b1b8c30b13b084bd0ed25d4723532691bd72469fb4b579e0c496aafd0aaf2cff,986842,2020-09-27 13:52:48 UTC,110737016,110728474,false,8542,0
cfbd065bebdbef3e3edd2fda2297a6c9d81264236d5d9e50b53ca3363e21d00f,986842,2020-09-27 13:52:48 UTC,243310473,243307206,false,3267,0
3d50dfd594451a9d791de172b0fbb72812c67060084d821ff2f1197d80c885a2,986841,2020-09-27 13:49:29 UTC,40443346,40440386,false,2960,0
a703b25f31e3c4d4d74eae752aeaf4d8ae167a115244f3f1a0be2300894a121c,986841,2020-09-27 13:49:29 UTC,31008426,31000021,false,8405,986829
6c0864ec082ee9cf6be322d75ad3f1ea03aa9903199370821c356cce9d3b32a1,986841,2020-09-27 13:49:29 UTC,1037522,1031654,false,5868,986829
9eb06b8f16c80cade2e8498786160dfd0811c41ac5dc1197b67ab70b8686562b,986841,2020-09-27 13:49:29 UTC,10000,,false,10000,0
12b714bd9524b7a18c5129d61438362e773099bfc813ec67e3945dd5f1230e0a,986840,2020-09-27 13:47:39 UTC,10000,,false,10000,0
1f10fbe6f9b35a3846b3e25f1872516287c158ad7fd5e07b39c5ce6e60340bd1,986840,2020-09-27 13:47:39 UTC,15010000,15000000,false,10000,0
8c6b8213fd81b644a17f36ac6c175994d90c62826585f23d1be415625546358a,986840,2020-09-27 13:47:39 UTC,499990000,499980000,false,10000,0
166f3d28056630275b03427dd9b7418bcea6c8742cc0235b31ed90da31c15f33,986838,2020-09-27 13:45:47 UTC,464281603352,464281601268,false,2084,986826
de1b552a5de968870265d6cc70bfc0bc96802f587dde4c4a281bfb5a81b8c6e6,986838,2020-09-27 13:45:47 UTC,10000,,false,10000,0
95af2eaac7cca87bf45e196daf4e3f814d675433a379fedb8d43346ed4a6a727,986838,2020-09-27 13:45:47 UTC,500012960,500002960,false,10000,0
6346742df2e098db717ef88dd6aff1775e262e5e6b08ec1c4f47eb1fd300f8ad,986837,2020-09-27 13:44:36 UTC,103764131735,103764131059,false,676,0
c6db19fc787fd866dac4d365c58b1a34ddf235e4c277776289a224d7ea51e855,986837,2020-09-27 13:44:36 UTC,41030980000,41030970000,false,10000,0
9f7db964ac02cdbd0782b804a7400d47bad399c8871a60afe7c7d2a90345576c,986837,2020-09-27 13:44:36 UTC,500000000,499990000,false,10000,0
b1d3b5eba193f3d794f29dfa6a9b67718b2a365fb85d03af3147014780683789,986837,2020-09-27 13:44:36 UTC,40516534,40510534,false,6000,0
e6d731bcb3f8ab1e367f0237ef9c8704576dc45b3b258bcdaa8833e5e29d23be,986837,2020-09-27 13:44:36 UTC,100000000,99997550,false,2450,0
00172ce15dca168832c20c02ae4e16ab8e03413cc13d9955ccbd95e5cee79a2f,986837,2020-09-27 13:44:36 UTC,5263589,5261139,false,2450,0
f791cd8fc70e524a9d2a65f7d30ef7147e2bf42534bb137edc19a06e8d5d4087,986837,2020-09-27 13:44:36 UTC,243706698,243702513,false,4185,0
4fd233f4036fbcbf759824ac4a06102ea328a1d5b8813a56a9e12b000c5008bc,986836,2020-09-27 13:42:14 UTC,10001980000,10001970000,false,10000,0
d49657a00abae1f6f3338a93b39520bbdbfe3913194bb92982c57cb40e678d2c,986836,2020-09-27 13:42:14 UTC,1023078,1016298,false,6780,0
db36d9b32b6eb7b04b9db34399f41e8bea43f059c4600ca8ebcebebc026cb4c5,986834,2020-09-27 13:40:57 UTC,11031086,11027729,false,3357,986822
fec383deec081affb3e93d5a6bdc21a9accc716c328ebd6d0e734a7f2db2a668,986834,2020-09-27 13:40:57 UTC,10000,,false,10000,0
e04fc4e22c14119fe5145b7d009d215ff43441767175664f0597a80baf81d9d9,986833,2020-09-27 13:40:33 UTC,155778283,155750368,false,27915,986821
93baa4c55aa45a89db7b8e098f2e6f6a2c0fc830e5a005964fa47df76d9a8b16,986833,2020-09-27 13:40:33 UTC,212449169,212385267,false,63902,986821
c88024c4624d13c5f5062dcba53a487e98e29e848f312f4cb7818bd2ce39d267,986830,2020-09-27 13:39:48 UTC,18356909014,18356899014,false,10000,0
a8a5aeb6968753a5d90f8f554b030e996ac8b34ebb524902a0517ce0fff88d7f,986830,2020-09-27 13:39:48 UTC,282470386,282456958,false,13428,986816
bab9497ce7e0c26d9adfde04882512b3f37a3b2dc2145cd564eea113b5ce7c73,986830,2020-09-27 13:39:48 UTC,250,,false,250,0
e54bc389a337aad6ecea753db5a2af2b7e2fb594ef44af38aa7f3367997c3e3d,986828,2020-09-27 13:39:02 UTC,499990068,499980068,false,10000,0
16a14fd82afe99bbab3c834833620ca7332ea11ec43846ec91a2587a3ceda532,986828,2020-09-27 13:39:02 UTC,18736808551,18736798551,false,10000,0
2e9ecc920b1e36dee7bab7ee176bdd87ccbf18d94ad84a1497ca62915a9cd3da,986828,2020-09-27 13:39:02 UTC,10000,,false,10000,0
fe474a53844ce20e0b13fd618aa82138f3afddb2f17ef4881d6da4d806e76302,986826,2020-09-27 13:38:10 UTC,32541990000,32541980000,false,10000,0
65704c13dc9824a30f5a74f231dffdd2053c083538b68c219fbf1ee9b04bc64e,986826,2020-09-27 13:38:10 UTC,18736818551,18736808551,false,10000,0
53b133e9f3c3f3689b86167625aa5c6738cb94a142d68c6b950f983dee72f4c7,986826,2020-09-27 13:38:10 UTC,40610127,40607167,false,2960,0
f0a34cafbf161ab3ecb0d3fffd9610648c18cecc5d12053fb03ac5f52b423ba7,986825,2020-09-27 13:37:46 UTC,49918990000,49918980000,false,10000,0
68afdec225ace8312239bb47c486b971880c4ef67d0497a1cd4fcce453d532f4,986825,2020-09-27 13:37:46 UTC,151809885,151741549,false,68336,0
e2357752078e22944d0377d079fbcaee0ec98253a46a4551331d7435878b2ecd,986825,2020-09-27 13:37:46 UTC,10000,,false,10000,0
640cbe0b947d7d39d634a417761f44c5fab7b3d2d25a9d1225f05cb85aafc17d,986824,2020-09-27 13:36:46 UTC,38440000000,38439990000,false,10000,0
92ee1e4c549fe8320c3be70407643bf8f804f2de60dfec2cd337704738c0c65e,986823,2020-09-27 13:36:05 UTC,1000035686,1000025686,false,10000,0
ead96730ac109cb3be7e465d3ef42eaa8b9a71b12629b87484463f46fc552ac4,986823,2020-09-27 13:36:05 UTC,21423398,21413398,false,10000,0
210915ecefc34174cc948de3f8ae699167dcc275c2330005e3b632e6d10056d1,986823,2020-09-27 13:36:05 UTC,500092960,500082960,false,10000,0
a92d4c0af31cadcf15638f2d88ec2cb5582b1f50ed9ffa2c676b8bf9836a7f1c,986822,2020-09-27 13:35:32 UTC,10000,,false,10000,0
21d78d30621da2157264b90af8b4a15227ba221b6d38754acf3989f0808e27f7,986822,2020-09-27 13:35:32 UTC,50000000000,49999990000,false,10000,0
fd8d7f1b4603bf3747b755452ba4c91d32d443f6827a5018f4fd159571d20246,986822,2020-09-27 13:35:32 UTC,243932110,243928537,false,3573,0
6c48d8c8b847101356ddebe35f0da1dcb32a956f7974f1dfd4a4e654373059fd,986821,2020-09-27 13:34:27 UTC,176520153,176510153,false,10000,0
15db945db7459ed470043628288b56566015055b53d39b255f0d1540c353d983,986820,2020-09-27 13:33:44 UTC,1980310046,1980013870,false,296176,0
f419ea9b866b9bb466be25da3a124028ef68bfcbbdd93d6a72a7e9cd848d4c0d,986820,2020-09-27 13:33:44 UTC,2410735730,2410439554,false,296176,0
5cd2383f1a132ed69c11cf17b4b9eb98040bd359e841295ac2c578d67b37e6e9,986820,2020-09-27 13:33:44 UTC,500102960,500092960,false,10000,0
5120323f43e366e4005482634afcdbc0e7234186a1689dfb388d78c647f7f086,986820,2020-09-27 13:33:44 UTC,1202393185,1202245601,false,147584,0
2ac9e39a85cf7fd532e7a84efd840b378560a9aba3a2a2117e46f91bb8815b8d,986819,2020-09-27 13:33:00 UTC,10000,,false,10000,0
75531e48b859fa1c526b2394a1b7099ed9b6fe9117f302313dd7398eff0abfb2,986819,2020-09-27 13:33:00 UTC,10000,,false,10000,0
f5ebb2a83587c75a154c3bdf8d10e5c01b68ca708c6be85d2415d7c3272cc5c1,986819,2020-09-27 13:33:00 UTC,132380030,132374030,false,6000,0
39ccd06989975e39e546c43208adaabe8c222f7dec4db81efd88d3fcce4417ff,986817,2020-09-27 13:31:36 UTC,214564058,214489683,false,74375,986805
b79f151cf1742176f0c93ae29a0b3d4ac190c3627247b02f6efad710ae318263,986817,2020-09-27 13:31:36 UTC,10000,,false,10000,0
db2d27b5e1b62fd4e0736e08a84ccf87ba7eb1e9e21bae3a4a566fe487e56395,986817,2020-09-27 13:31:36 UTC,40809449,40806489,false,2960,0
037af44f89d5866b38704f07c1df9c08965312e059c58dafbbb3143d5b2c3fe2,986817,2020-09-27 13:31:36 UTC,173506341,173490579,false,15762,0
4a2c7b841375d4c1c2e5f6222ca3087f40ab3db88b4bb3d78c341e8ac4092ea2,986817,2020-09-27 13:31:36 UTC,244086903,244083943,false,2960,0
e4564dee01a915d5be2b340c08de5bba6a5b03a378c5deb8f40ecef2208f4d9c,986817,2020-09-27 13:31:36 UTC,156464772,156441496,false,23276,986806
9671024eca08267f42c09e383223de76ec73ba4d00d32aa4ba6a1ff55a6d09c7,986817,2020-09-27 13:31:36 UTC,110786683,110778141,false,8542,0
8229348350cd815d3671e77dacebb010168ea8a70e606210f1b36db5235c0813,986817,2020-09-27 13:31:36 UTC,183094409,183092317,false,2092,986806
e3e4357e921540e0e5a839a841b7f50580dae07efaa16c556f5f6794808dbf8f,986817,2020-09-27 13:31:36 UTC,500112960,500102960,false,10000,0
d4143c7e0acf101cc7dd4af7be158727693fb4c8fa2aab80f9686141aaaff811,986816,2020-09-27 13:29:41 UTC,110855906,110847364,false,8542,0
0aa64f8f04f712cb4df6ce6256b2d31181d6522e44fbf96c06887a6f3172fab6,986816,2020-09-27 13:29:41 UTC,8564317,8544317,false,20000,0
4dc99bc831e86b70bd848e222ad3a37574c6393eccb60b474b86b007b9b9d87a,986812,2020-09-27 13:28:08 UTC,7087533,7086387,false,1146,0
5b3f0b11551bc944929fb72fd93022cc56e107bc4b8f45e7da5f7c3056bbcb17,986812,2020-09-27 13:28:08 UTC,50504094318,50504091700,false,2618,0
5099fa1566c5750b71236f08127996fd575a5de34af2692a9463a6c6ddb83106,986812,2020-09-27 13:28:08 UTC,44990000,44988854,false,1146,0
fb2294dcf286091a5eeb1cccffd643d951d07b6ba030d3eeb7e6b117928421d0,986812,2020-09-27 13:28:08 UTC,10000,,false,10000,0
747d04f3b717ef54591316ae044b8f24628aa4eae128c832563f66314eab3e4f,986811,2020-09-27 13:25:41 UTC,51007289,51003941,false,3348,986800
d9dc234d90abb08db05691445abe2c8f2285e740ed2b7e216742c93ff43ef280,986811,2020-09-27 13:25:41 UTC,244238700,244235740,false,2960,0
a8a6ebc8c525d54a6aa450d869de1b3bb8d40075d0deb1ea0d7fddcbebd80c47,986811,2020-09-27 13:25:41 UTC,110885254,110876712,false,8542,0
61ba18a9a383148bd881788d3517574286876b2995833cd1e3f4307fadfeb99a,986811,2020-09-27 13:25:41 UTC,66544078800,66544077218,false,1582,0
95c96afaf9dcecb63f8cee3925a65f76cdd3e0c887fd64662e8ba28cb24d27ab,986811,2020-09-27 13:25:41 UTC,10000,,false,10000,0
f4f89478ebb1a6f5ab99e8fdd7d070475f85384429ea7b214056f283af1d9982,986811,2020-09-27 13:25:41 UTC,739864,703864,false,36000,0
c43b26c57660fe9ab327ec7bb1852bd86e48a3c9f01a04858b8862a7c5781d4f,986811,2020-09-27 13:25:41 UTC,192063837,192061745,false,2092,986800
bc2a8fdc4ebaa3b44d9d3265ae045260ec6bfcfd0730e96f68220d52037bd80c,986811,2020-09-27 13:25:41 UTC,28271200,28266200,false,5000,0
65f571dcc85ac629420e787e97328f179c6615750c4be7e653440af58d9d9986,986811,2020-09-27 13:25:41 UTC,500000000,499990000,false,10000,0
b51d1d94d8ff63003ab0ca0e2c32750b19d96d4e45f6625f2b1b4b3292d4d714,986810,2020-09-27 13:21:58 UTC,32160,18750,false,13410,986717
356caf38fa3f1fed1b20eb457ba460210bb1a2f7884fb94d9f50fb4f3f1d9ec3,986810,2020-09-27 13:21:58 UTC,339330812,339327072,false,3740,0
3a07b5ef7de61704b3d1b9b169419c2ef3df9468d7713f0be127c1cea181b456,986810,2020-09-27 13:21:58 UTC,217045618,217043526,false,2092,986799
9d49645f583c5c2391d769923a9938343ef627790b5ff920854f11689a232df2,986810,2020-09-27 13:21:58 UTC,5338455,5328455,false,10000,1601209273
1b5dcafe3d9675d2968611e1c1e9afe4bfc67442dbcff51ceb27b8d1f3596650,986810,2020-09-27 13:21:58 UTC,144500000,144431664,false,68336,0
2a0d50962adec3fc3d153225a7dc2c02ebba2f40b47eed765234fe5ff9c41e67,986810,2020-09-27 13:21:58 UTC,464309876644,464309874552,false,2092,986799
b6716df35c8369718f018d0c517141fade2eaa0a9bc4c02c21633356d6c1d7a9,986810,2020-09-27 13:21:58 UTC,10000,,false,10000,0
0e716679fbe0874db6ea3ba0a994739d602adc92205a14bdf0a3bcf9d1217b70,986809,2020-09-27 13:20:29 UTC,394493428,394487428,false,6000,0
e6b1389dbb085e782f0af4b4299a82abd037b872205edc8d28eeff2f213cb39c,986808,2020-09-27 13:20:13 UTC,157213608,157191510,false,22098,986796
85366d70ef6b48e7b159efcff9d1c9c4ec6b1697a319cb958e95a86664233705,986808,2020-09-27 13:20:13 UTC,216401373,216330535,false,70838,986796
2d394d383af2be9f6bba2b8d6fe0dd64dd6c232cedfda90fb1f024ef4ba6586a,986807,2020-09-27 13:20:02 UTC,110920505,110911963,false,8542,0
19c252aee25931f7a973e007821436e3d0c78acdc82a03fb50692eb391b04f43,986807,2020-09-27 13:20:02 UTC,63485730070,63485717695,false,12375,0
1ea89da46ad52fdb5f8b78148a0b10f096205aee816285a2dd2ccce9c9d751d3,986807,2020-09-27 13:20:02 UTC,100000000,99994000,false,6000,0
5bea6b7c7027436312f71397950843030cf82bf101cf0d9334fbe409debf3170,986807,2020-09-27 13:20:02 UTC,10000,,false,10000,0
12543ecbfde68eef3164c22cf2fdd2fe64515dd255b2d98e766a6352345aa227,986807,2020-09-27 13:20:02 UTC,1728534,1728434,false,100,986796
3f4ae3cbc99a93f41715d355f5dd47a9957fbd51ae571ed18f4a078864e1f561,986807,2020-09-27 13:20:02 UTC,465589865102,465589862719,false,2383,986796
d86ed3531d40aba9c02e3b25343462d136e38fa8ec3feb2afff7d3eb352888a2,986807,2020-09-27 13:20:02 UTC,111019835,111011293,false,8542,0
cfc62aa648bdbb66f541cc6049252994b0b3a601faec06516589d3800e8658b1,986807,2020-09-27 13:20:02 UTC,10000,,false,10000,0
e540f78ded24be34e1af06ed4c3af7bec60779b95c5f05cc29fce83229cdf96d,986806,2020-09-27 13:18:33 UTC,40952625,40949665,false,2960,0
a8d9efc47ff5c98ce4340aaefb7cbaf57b949c8b73a5a913b883bf00efd3215b,986805,2020-09-27 13:17:55 UTC,100000000,99997550,false,2450,0
144bc13c9b486037b67f28a8934515ca94e12371c46d48e7de7a9ba75b4303be,986805,2020-09-27 13:17:55 UTC,499980000,499977908,false,2092,986793
f44c3fdb609beeb6afaeeadabd0d651cf7ebd258e52e5e795f826d2e87f19a1f,986805,2020-09-27 13:17:55 UTC,18241281343,18241271343,false,10000,0
e725190c8365bddf0dc4a1f7e07224d99d1369513647cf81f987837b171746e9,986804,2020-09-27 13:17:03 UTC,499980000,499970000,false,10000,0
ccf7026e16d7bc1e992bb02f43d5020add54ca065f9f4c4f11ca909001c3f251,986803,2020-09-27 13:16:37 UTC,132311361,132295781,false,15580,0
869a08cbfd2c214740ea7253830d1341acb3f7f7745f344bd460eb6d1fcd52c1,986803,2020-09-27 13:16:37 UTC,145069814,145054234,false,15580,0
00e5a9d0c6871d9cc34e9634fd430074bdceb1ecb0655b8266ed8101d9795539,986803,2020-09-27 13:16:37 UTC,112770064,112754484,false,15580,0
1d0a6bfbc06a180a7608e67e3b583fae5869244670e79fcf4903e4922c63ecfc,986803,2020-09-27 13:16:37 UTC,116847122,116831542,false,15580,0
fbbc480debf3f24aec9c8fa834ae3d8631fe0997d063a34a18d20456bc4c2c24,986803,2020-09-27 13:16:37 UTC,1286646,1283289,false,3357,986792
bffbd229224b1a8999a0d107a2f4ad9627b5a1364fefa0dbe634fd4a940f600c,986803,2020-09-27 13:16:37 UTC,3500000000,3499997464,false,2536,0
c9175a8473cd1ebc22300ecc7c94acdd6ca92406278e43760ce12528ebe7d460,986803,2020-09-27 13:16:37 UTC,105552065,105549615,false,2450,0
a5dd63881e1eb08e28e238566c7a7863390d5ed8841dd6ea2e7c3c8b0ccb4eeb,986803,2020-09-27 13:16:37 UTC,10000,,false,10000,0
c4b9861fa32f2558be334245f8fa43704b79a606791023e17c4f5d1f261ba798,986803,2020-09-27 13:16:37 UTC,123459565,123443985,false,15580,0
e50843bc8aadca18dbd03257c76a296fc427ce4b27e79f13c5d445fc8802947e,986803,2020-09-27 13:16:37 UTC,104901846,104886266,false,15580,0
e852ed2905dfe67f69ff732c007f6fc82b7d760f2afc3af66e677945510aa308,986802,2020-09-27 13:15:44 UTC,163434917,163419337,false,15580,0
795d451c0fae0aa37adceff643afba6650f3b0edfcf7a9e529d1d3fefc11703e,986802,2020-09-27 13:15:44 UTC,188094471,188078891,false,15580,0
dac221267c8b80d3949700df5cb2426623146b8a36a5765a13a96f48e686b5aa,986802,2020-09-27 13:15:44 UTC,354149,344183,false,9966,0
69e4154bab34b4928ce195af3386b81141a44ef069b14195b7a60bfd74d7f167,986802,2020-09-27 13:15:44 UTC,171300758,171285178,false,15580,0
25ccb480f7e6fbd2b47e66d9c1a3eff80edf089993a0991fa912374dc691806a,986802,2020-09-27 13:15:44 UTC,200160152,200144572,false,15580,0
1d203f832e049288cfefe4b46c457c18412c8bb60f45e9371bd6df0c74bd82f5,986802,2020-09-27 13:15:44 UTC,3563326219,3563320999,false,5220,0
368cb5b1afbdc26d49b8fbe72664fa93b6d901964fe8202ff87d89ae8af013f2,986801,2020-09-27 13:15:02 UTC,351883353,351867773,false,15580,0
aac6f6fb25a38f77664896dd60847ae0cb611d9188c7c9eb2e2dcacef2be8717,986801,2020-09-27 13:15:02 UTC,491111295,491095715,false,15580,0
76053c3fc797981bd5b5e61e354e67458b1f20d3640e35d932b43303ac99de1f,986801,2020-09-27 13:15:02 UTC,312969509,312953929,false,15580,0
574f663ba408a0ad7a8cba450e033f039ce1ceaf205f3fdfb9147ada3bf82731,986801,2020-09-27 13:15:02 UTC,219948854,219933274,false,15580,0
69f1d4c43003594c12541ea64165af4b95935acccff7a822238695c3c6e5fdcf,986801,2020-09-27 13:15:02 UTC,10000,,false,10000,0
29cf01058c3735a98023f2ed55488b45c254f8ce9e11e014c0a8c82b0505aa02,986801,2020-09-27 13:15:02 UTC,423637657,423622077,false,15580,0
78782a48a5752dbe33478463a3aa7ed79ea0c1cc8bf2b2dd0999e8f6e8ef603c,986801,2020-09-27 13:15:02 UTC,264153870,264138290,false,15580,0
16e94397beb478affc24d51b93faa85104311a17917e5e9a822530ecc6d5c874,986801,2020-09-27 13:15:02 UTC,376191748,376176168,false,15580,0
ed7e9f3cb5c32f29690764979c28690dc0713a33b72446e6c88f6aca4edff6c7,986801,2020-09-27 13:15:02 UTC,532081813,532066233,false,15580,0
7d11671270500b8391bf3ace5af1fb13903d602bec71713c9274503de744c476,986801,2020-09-27 13:15:02 UTC,1290002,1286646,false,3356,986790
21ed2a12b10edb0f96f07b3d2c204a6a866f3754e1b28d30788f306ec382627c,986801,2020-09-27 13:15:02 UTC,237484462,237468882,false,15580,0
eaf4e1406ce64deb58f97fff6845c2b2e502fa992c4bbc54ffc370eed01091b1,986801,2020-09-27 13:15:02 UTC,389993,289993,false,100000,0
4149b4f26556ff313bc2e2e051f20b2d200596b941d1622c5253f05dd53d8b50,986801,2020-09-27 13:15:02 UTC,238279014,238275274,false,3740,0
1a03e08d4fdd1ae04352c2c033236110c4e71a87fb54c579cbcb0032657e4793,986801,2020-09-27 13:15:02 UTC,582734048,582718468,false,15580,0
adf1b0b1d12536704753d8bb0f34a2343314fa67e06aa525f0028119f784d9e6,986801,2020-09-27 13:15:02 UTC,663517881,663502301,false,15580,0
5b1a7fb5a2d41f39c0eea6a5df7b5369cfd257ed7b909580e9f9027280b11e6b,986801,2020-09-27 13:15:02 UTC,244482049,244479089,false,2960,0
17cadaaac76fcb5394e885d0971c0cd8f625585dbb1eefb3271587e39d793888,986801,2020-09-27 13:15:02 UTC,810430113,810414533,false,15580,0
344f56429aff36a80d2c84824c387a815821095784ac6fdf1a2c1503dd261d09,986800,2020-09-27 13:13:08 UTC,9700609842,9700594262,false,15580,0
409fa336166b9b786c525e6800f9bd02a4bdb961b29dfe79cb717b560fb9a017,986800,2020-09-27 13:13:08 UTC,3765836,3762480,false,3356,986789
0d1e0789a7c443d2feeb8dadef753d2fffb4e32a716ae392c1687693f051fc68,986800,2020-09-27 13:13:08 UTC,1504949487,1504933907,false,15580,0
4ba1700fef15456dee0d2a7dd0b4736c66d2bad38e7f9ee07905073f985e50fe,986800,2020-09-27 13:13:08 UTC,1029570007,1029554427,false,15580,0
cf7413e2bfd7d2985afece3684e68b527217dc20a917702c4d9cc6ee180dbe9e,986800,2020-09-27 13:13:08 UTC,1286461404,1286445824,false,15580,0
796736c2b2d452b198333e768e77a27288ed258ee92dd7d336ebe95f7b2189ab,986800,2020-09-27 13:13:08 UTC,465805764131,465805762039,false,2092,986741
c75eb23a480a9d1f996d91bbbaa151f7f92cffe8e5372546759792efe250fe9d,986800,2020-09-27 13:13:08 UTC,3289898419,3289882839,false,15580,0
6bb0212edb916bc08830ba43a19dfd78a7a5e6c1f5af5ffcf64f55017e8b1d35,986800,2020-09-27 13:13:08 UTC,2458567641,2458552061,false,15580,0
d3d863d606f67dfd36aeb55069a168fa1618b5fcf3dccf67cc9bb567b25fb2af,986800,2020-09-27 13:13:08 UTC,10000,,false,10000,0
e78ee4676caa6a50996f81711c995cf8788f3d69fae946508dc1763275f9ae0b,986800,2020-09-27 13:13:08 UTC,1118547059,1118531479,false,15580,0
61c47277e663c9d4185fa840a321a36e754e65e9dee2ed991b36d1fa160555ec,986800,2020-09-27 13:13:08 UTC,1792585927,1792570347,false,15580,0
673dd90c0d876bcfd0ddcd96d7b057475694318184281782f331171b5803ea53,986800,2020-09-27 13:13:08 UTC,5020124869,5020109289,false,15580,0
95a7a2d833f6f3ca61ec47c127efd5f939631a57b72fb9ab1c5ee367d9254b51,986800,2020-09-27 13:13:08 UTC,934372222,934356642,false,15580,0
ede2faf84d3ae003133f980bec325fbf40346d64bb50e61cae4076c3f631a1fe,986800,2020-09-27 13:13:08 UTC,73074451433,73074435853,false,15580,0
0c4c11242c49946db0f0ca57d559e6a3119f36c2d15d37483544514f30d75a63,986798,2020-09-27 13:10:39 UTC,217816569,217752999,false,63570,986753
be2584f57905d4cc62296a8010e34da3b1bf423676cb8d8ab4dde1ddff450e8f,986798,2020-09-27 13:10:39 UTC,10000,,false,10000,0
108aa17db0041858e74bfa1c6ad4c3f2a75979cff42bbf4e9e82ca444bcf2ac9,986798,2020-09-27 13:10:39 UTC,41176781,41173821,false,2960,0
6eb851a622892596798cea5b93cc3f40da67b0891cf245f73da07ce4e173b1e1,986798,2020-09-27 13:10:39 UTC,157959947,157936092,false,23855,986787
55d1625a2277bf3e9184a0380379b5f3f619bc9f9a08f7adf995927203577d0a,986798,2020-09-27 13:10:39 UTC,5849569,5837381,false,12188,986787
bf2466b7588af77f2a720228b93204fe68b1cb9192078db979008035f8654a58,986798,2020-09-27 13:10:39 UTC,103715120,103691433,false,23687,0
386eb1ba305ea504e4a65edde51d0073f30de1b04ec5b2274b6bc1db474d3d0e,986798,2020-09-27 13:10:39 UTC,29212265,29202265,false,10000,1601212224
aced6bbb0ea6d16ead13c884a08a7d1831e9d738b27cae548d99a8546bfdc14c,986796,2020-09-27 13:07:42 UTC,499990000,499980000,false,10000,0
ef8c8e5da58b7ae9f483bcbf8a02607dc310c927cc29f0a8be1255cdd503d2b3,986796,2020-09-27 13:07:42 UTC,468068966133,468068963751,false,2382,986785
0f5450a57d1776ae475cc512ad041bb523deae50a92a2c1187594fa0d3c96296,986796,2020-09-27 13:07:42 UTC,397732234,397722234,false,10000,0
361f0bd07128958d6effaf9515bcf8acfeb7c25a6a38f3c165c1b3461d769103,986796,2020-09-27 13:07:42 UTC,10000,,false,10000,0
06f1204edc8a9ae3a4cfa4932eae3babc2095eccacac0f8dea7872d3dc90fa84,986795,2020-09-27 13:06:44 UTC,21420,18970,false,2450,0
15b4b3731aead9080e3701f47e8235a019f43d5a5d2061bfe786688d57da98a1,986795,2020-09-27 13:06:44 UTC,111133332,111124791,false,8541,0
f42f53003648c275d27dce60b65b0e2f36791c6353c25934de5b0aa7762cb879,986795,2020-09-27 13:06:44 UTC,468140738425,468140736333,false,2092,986783
fb45a4f89ace0c6ceb284db8c4770659696156b5905498163b66d6e40600c102,986795,2020-09-27 13:06:44 UTC,244635087,244632127,false,2960,0
c6186184d0bb8bc563c78c484c93ccfc82094405eb976a90c381804506906258,986794,2020-09-27 13:05:55 UTC,1500000000,1499990000,false,10000,0
d7b0588455555eef4d7a45ddee169955feb286b534d5af82c292cc64da2ac82c,986794,2020-09-27 13:05:55 UTC,2990237543,2990227543,false,10000,0
20158250397fca704a12c2836c0a9ec74ebe84433c35504f5cada78ea29a6e47,986794,2020-09-27 13:05:55 UTC,2076254826,2076254755,false,71,0
c5ac7a5bb900db2d821e0b38f80eaec511c71e40642997a1a4a2ae6de29a3630,986793,2020-09-27 13:05:20 UTC,3502306636,3502296636,false,10000,0
4b6a8b45b99d4e8426fe4e25e4fb4ccdd660035722ad6dd553d946794b6a3cfe,986793,2020-09-27 13:05:20 UTC,34125068467,34125066017,false,2450,0
3ec8ed9cf63509fe3bc49a9d30d64ca7295b00296fd591cf704677bbccc227d2,986793,2020-09-27 13:05:20 UTC,233820521144,233820511144,false,10000,0
623351354a5559ae913b286c5718ba6229df8a9282de6259d926d7b8c89bce89,986793,2020-09-27 13:05:20 UTC,2000177503,2000167503,false,10000,0
10edfcd9a0db4a1592365e92fe7123b8448d0600fbeff2ee88d1811f7f1be56a,986793,2020-09-27 13:05:20 UTC,951191741,951189680,false,2061,0
03f0141b20f7ba85ef40f891590c4686c66ebaaa25d340e122e7c661d1c469da,986793,2020-09-27 13:05:20 UTC,41369828,41366561,false,3267,0
ea42d5d45eab550cd072e73b4788fa3a4b90b064c6f58ceeb151e7bdaa54772e,986793,2020-09-27 13:05:20 UTC,499990000,499980000,false,10000,0
2d80300327fba8ca02a15fee4807ea1dae9f4ea9b0071fb8aa6a4239d14a57a0,986792,2020-09-27 13:02:58 UTC,4659515159,4659512486,false,2673,986781
991ccd7d5b031ae0af197f54ad2beb333767da4611b1bac8db5048a4dbb09604,986792,2020-09-27 13:02:58 UTC,1155669423,1155589423,false,80000,0
600e67e9cd5e2d57168905395deb574a9933f18dbde127cfacc7442bbbdd2fac,986792,2020-09-27 13:02:58 UTC,500000000,499990000,false,10000,0
346c477397807792e0d41741c7e10486d14508e7db6b0b76e5a3e3742a20887c,986792,2020-09-27 13:02:58 UTC,1230619712,1230615305,false,4407,986781
dc028ae2b449b0eb362713ae9666a1474f1946f9a1227ef6ebfb29814dd08631,986792,2020-09-27 13:02:58 UTC,2001836443,2001720403,false,116040,986791
89e688798745b9f27b8e969875d7b4144eb8a8b0a02cdc6f65b54c7f0c8e0461,986792,2020-09-27 13:02:58 UTC,10000,,false,10000,0
1f0abe30ca22099f9a96643454883d9d4fea7324ad7cd0f2d775fa29638df986,986791,2020-09-27 13:01:08 UTC,10000,,false,10000,0
93bdf66e1ac505f62ea818e92c7ddb5d22d133aa328a175502d8577f63c730b7,986791,2020-09-27 13:01:08 UTC,219169172,219107635,false,61537,986779
e701202153d634baca091efccbe46b0758d43c02d08677cbd8d14987746df98f,986791,2020-09-27 13:01:08 UTC,238469734,238467650,false,2084,986780
0fa35ce81b3322c474769e4df0c8e56a7f6f4a66f51cfd5176636f328a7e766f,986791,2020-09-27 13:01:08 UTC,10000,,false,10000,0
1c6650382ea11507a2ffefe82d909f5b8e2fc8a5a13898b886e695325abf1e73,986791,2020-09-27 13:01:08 UTC,158565438,158542438,false,23000,986779
530c0e65f87bd908fb32ec9de2dea29e294e132b6cc394c1cbc7c3748f5f73d4,986791,2020-09-27 13:01:08 UTC,100172462,100170012,false,2450,0
a396ddd5630640c3fc416c88e0acf232f7e3d59af99240d17f426060f6bfaed9,986789,2020-09-27 12:59:32 UTC,100058581,100056131,false,2450,0
7a1cf2188ce56c60fdbd2d1947d2f6861fa708d4710e0f1446fa00b3cd1b629b,986789,2020-09-27 12:59:32 UTC,202260008,202257558,false,2450,0
888cedcab5397fd259bf46476334806aebf01ca1f0db3937f6472d021f856e6d,986789,2020-09-27 12:59:32 UTC,169887088,169877088,false,10000,0
cbde3976b0b4f9ed7343ab33152514485e6333edb1606fcdd7c530f62c2413aa,986789,2020-09-27 12:59:32 UTC,10000,,false,10000,0
3297723b51847d320ebd41cda3aed609016084910240baca9c224f05d6afb683,986789,2020-09-27 12:59:32 UTC,500000000,499990000,false,10000,0
ce38f4a9843aced5a85da36f408cbef7face19963fe3a94c958d45413e2b82d5,986789,2020-09-27 12:59:32 UTC,4435380,4432930,false,2450,0
f770ac0b6e6f840483bebe2d2b5115cebc9a223aa89bbc5256a5371d3225e929,986786,2020-09-27 12:56:17 UTC,10000,,false,10000,0
74d720c162af1eecd813838b4585409166382061942c6c8fe83c85dc288c7c23,986786,2020-09-27 12:56:17 UTC,672589337,672573757,false,15580,0
64ad270984a2d972c8b9bfb23639bc6a645025097ed05506c23081aefcb9eacf,986784,2020-09-27 12:54:34 UTC,111180740,111172199,false,8541,0
c671001a4b5215e61797791026e5bc1475ef0b402047aa48fca622225df98245,986784,2020-09-27 12:54:34 UTC,10000,,false,10000,0
1d878b69e60a42edbeae9fbcc7634bda0e5048e9a9ab06c0b626e6f0fbacec02,986784,2020-09-27 12:54:34 UTC,10000,,false,10000,0
b78d0c94a4ec14f5a19f54186134e45e88053c0b6eff1f5be9dd2cb939236778,986784,2020-09-27 12:54:34 UTC,15587223,15583875,false,3348,986772
592a187a612dc97e0209815f03e0b7f6291f70e8a2acd4eb7ca24aaa6ab9c043,986784,2020-09-27 12:54:34 UTC,3357363084,3357359979,false,3105,0
e98bde72f562d9946ac94e4d8a283c2bde40ccbdee88e70a19f60668d5708260,986784,2020-09-27 12:54:34 UTC,244792022,244789062,false,2960,0
eb8f33bec7c855d4db32a4066ef0e48103f4f04622a7cde8038e1cb79dc0fa2a,986784,2020-09-27 12:54:34 UTC,10436057,10420817,false,15240,0
006489ac60752421655eb325fab876c1ec5b8cfa4bb52e8d3f11148cc1abf8dd,986784,2020-09-27 12:54:34 UTC,1215163,1170323,false,44840,0
3baa6a04b6ea97a6234e3a4ebdc2011cbcf566d4912de93bb1c87fb215368027,986784,2020-09-27 12:54:34 UTC,10000,,false,10000,0
0731a6ed3e4023845d68e5f396ac75d7d7f7a6813eeeaa96b74d9a88a2ab4ca9,986783,2020-09-27 12:50:38 UTC,159148392,159124247,false,24145,986772
8553ed2a198c728016afe3defbe150cb3b05308433e035ae23126b2e3b7fa2e8,986783,2020-09-27 12:50:38 UTC,10000,,false,10000,0
cd9f7ea56efe72238c76b591a09b2e2b857f6f0104f2cc010536831d354c84f0,986783,2020-09-27 12:50:38 UTC,220758775,220695444,false,63331,986772
94adbaf3b2bc6928fda7ad95b70bb9fed6f247abb2078d9a9e3c8f28289568d8,986783,2020-09-27 12:50:38 UTC,194702,192252,false,2450,0
cff4ddb322147671b4323d6eefcc1fb9aa84729503806fa251c949a5f812a67a,986783,2020-09-27 12:50:38 UTC,487440240517,487440238425,false,2092,986772
89e1d6e3d9ca3d2ed3be7a4c7202d4cae68d99d9f0f3513b8baebf481f7fc348,986783,2020-09-27 12:50:38 UTC,103797307,103795607,false,1700,0
1c86e3b248edffd3635c0cef5d7486dcc042bf1db93e9c72deedca76b5b5b948,986782,2020-09-27 12:46:35 UTC,10000,,false,10000,0
4518509fa219b5f2b43efc147b31a8a9b756e60a3e17073ae06d444a29c6b33d,986782,2020-09-27 12:46:35 UTC,4347365145,4347363084,false,2061,0
8c5e98eec7161a1b5ef94f0e30b625482505578b1a934f83423d5a1705362107,986782,2020-09-27 12:46:35 UTC,41520916,41517956,false,2960,0
71f0a93a6f7638fc7cf45d3bcf8b1945ae637b6263299ebc2af8997599b12d93,986781,2020-09-27 12:45:12 UTC,17989821730,17989811730,false,10000,0
096244c7f42a740411464acd3a37f0052e32765403fab317201b5487b6600571,986780,2020-09-27 12:44:32 UTC,10000,,false,10000,0
42309de26abcdcf076d27e3aceb7329de7e75d94c6fc8584ff9a01f38414acc4,986780,2020-09-27 12:44:32 UTC,18554293848,18554283848,false,10000,0
47bc3218fe778ba9db1a2c19316cc8bf66016e8471c3527e2ef8e545e9115f40,986780,2020-09-27 12:44:32 UTC,286030000,285950000,false,80000,0
1b0d8bdb26add6a43cadf4710acfe360439b38a44d77112ab28dbd3e842a230f,986780,2020-09-27 12:44:32 UTC,111359609,111351068,false,8541,0
52380df23b00011cf6fdfe0789435a3c48ad092dcd28549ca39038d7499e41d8,986778,2020-09-27 12:41:53 UTC,1009899214,1009898068,false,1146,0
5324875f661657885f4d973fd15965ec268b51d1d36d182ff29bc3991b45002f,986778,2020-09-27 12:41:53 UTC,4367367206,4367365145,false,2061,0
2dca6e2a18145563112400e77de14395a626640525ff7d18bce5952b1525f136,986777,2020-09-27 12:41:34 UTC,10000,,false,10000,0
646a4cd870b94855456c4dade1875c85f91189a8bb89b04a5d02bfd0e6e0ca30,986777,2020-09-27 12:41:34 UTC,221968271,221908758,false,59513,986766
1aa84c219c6e5084b06bd85c49019ced47de1359be78ceea387f9f0db93fc341,986777,2020-09-27 12:41:34 UTC,10000,,false,10000,0
5a5d5ede87360b946b7eee043213147cc0b8ac6203ebb90873a7118cf662a3aa,986777,2020-09-27 12:41:34 UTC,318158051,318142471,false,15580,0
dfeb2045284a4ec04b967615e4d17067268d417e56285d20e2e87306698648e6,986777,2020-09-27 12:41:34 UTC,1999900497908,1999900495824,false,2084,986766
97b6cc61b16598000278c7fab4afa8fd2058a6c7e82de8c3f70f6e9f22f4dd98,986777,2020-09-27 12:41:34 UTC,9577,7127,false,2450,0
0b51c0d0cf4ded6f0b95acfefb7a88f156e4b38fbe8d2f03b212cab22d61a0cd,986777,2020-09-27 12:41:34 UTC,125816569,125800989,false,15580,0
a5a01517368cc06a978b9991db32e18adaacba7b30df037ab7e7cd2f259a8fab,986777,2020-09-27 12:41:34 UTC,2180229920,2180129920,false,100000,0
abcef121c333dfea425a707efbc493b76f5bad1e586ac2fc8bf54a1ca2190f41,986777,2020-09-27 12:41:34 UTC,10440000,10432380,false,7620,0
51345c46bb81eb81a0225602203a168c77b0177b3fbaeb56335b8f1f987eaf83,986777,2020-09-27 12:41:34 UTC,23598286266,23598256266,false,30000,0
aeb1a01957fe8bc1903057301223570ab4f261955a5b66b91aeb2a1fae589e31,986777,2020-09-27 12:41:34 UTC,2864702468,2864686888,false,15580,0
93d20d0b5de0244afadc52a855cbecc6577bb8d6392d0439621df141f365962b,986777,2020-09-27 12:41:34 UTC,710051925,710039669,false,12256,986766
b704bece136066e75800d1083ad837972280b06f127145ec77d144cd378ca450,986777,2020-09-27 12:41:34 UTC,487539742601,487539740517,false,2084,986766
2508883c324f2f68c1df7097d0c3fa27421985de0ac8887b54d372762fd723ec,986777,2020-09-27 12:41:34 UTC,1552898763,1552896679,false,2084,986766
6319d35e175792e0ab594a71de6226725a571fc8bebdf0852e3fd36d7886fe56,986777,2020-09-27 12:41:34 UTC,10000,,false,10000,0
91c7c5b7ba00ca9ebb547269a2cdef482a983cb96a1abd99b3eaf11d6ef39bc0,986777,2020-09-27 12:41:34 UTC,10000,,false,10000,0
3cf67faac151d857f5940c800f1cf195077e5fbe603851a22bb8cfee768785e7,986777,2020-09-27 12:41:34 UTC,470490028,470474448,false,15580,0
07d0e21c3573c81fc034c1bcf33db883f7980ef8e6d14826f57f8b46fe896b2a,986777,2020-09-27 12:41:34 UTC,250394857,250379277,false,15580,0
a6947b2c9cb040823080a3f10f50b964549ecb154b9bbd2b37d73af63e58fc72,986777,2020-09-27 12:41:34 UTC,244990374,244987414,false,2960,0
b4faf102720b0c17ba9c25de97e5bf6b668a2bbba5aa6bc0b753faaa5859d1c8,986777,2020-09-27 12:41:34 UTC,159526768,159509610,false,17158,986766
a35687b37b16efe2355aae895bf32b907bb2db1f64f0130e1a2d0b251bc4e14e,986777,2020-09-27 12:41:34 UTC,2195978269,2195962689,false,15580,0
6f2acdd47f1ff5884c4a875566ccea2247184d632b49651af97e243aa2fde6ef,986776,2020-09-27 12:38:22 UTC,44002675,43987095,false,15580,0
e1971666c2ef835b0d61939132d682d761a867ae2a5b7442f444a8551a531d09,986775,2020-09-27 12:38:14 UTC,259706555,259690975,false,15580,0
266a70df0067e946de178e7036358c7a1373f15de4d9716c2974709f79908b80,986775,2020-09-27 12:38:14 UTC,41277551,41261971,false,15580,0
61031fc22ac0487f0f96164f2a6bb5c84113a9fea74b09241f6a9123f0501068,986775,2020-09-27 12:38:14 UTC,1295810654,1295795074,false,15580,0
958b6e7136b80f809b4f2564991509ddffc94712a72b1758abc39ddc9776a150,986775,2020-09-27 12:38:14 UTC,27156119,27140539,false,15580,0
b4c98add55eba7a5845d72de33f5ebf918ed29f0a389fe2f99fcff6b3199c9a4,986775,2020-09-27 12:38:14 UTC,1315645425,1315629845,false,15580,0
b91b8a72e3b2f31f57c32090c42e927d2813702aa467a92ab3c443893e11bb1e,986774,2020-09-27 12:37:26 UTC,382221058,382208973,false,12085,0
06f2c5a9b513323ace41a68dfd77b2694f7aaff88bfd781b44374280f5a07db3,986774,2020-09-27 12:37:26 UTC,1546507800,1546506654,false,1146,0
1507931c92b4460e3c8149a6678166fa7ca6aa8206d771c9f2db3040d99fddb6,986774,2020-09-27 12:37:26 UTC,720651928,720636348,false,15580,0
2b3644f954d9e16b0ce3212efc85ca090b98116cb74018c134af67cb75c7cabe,986774,2020-09-27 12:37:26 UTC,41691846,41688886,false,2960,0
673f8d7d409fc36d939b6810892ff285c24de4c2d6fe2248d96f2030b3910c9a,986774,2020-09-27 12:37:26 UTC,1639115139,1639099559,false,15580,0
7da540e7d4ada557e9cac41834ce41c976f4e9168c8998cf444d76e256f209ce,986774,2020-09-27 12:37:26 UTC,1812838288,1812822708,false,15580,0
39b49dcca00b8d7337fc87e1b9ac4ec8aa5ecad8683410efff63272a421f2cc1,986773,2020-09-27 12:36:47 UTC,1190211371,1190195791,false,15580,0
211ae09d57555874ddb373fce9fca3db03ee8e72b3339d05c3c893e28141a5b1,986773,2020-09-27 12:36:47 UTC,487725344693,487725342601,false,2092,986761
2ccffc408043f44f0a6e8e87bf50dbcbf091d13681e93b01171e60c1b3c0b0ea,986773,2020-09-27 12:36:47 UTC,10000,,false,10000,0
98211331ac2701ac105599997877de59f724df231299da5d711bd02ee4eda3c9,986773,2020-09-27 12:36:47 UTC,698496596,698481016,false,15580,0
2c7c9a320027046e2a1caf120f0bc9f7e5129405e1ca66cf92a0a52e63979491,986773,2020-09-27 12:36:47 UTC,7549646731,7549631151,false,15580,0
475ed58b20ca0e5dab812b2535f7ab50d6c191dd6234b7700da45a6965c5a1b3,986772,2020-09-27 12:36:17 UTC,464280156,464264576,false,15580,0
117dd8ab5a8310964fbcaa1c1af92b3f176ef13b8e8939c646a2f5002c0b2160,986771,2020-09-27 12:36:06 UTC,6187938548,6187922968,false,15580,0
34ccb39d215cfabaa4ef57d08a656a6bc39138994756d83c019770e8e544bb0e,986771,2020-09-27 12:36:06 UTC,118260,97100,false,21160,0
5205ebabbbb6a8cb6515a9864388191746f3f67ee94432b8bfc7629c24aab3d0,986770,2020-09-27 12:35:39 UTC,1000064716,1000054716,false,10000,0
1b4210ca7fd38d1e62f88fac38a5a0658f1ea0635a9d1334a4bcaa50a3768058,986770,2020-09-27 12:35:39 UTC,65968668168,65968668068,false,100,986758
3daa37a7b4753aa6e2fb94eb88525b30d22800c1a0e02310d512ad48e18e429a,986769,2020-09-27 12:34:58 UTC,2000000000000,1999999997908,false,2092,986757
d9ddd70aaa5b2b75091b42b347f22e3cd42e47349a8b8aca0f84ede17b0f5539,986769,2020-09-27 12:34:58 UTC,84835,83689,false,1146,0
2c787c586d67e78c11d7b55ead632878c12e0805c002c09e5d89c8286fa6eb6c,986769,2020-09-27 12:34:58 UTC,45460488,45454548,false,5940,0
b76947010ae0445b4d2ab33ddac42c9306364cec7397d6ac3199c1456db06648,986769,2020-09-27 12:34:58 UTC,272392413,272390329,false,2084,986757
dbe38199d63de6f781d3313c726369643f993f5cd113f8bd4c2bf45d3c48ea70,986768,2020-09-27 12:34:01 UTC,8288776,8277861,false,10915,986757
8ffd3462464355ecf2218fef6a43704cecb477786688d71a051724d8b045d23e,986768,2020-09-27 12:34:01 UTC,10000,,false,10000,0
364f697ad75270db792eb5d6a0b0fbe1e0b7e0ac4a3752727969a87cb63be5e1,986768,2020-09-27 12:34:01 UTC,127125125,127098640,false,26485,0
2cfcda87fa7d1721fa4b49eedbe5c24ad2a44088b9228ac164fb4ab12591029c,986768,2020-09-27 12:34:01 UTC,487903346785,487903344693,false,2092,986675
0a0a851549f6e5ca54b8cff2123a0d06f21e8e2b82790a4336a2c75b6bf56988,986768,2020-09-27 12:34:01 UTC,111562852,111554311,false,8541,0
b192d8c4fd99c82eca768530b21d553f02c726d656bc901b1535fba9d10ec37e,986768,2020-09-27 12:34:01 UTC,499998796,499988796,false,10000,0
16307522c1c3a2e3cae304c95faae513cc5a8fca7d630864c59f66e23bd1b21c,986768,2020-09-27 12:34:01 UTC,223236311,223182273,false,54038,986757
561d83b7d5e85a7b0139cc0ba31b2b8f765ed09e581f3ec4695b248d3b98e9fd,986768,2020-09-27 12:34:01 UTC,160315103,160294426,false,20677,986757
3d570aa62785e6106dac5729b7cc677f331b60fde898bedf8bc3c39fdb083d94,986768,2020-09-27 12:34:01 UTC,111691595,111683054,false,8541,0
a8214f2152f19b2bba47d87c3b38d03ee0e2fbaa13a918118c88b8aa0c7f8a56,986768,2020-09-27 12:34:01 UTC,245242909,245239336,false,3573,0
48eb7104b936d08c2e349afd9da0a19eadcc5796235ae55d1e5ea0ae21606a22,986768,2020-09-27 12:34:01 UTC,111647655,111639114,false,8541,0
e7d66a5733c5c6bde1bbd0c33e168cf5bc7c98acca45e4cb591ee422bcd2e4bb,986768,2020-09-27 12:34:01 UTC,105932906,105906146,false,26760,0
031a07eafb9ca27c9b678d04810e9a24138d4d63c57d92771d2c25941ff0c875,986768,2020-09-27 12:34:01 UTC,39531338804,39531336964,false,1840,0
d212d6428637b8f2723da0a811d69f4e0ead14e44f2be00c58bc13088442d5dc,986768,2020-09-27 12:34:01 UTC,101777654825,101777652135,false,2690,0
b3dd15644c7bce432e8955ac5af245039bb7c757d1d423ed114583b630a3a68b,986768,2020-09-27 12:34:01 UTC,10000,,false,10000,0
bccef89189710842eebb6558b6fa988360ef560dbd9b0d087e25b978b21720b6,986768,2020-09-27 12:34:01 UTC,10000,,false,10000,0
bcd5ec9ff416176b45580e9db79981c5167a040e22e3d56f100a190ceba85309,986767,2020-09-27 12:28:40 UTC,500008796,499998796,false,10000,0
c0044f6ffdf793907bcc046910aac3fb388e45af23f06026d9a3bc0017568aa9,986767,2020-09-27 12:28:40 UTC,121147997,121147805,false,192,0
968d1d9b16e9a677db9ea5fc283e42a698a0b7f9adb6396868b5e25ea7a6d8a3,986767,2020-09-27 12:28:40 UTC,999500000,999498080,false,1920,0
a7596d48c174fa6cc09671f00ff65d43300d882b87ca1cf2b8b98129af29c0ce,986767,2020-09-27 12:28:40 UTC,10000,,false,10000,0
71e1bc42a408a0f53765a77f121f0714de9da0a90d5860ed9805bd12e064487e,986767,2020-09-27 12:28:40 UTC,255191047,255123667,false,67380,0
a51ae6edb0034f31554c592908f2d5922b8bf0afac85044e0098c43128ac2884,986767,2020-09-27 12:28:40 UTC,17042,7408,false,9634,986756
5c68d8265e99468f4a789744449861c825403833ef6257dfdeff8f680e036d47,986767,2020-09-27 12:28:40 UTC,731079423,730999423,false,80000,0
4e6a9c7ab63d4e49ca2cc69968aee81086213d183e787ada77ac01202a590598,986766,2020-09-27 12:26:10 UTC,42003586,42000319,false,3267,0
73cd957b3641782fb790a5dfeddead9d37ed5e87df822884c63efb8b7cf7fde9,986766,2020-09-27 12:26:10 UTC,6135126,6132216,false,2910,0
85fa0feb3b910b6e51c0670e90d33c17ed8872d442a473a05b0d70a192c908e9,986766,2020-09-27 12:26:10 UTC,39102,36652,false,2450,0
72e76afddcd5b9f0c60ca20ce8a8ee042834a30703767bdb6c2193bd56fb20d2,986766,2020-09-27 12:26:10 UTC,38773159,38764755,false,8404,986754
64ce06e642b5c45c4ec30107418f501d023aff644be21870ce586f5bd77a1c8f,986766,2020-09-27 12:26:10 UTC,10000,,false,10000,0
c49b1cf1168a956d6a8681d5d9d144deba37c10e4710ee94eeaef34c4be92433,986766,2020-09-27 12:26:10 UTC,1508010000,1508000000,false,10000,0
2edfd9aea51329d9037efad18ab01ec0289d25a199ec2687d3e289af5aaf7d27,986766,2020-09-27 12:26:10 UTC,397737114,397732234,false,4880,0
4a3cfe55be19b86a538719a681275492cd7957277e66a9b1fd4352e314269439,986766,2020-09-27 12:26:10 UTC,491512696600,491512694218,false,2382,986755
c0e81b371423a2bbb4c9a85f01afe579b975d5e8ebc04b03cf6479b84b87f9dc,986765,2020-09-27 12:25:08 UTC,525472715792,525472713700,false,2092,986753
3e0372ad60f956e3047964c3f0121289217487292a66cd88d7849f2100cc210b,986765,2020-09-27 12:25:08 UTC,3346701681,3346698281,false,3400,0
a781fce3a617c8265dc28fdb466d1082439746509730a7700a51252e731d4199,986765,2020-09-27 12:25:08 UTC,10000,,false,10000,0
00afc86d98dc87cf355b9e94d10ffad7cc613129c992d7a44bc55e78d4cb6e15,986764,2020-09-27 12:23:37 UTC,10000,,false,10000,0
c1963ceac688da4fc83150a6a4e7ff2390c0663a0e34d2f50d7fe369edf3425f,986764,2020-09-27 12:23:37 UTC,10000,,false,10000,0
7e616d1d2f3ba6dedb9444ec683dfd0c8eb818e5f3ae24f6e2363faf1078278f,986764,2020-09-27 12:23:37 UTC,27339000,27335600,false,3400,0
c9b8b3fd6aff73da34151378f72fcadb03efbfcfeb0fd885b2f9aa23e94ce0a1,986764,2020-09-27 12:23:37 UTC,499996831,499986831,false,10000,0
d222b1b95ac0d4f732b805479c6fff16029da566837fc2a38f54677fe56b1725,986763,2020-09-27 12:21:37 UTC,10000,,false,10000,0
7ba29b6e44b0f2c19da069de1eca61aae39a4455086f5930ef294a028f0f679b,986763,2020-09-27 12:21:37 UTC,10000,,false,10000,0
037d0cd66e451f98487b7a352292295a0127d5bc56b13775fff1e797745d5d82,986763,2020-09-27 12:21:37 UTC,4052613,4041393,false,11220,0
2a016b3deed2d3b3ef6657cbf606c036d6cc0dde8e8017fe1b4d6586f6315787,986763,2020-09-27 12:21:37 UTC,10000,,false,10000,0
05f738ba5b1c9f8feec5973c9c5c129400ef8a7f6aae5420895478258e200f57,986763,2020-09-27 12:21:37 UTC,160876494,160855253,false,21241,986684
5cc45db4a1a9d0a34b75d7a9b79110ab614553a8d985bea9ea2d53f2b35bd3b8,986763,2020-09-27 12:21:37 UTC,245461762,245458802,false,2960,0
ae02ec026b1892d10a6b46a676c2759b2468b655ba68738b32b7a46b439e24b9,986763,2020-09-27 12:21:37 UTC,17274844675,17274843859,false,816,0
ba3ef3be70dae67cb3b84b70d84489e2c6f19d01e65489ec70ce37d547d047c4,986763,2020-09-27 12:21:37 UTC,41432009,41391209,false,40800,986752
0cd5126d6ef93b35652bcc4c4cd0d58a00a79a8f9be59d9697e96ae9a0b541b4,986763,2020-09-27 12:21:37 UTC,14609843,14606212,false,3631,986737
0bfe0d01049737a49521b550b09695a26c21a24f5c830d5d3009a080a39a4356,986763,2020-09-27 12:21:37 UTC,18054315052,18054305052,false,10000,0
e62f4cf595ef1d37c7b6513732dca147708452c895f991f31845365afe90a0f3,986763,2020-09-27 12:21:37 UTC,51384800,51374800,false,10000,0
88490fa85df86d6bdec5ab76043701bbd8597d5e9a5d59a118df8e92a56db43b,986763,2020-09-27 12:21:37 UTC,224507998,224451722,false,56276,986752
0f816292a043f35fe1a95824b56090986d30fee55663cc3fcfa9c7c03bb11842,986762,2020-09-27 12:17:27 UTC,111722076,111713535,false,8541,0
38863b1c5bdd02fe5962747970573eac8158b27a2c38bd69b6fd523b9974c810,986761,2020-09-27 12:17:11 UTC,18588410415,18588400415,false,10000,0
1c034347b1e8ab89e1d5e28f05c14406f7bc8ce81cf701baab2b5973c70191d5,986761,2020-09-27 12:17:11 UTC,293874756,293872664,false,2092,986750
87ca1d96541ad42f6b05f6e9abac2ff755d12e6880d953cf0ad3fa78dd744f9a,986761,2020-09-27 12:17:11 UTC,10000,,false,10000,0
df4e26562c9a3e7cf46ab407d4332bab991a22baae594b0a3e9b099d859ca939,986761,2020-09-27 12:17:11 UTC,42204207,42200940,false,3267,0
56c3e7f200fa1e8780a79c083bd82815b7132e9963b8e5990b4e48723a0fb397,986761,2020-09-27 12:17:11 UTC,10000,,false,10000,0
42716cfc607197775225d5e50589c28fc385e9a0f11b12d8f2dfb6d68829dfef,986760,2020-09-27 12:14:44 UTC,529237321884,529237319792,false,2092,986749
7ba8a023e07c73399fc9a25055ca9a165be9fa201746cb8a63b88079d0f47b80,986760,2020-09-27 12:14:44 UTC,245687022,245683755,false,3267,0
3f392e025b5f9f93419f0dc9fcbce712fc771193c9d5edea2b9eacac3fe93246,986760,2020-09-27 12:14:44 UTC,10000,,false,10000,0
a083c9293100abb50d50f9a2e9684145be40b5bfa7d5b42ba8db9f1bf861a46a,986758,2020-09-27 12:12:42 UTC,3565230259,3565210579,false,19680,0
63a46924a911672fc0499385a06efd19f62712b976ed28f51338e929ea313ba7,986758,2020-09-27 12:12:42 UTC,42507900,42504021,false,3879,0
c9c706ac802155264d1b4422b635ee6556b9133078ec86d0985a1742a504d087,986758,2020-09-27 12:12:42 UTC,440085997,440075997,false,10000,0
d4514fffc0931343a7f411b658384c69e8e8e9d2621b028ddac5fcb8c0dc0ab2,986758,2020-09-27 12:12:42 UTC,11501009706,11501000064,false,9642,986745
1d33df355095e076d9278f7891f03a5c5699818f8a6004036114ad21056292b9,986756,2020-09-27 12:11:17 UTC,10000,,false,10000,0
908e395712dacfef9cc5f9658e5baf66a6e56b86f6aa8076ae2fb3f4b88ad7ae,986755,2020-09-27 12:10:27 UTC,225754702,225695744,false,58958,986677
21dc44c546c72a32fce8fb73f0e2795f8baeab60908808471a7119c7686acd93,986755,2020-09-27 12:10:27 UTC,161351214,161330554,false,20660,986658
9a8407053b97114d17ab682394262e0b307735a62739cee90e3d2c15c4db21f5,986755,2020-09-27 12:10:27 UTC,3427973811,3427966811,false,7000,0
441e3bc403486e0f3361331c582b3c499e8a209050f073e27216dab12780599f,986754,2020-09-27 12:10:05 UTC,43012,37012,false,6000,0
8223680f8a13052d0c4f7f4312e97040cf7d077e8b2b68c2e54dfca0c17ea5f1,986754,2020-09-27 12:10:05 UTC,22773692,22763692,false,10000,0
e95b730b8c71cc0b3521631d5bbe6c6b21caceb0d895d10eb1f059696df47b70,986754,2020-09-27 12:10:05 UTC,10000,,false,10000,0
5b776691cd78d83d6e59ddc386ac2a21259ff86cc4fa47b7b9a55abc90884418,986754,2020-09-27 12:10:05 UTC,144500000,144420000,false,80000,0
427fff53fe355f9c702c3017a43d8c4cbc6375438128a8d0c97c28768824bf56,986754,2020-09-27 12:10:05 UTC,16918607,16918507,false,100,986743
2333ffa4bb2446aa491d89791f6c72dd15e76490114686427c885d269a06ef97,986754,2020-09-27 12:10:05 UTC,51010,45010,false,6000,0
e14244b2718208c164496e71e2f790a88a55a3ff47ff4ce66a71e03955147cd0,986754,2020-09-27 12:10:05 UTC,534373550221,534373548146,false,2075,986743
fe4c6129469d6b6c7fd4a0b245fb8337276f88bbf46f9150d5e203e6d6918dec,986753,2020-09-27 12:08:35 UTC,10000,,false,10000,0
b81599dc94753015a5aa8fd27729a8e1d4888f6dc12dc2202421b2c95e753e53,986753,2020-09-27 12:08:35 UTC,2195229920,2195129920,false,100000,0
200d01ad94b1be544d0ffbebe486855eb3acfc16fede09797c5f5f35940dc0f1,986753,2020-09-27 12:08:35 UTC,50332,44332,false,6000,0
2ac7420f3238f6f132a8adb4cec1eebd7c58d4c3ba8a42c3830b8f0f49a324ef,986753,2020-09-27 12:08:35 UTC,141177912929,141177910579,false,2350,0
ef89111d01195abad52d9083861b0fe521eb0e8c2f5c85816f92a1b0acef73ce,986753,2020-09-27 12:08:35 UTC,43154,31154,false,12000,0
b0a8fac7eac0a744dddb5c65876da201f5215aaf528e90933845207266492aac,986753,2020-09-27 12:08:35 UTC,106797000,106787000,false,10000,0
0c7146326f0d60881398f90e521be626acaf6b6234a527b534dc46cb0d18f56c,986753,2020-09-27 12:08:35 UTC,218369257,218003737,false,365520,986752
3f36e80de5296e0028cd703cb57fef1109385fd266eab2f92ba8044121e9d233,986753,2020-09-27 12:08:35 UTC,51456,45456,false,6000,0
25c10f15df2cfe5dd070baf9eac6b3102bb7df5a2a60e036634451ca567b76fa,986753,2020-09-27 12:08:35 UTC,42590,30590,false,12000,0
fea0241d40a425dfcc0020b5990fd9b49eba8e295355cc66c4be29342f5743e9,986753,2020-09-27 12:08:35 UTC,1000124276,1000114276,false,10000,0
6a182915d2ba1c1098ade01fc6e93b77d82c40201254a38f3e4a70465d5ba31b,986753,2020-09-27 12:08:35 UTC,245944451,245940878,false,3573,0
6f8e76281f7ead2ff66b714382447aef0d3b2236e80f9396acae9c10ed04c14c,986753,2020-09-27 12:08:35 UTC,13500994431,13500984431,false,10000,0
776c022216a9730d03db9485d3f27a9fba99eb2fe83d92a0fe53b99f9b833753,986752,2020-09-27 12:06:11 UTC,57733054,57723054,false,10000,0
877ab9c117aa84657c6c057e6dee1a44a033467bb2d4f680a0d2c424194421d0,986752,2020-09-27 12:06:11 UTC,111745400,111745124,false,276,0
f617abb63a635c0d59ad58c2872c5ec27ab2a5e93c939d09e337eaf9ca360eac,986752,2020-09-27 12:06:11 UTC,299203754,299201304,false,2450,0
ec3acd53a4f94fc03d3b80a9c647ead6fa4d8ffc823287618a9cb40b78947798,986752,2020-09-27 12:06:11 UTC,2208329920,2208229920,false,100000,0
da0b5744bd9db50fc869022860a9599b635cc7312bbe44574d083efdb5ecd71c,986752,2020-09-27 12:06:11 UTC,3502316636,3502306636,false,10000,0
3839a5e5c10c7504a39740962e6f255c491a0610417db7c4555c3cbb7b336e6c,986752,2020-09-27 12:06:11 UTC,352316426,352312686,false,3740,0
ec46ed3370d1ce445fcea6535338198afe4d8986cc58febeeac43a3d0e9ecbc9,986752,2020-09-27 12:06:11 UTC,6352281581,6352281120,false,461,986741
93f9ffa090213ddecd35d1fc9a7bc5c248b4d227c6657336334dced2dffb874e,986752,2020-09-27 12:06:11 UTC,328582505,328582260,false,245,986741
d9d4d698250ec54b25a72f82ac11b798be0e806148e03b2d2774390756b5c465,986752,2020-09-27 12:06:11 UTC,233162517798,233162507798,false,10000,0
89cfd2be36e9a608984489c7c27d0a4f3d66cbad1cb058dcffe0411060bfa2c9,986752,2020-09-27 12:06:11 UTC,10000,,false,10000,0
278144696f5a2a264b7cb2253e0bbbd94ca51a6a4f5c4d809a245e74e7bc02c2,986752,2020-09-27 12:06:11 UTC,226894661,226887554,false,7107,986741
fd776bbb16e2e8f105bc9d42bfd67299c864bb23dfc8f05b74387bc359485086,986752,2020-09-27 12:06:11 UTC,10000,,false,10000,0
f107ce60f2c599b8584058ec98e447c21d2a8328fd57c1c52edd7a90f1aadba0,986752,2020-09-27 12:06:11 UTC,500018540,500008540,false,10000,0
17f09ff038d77148cdc69302804da384b2410c3ceebcaca34e1500775c3cbaca,986752,2020-09-27 12:06:11 UTC,500831695,500827955,false,3740,0
7666db635104b81a10d3040867ca541f54966ddefbb617e911ec6c27adda8beb,986752,2020-09-27 12:06:11 UTC,10000,,false,10000,0
9e84f82ef7469a9f74a4b1c910419c82194efa5e75601b5217706ae79241da89,986752,2020-09-27 12:06:11 UTC,101001453,101000031,false,1422,986741
ae4c892fe2195b9d9268d1702280c0390a1c05531a6caa1228fa9f3c2c4223f9,986752,2020-09-27 12:06:11 UTC,2000183236,2000173236,false,10000,0
8321f7c9b942993674976e6ec781b1234a2353661217a7ad75ce94ba27c3b90a,986752,2020-09-27 12:06:11 UTC,161750100,161748224,false,1876,986741
a31477796e4d402b7cb46135ac7a20c14d4923c529086416206cdac88f34f69e,986752,2020-09-27 12:06:11 UTC,4702222695,4702222382,false,313,986741
e36dc56558c3d2debd8a45fa7102ddac251c65436865f78025f0b6a44a434807,986752,2020-09-27 12:06:11 UTC,10000,,false,10000,0
88cc6b8cbce8ad612ce03ba8b2d7729039defedcbadd74e7452b28fc3541081a,986752,2020-09-27 12:06:11 UTC,210224,166864,false,43360,0
9c81dea97e7922dfd8f0284ce91321b2e0f2c496f05bb0d67b8131e9aa685cd4,986751,2020-09-27 11:58:18 UTC,10000,,false,10000,0
c81242b36119a5190864fa3cb217c2072d713baaf972a42c24c3596fb18b242e,986751,2020-09-27 11:58:18 UTC,500028540,500018540,false,10000,0
3146a26fe77d2911eaed8fb884f12a41f428c857087a75ff0c5c37286336050c,986751,2020-09-27 11:58:18 UTC,42726378,42723418,false,2960,0
f819e3c5d07dd4c6479fccf599506da8435bc4bd01d0db9580f8efdc86f387c5,986750,2020-09-27 11:57:44 UTC,10015889,10005889,false,10000,0
267a0572eaa9197ec2511da8d92c07c8b2adf478f0a6e5e4bc11ef5372245b2f,986749,2020-09-27 11:56:18 UTC,74867,64867,false,10000,0
2648c401ccbae1960ad0c8a23718f193a1dc8091685bbb4e66d78d023ca2a1b2,986748,2020-09-27 11:56:10 UTC,500945495,500935495,false,10000,0
b28eded17a94be2e85762ba60e2d613542f1fd9b82087a692a76232c3da3a41b,986747,2020-09-27 11:55:33 UTC,10000,,false,10000,0
e9c4257e72179ea6827d4e689ee937489fde347c5e3981acc54d3350df872748,986747,2020-09-27 11:55:33 UTC,534545656666,534545656421,false,245,986736
f69821e978c34286292ef7f996934782c886f861a0901ddae5dbe4d9c515cf0e,986747,2020-09-27 11:55:33 UTC,61321177642,61321077642,false,100000,986736
80da1a8aa63dd5fe61fc21420789e752863d12f5678f6f5b279827f8a235041f,986747,2020-09-27 11:55:33 UTC,246159496,246156536,false,2960,0
4dbb4308bb9d411988c87e0645c853d729042d1b854f6d8dd907d780cd5d5358,986747,2020-09-27 11:55:33 UTC,1404708,1404315,false,393,986736
edc1157dbe4dddffbca5922e53b6380292a43044652119b35cabdd0dcb33d702,986747,2020-09-27 11:55:33 UTC,97094828,97091088,false,3740,0
8510acde4468e3bf91d3a004c91fd2b1160c9544f778cba833ef2a574e5caec2,986747,2020-09-27 11:55:33 UTC,499980000,499967915,false,12085,0
afdb3eae167a2ad938c2d81fe08294292300939f6a29538a076ad1df03beee63,986747,2020-09-27 11:55:33 UTC,153792199,153782847,false,9352,0
e862ecbef184e04a22cc9865240ee0c6310af0d7c9b8d119f64cc5114e8a314b,986746,2020-09-27 11:52:59 UTC,10000,,false,10000,0
2b743b39047c89769b14e2d5b7dff41f2b728281670a3242ac2ebda82714d968,986746,2020-09-27 11:52:59 UTC,586623173,586543173,false,80000,0
b3e9ad40e3b74e7f715f2bd59063bd17603925ef6584abee27384ffaa7a59b46,986746,2020-09-27 11:52:59 UTC,1000000000,999998545,false,1455,0
5801a0068a43adfa55119e0f18da349f73fe71d69eed22a979ee22d3c9b76f7f,986746,2020-09-27 11:52:59 UTC,1135385479,1135381739,false,3740,0
e9a59838a20be9fb9a6a67f51dbcfeafd5aadba7cba7fab6c4789557d219f8ad,986745,2020-09-27 11:51:36 UTC,64001431,64000006,false,1425,986734
a8e85c3d96c4a7b54f729675f6f8b5d52b975c4a4073efdbe8ac351e52017bbf,986745,2020-09-27 11:51:36 UTC,10000,,false,10000,0
d845dbc899decebf86bde0a034019e1317e6a184e5dce0e8a0f09f21d9d59da5,986745,2020-09-27 11:51:36 UTC,228301399,228294900,false,6499,986733
62604f0503b9d8ab2883196a0f72d10d1e8a29bc401c612710f5161deb591e58,986745,2020-09-27 11:51:36 UTC,163457362,163454873,false,2489,986733
0905e4e8a0698bfe863ade77763565ac746cfbe88d7b397d153b5610d36944b9,986745,2020-09-27 11:51:36 UTC,10000,,false,10000,0
174a56b6aa35b735b921ed793e5454d0c72e91ce9005f6dfd64f895fba419cbe,986744,2020-09-27 11:50:15 UTC,485757264,485747264,false,10000,0
724256cdadeae44c379a5e5fe8e9f9929a681593b16a809ae24c6903569f7968,986742,2020-09-27 11:48:34 UTC,37397414,37396135,false,1279,986730
3863b60133ce9c500702d175b7b52a69c72fd0900d6ff4d7ca7ad84962ed4e62,986742,2020-09-27 11:48:34 UTC,10000,,false,10000,0
117fdce04457539c562741190198d6eb25fcaca6de28c2d82a7fdc6e26ad5011,986741,2020-09-27 11:48:06 UTC,43080063,43076490,false,3573,0
fba4000604e83283daa4a266e7ddc7c94d078e9d8a9fa2c8bcb13d7b971d4fce,986739,2020-09-27 11:47:25 UTC,500000000,499990000,false,10000,0
70b0c8dfc7c422af5b6611a019c615ebda099af63461b8a778473ab00a2ada10,986739,2020-09-27 11:47:25 UTC,19530,17610,false,1920,0
ca34ec78e3d73f4490bbd76053174f02a05659290aa98a3dc3270f6429338974,986739,2020-09-27 11:47:25 UTC,10000,,false,10000,0
424b0bd5f3f58c3256f6b6120d39e376b192f3e6007c8aa483491c53deb81667,986738,2020-09-27 11:45:24 UTC,18088411875,18088401875,false,10000,0
cdfe6f68966f2aeceafe80539b6397dfba16b12674ce901c0daaeb98909c3d18,986737,2020-09-27 11:43:49 UTC,10000,,false,10000,0
1c95554b0288479c0882ad0e9f9e1b312ded8b7ea7cabcc01eab00fd738b54ac,986736,2020-09-27 11:42:42 UTC,246316786,246313826,false,2960,0
d8241427e1e395358f0677ea697ef5b874cebdedfbc0052f853301bae49c5633,986736,2020-09-27 11:42:42 UTC,18438133214,18438123214,false,10000,0
ead03c2b23371c469474b93d43bcae9e59cc064df08f44531d0869914a64f727,986734,2020-09-27 11:41:19 UTC,111815099,111814823,false,276,0
120038215c2a8c0d4bf3bf523f8e860ce34e85dbc8cff3eddae09c3a1d32ead5,986734,2020-09-27 11:41:19 UTC,163996312,163994299,false,2013,986723
8b44517625c993f2a1fc54685401bae3611c4a9c41891bd1e6f14f9cd33042bf,986734,2020-09-27 11:41:19 UTC,64485742445,64485730070,false,12375,0
2a392648ea1c2112584c2aada8af5342a7f14edffb6206f25a5a6c126dcd634b,986734,2020-09-27 11:41:19 UTC,229492556,229486055,false,6501,986723
014641e0cb9a6d3f5402dd633be8d0cc09e71ca81b7d3334c0304484c4c29f8f,986734,2020-09-27 11:41:19 UTC,192209242,192192858,false,16384,0
5f86493e7f07cd8988b7582f8c548cc9219183d6b7ea879d853b80e4dc69ca05,986734,2020-09-27 11:41:19 UTC,18438143214,18438133214,false,10000,0
b40cfd36df659b4f8da9bd583b3abf60bf2879f3c2609c858f0879595d2d49a7,986734,2020-09-27 11:41:19 UTC,43247921,43244961,false,2960,0
9546b9b139a29b3e4600dbbe3171260975204fc8b330ff78720cd02009443fd3,986734,2020-09-27 11:41:19 UTC,25816810,25815644,false,1166,986723
fec8bc9edd9ef49b7d4a7ac2d778938beb9fbe958cf3bda0bbcebd7c7d9c0b92,986734,2020-09-27 11:41:19 UTC,10000,,false,10000,0
71e59cb27a8873c55cdca4e75638fc10857a8d4775be7d367c3b881855d7eaa7,986733,2020-09-27 11:38:49 UTC,10000,,false,10000,0
38c3253b61235278cfb68a0de123557f27790060bf8f9a460619b41141a496a7,986732,2020-09-27 11:38:38 UTC,2000281322,2000271322,false,10000,0
11a7d5e77ee3e50c7b2d3d1dfa04e55a33adaf690fbadb727e178cae9f9db037,986732,2020-09-27 11:38:38 UTC,79289456,79287196,false,2260,0
811a24eab76b6aff997176399c686b67b3282ab176e7bc9932a8c57a45062780,986732,2020-09-27 11:38:38 UTC,10000,,false,10000,0
bcc660e86f951b36e186f578d7e2b759c017c0de3e41e2f656691e3483faad16,986732,2020-09-27 11:38:38 UTC,19256875479,19256865479,false,10000,0
4dfc7f49940160a3268d204d8ae19ad13201cc5b854ae5f0abfd1f25a9c20cce,986732,2020-09-27 11:38:38 UTC,499980154,499968069,false,12085,0
c4800f6b9c2b6819642b8f242372fef4e82027c37a58f351028c0c09e42ace2f,986732,2020-09-27 11:38:38 UTC,246485936,246482976,false,2960,0
158cef53451c7ce157ed6319391f2e4d4ebf9219ab7ae44430d7c6a412370eb9,986732,2020-09-27 11:38:38 UTC,13795179948,13795169948,false,10000,0
66584f61e2116da30e2807884cdb39ae6e0344333f8f3a65f25a55df1260e455,986732,2020-09-27 11:38:38 UTC,500000000,499990000,false,10000,0
56c990f969b8ec6edbf11b777a24232aa6066d529cdb6fb8bcdb70aac35963c5,986731,2020-09-27 11:35:26 UTC,289760193,289680193,false,80000,0
9ff0a0a2aca30cee722b9643bbc6ab15934b36ec0bf39a0d15631f6c534afd82,986731,2020-09-27 11:35:26 UTC,10000,,false,10000,0
3d7ad4ffc82a2a543a40b194118b9c6363032048ab3b8d73667d0d6a2c289339,986729,2020-09-27 11:33:46 UTC,19256885479,19256875479,false,10000,0
590e6f24b9ee1f3ff700f363c72ff9f788dc5efb2a9ba88f50b7da632d9ab38d,986729,2020-09-27 11:33:46 UTC,43402918,43399958,false,2960,0
24c107a16cd8ea6a1bb5eee6edeb1403bab7d6c1759427be7158f0c9e52caed7,986729,2020-09-27 11:33:46 UTC,112050,109600,false,2450,0
2f59551da047864371badcc12177f71b517331afa8f0e776adbe2f7bf5e944c4,986729,2020-09-27 11:33:46 UTC,57396656,57395656,false,1000,0
14e6911324eb07b62a562b3f4dcfada59b2e2a02ec2a6dc8a68908ba91a2617b,986729,2020-09-27 11:33:46 UTC,10000,,false,10000,0
6d78d3aa8b09906b29a12e9853bb4236419404ede81986ebc0df008718431252,986729,2020-09-27 11:33:46 UTC,1300000000,1299955240,false,44760,986727
7fb3341781b0e54eabf27a67086754a5866cac122bd4a8e4e37a5489511fbe87,986729,2020-09-27 11:33:46 UTC,735890000,735880000,false,10000,0
e8f675cdcdb67cacae5ce906ee65ac0c77fc07afc4f2c8929f0001236155f766,986727,2020-09-27 11:31:46 UTC,66029988268,66029988168,false,100,986715
b5eac660ed3db07c2a5eed95db8d276a761937d01937c7d8ad9e0b898ac9eb0b,986727,2020-09-27 11:31:46 UTC,999980000,999970000,false,10000,0
0bd5b098631de5ef94e627b5269aef2ace45d381697ca222726dbf164fc3e8eb,986727,2020-09-27 11:31:46 UTC,15669348,15668808,false,540,986714
1b36fc72864db32f937703769ce569d2065de738081666a826ceb9767c7287c0,986727,2020-09-27 11:31:46 UTC,499982083,499972083,false,10000,0
1c790f02b3d52b91a2fb18190bb09fd7fc332ef6edc95b38d0f4dd634de536ed,986727,2020-09-27 11:31:46 UTC,10000,,false,10000,0
de555e9b1ef1294867c0d531a216f280d2f29c3922fece7222c39a20a8fd4d36,986727,2020-09-27 11:31:46 UTC,1313333,1312793,false,540,986716
fcc6a37d4c4f98b3c94daf9d67188c7d137d8e2e2171c8c826125991cd8a9706,986725,2020-09-27 11:30:20 UTC,230581992,230575493,false,6499,986714
9336ea0a8f56de29f1c79afde7045ffe1b7fccc8dce26aeca2d689eb24b3c7a4,986725,2020-09-27 11:30:20 UTC,417526256,417411856,false,114400,0
a84714923af2bc254af21ab52c2bad2ae4da085726fa0fe0b47b3fea5a7590ab,986725,2020-09-27 11:30:20 UTC,164660797,164657732,false,3065,986714
5ebe93512c807e579cbd3bc834fec0fb1fe1e705ac7956bb0b953b594a507187,986725,2020-09-27 11:30:20 UTC,10000,,false,10000,0
95662da13d4e06c9f68ccbfdc1a6b04e52e3cdf6d21c8e9bc59e7b793f72d8c3,986725,2020-09-27 11:30:20 UTC,15564784824,15564779824,false,5000,0
47949489c5614754998712733148f560732e1620e4fa4d0f3d3f0eb548a62c34,986724,2020-09-27 11:29:23 UTC,19512,19512,false,0,0
75941425a0a7cbff5d8a7f9eabb1316c8514b68c24e476b5ef351736d04c843d,986723,2020-09-27 11:29:01 UTC,525000000,524995120,false,4880,0
ae26f64c01736c53a0c9ff74f06eccef218edc4101acfd358700653337af3cb8,986723,2020-09-27 11:29:01 UTC,999990000,999980000,false,10000,0
b6fa88ec931873f976fe3b9bc598f738c27542374202cdaf3afca0d689744349,986723,2020-09-27 11:29:01 UTC,524995120,524992583,false,2537,0
993b2dcce73985f02b98384c53bdfdcb1db9a84e242e63fb488d4526c90be793,986723,2020-09-27 11:29:01 UTC,10000000000,9999997550,false,2450,0
46812178c5bbe45c7a12dc903ec13f6ccccfc5e12ed66d188f01a16d203bcd4a,986723,2020-09-27 11:29:01 UTC,77422000,77419550,false,2450,0
3bf7a43b50dd21c8bd17ba5ca21fbab7ef3716c4c7a976f85c8e0e57e40367a6,986722,2020-09-27 11:27:20 UTC,3910040,3910040,false,0,0
b363ee85ca75111dd9951e1d0b217388e935ab99fc1794884f5fdba2288492d2,986721,2020-09-27 11:27:15 UTC,10000,,false,10000,0
574ebf411639ac3558d7791bd39685fc4d850a19b043a84a2fe28e08b48fa63c,986721,2020-09-27 11:27:15 UTC,111852321,111852045,false,276,0
a35fb4a9969db119c2237b34d20ba9eb31fd2d9df4ef2df036d899fe435bc82d,986721,2020-09-27 11:27:15 UTC,246643535,246640575,false,2960,0
3c0dc8f18c4ab6caa8990c45fb9bfdb27c0bb91204e478c1dc94756f947b8480,986721,2020-09-27 11:27:15 UTC,89622,87172,false,2450,0
7d9469297a95fd7bb37e29f72f956a0e44110f96224f14dcad232b210eb03d4f,986720,2020-09-27 11:26:25 UTC,1000000000,999990000,false,10000,0
809a3b701e50cc8c6feb5ea3456c7ea4b5747885c9e72d2e4bc66ad63ff997b6,986720,2020-09-27 11:26:25 UTC,10000,,false,10000,0
3757d332a377aa0282a671201d1f1df96240292a0e861599c5e4765919e922c3,986720,2020-09-27 11:26:25 UTC,499992083,499982083,false,10000,0
663d970d1d4bbaf837caca3b0acc613e52c9264cc9f9a1620700cf306ed3e685,986720,2020-09-27 11:26:25 UTC,43605627,43602360,false,3267,0
64b217c77242e7f9f1f2d1673ba50abb2ce894e1d87f536cb40760d7467e9d82,986720,2020-09-27 11:26:25 UTC,18259442083,18259432083,false,10000,0
28b525d2befb5d5a3b01f1ef5f5d661d5d801fe8d9000faf9c735d85cec8b723,986717,2020-09-27 11:23:27 UTC,688416681,688401101,false,15580,0
0ae14d85fee096205c98d82f5adc737ccdf55cbbf1f990698a3ca1ebdda36c82,986717,2020-09-27 11:23:27 UTC,3656299870,3656284290,false,15580,0
14a763cc46daa7772a7b79fc3662129cc537cb7fe4020ed6a37a8344e4c7b0ed,986717,2020-09-27 11:23:27 UTC,499991095,499981095,false,10000,0
613a42428ff04a9bc57ddded02d29d54dd6f62012830c8ecc0cff3ffa25d9b82,986717,2020-09-27 11:23:27 UTC,500002083,499992083,false,10000,0
a2d5ec3f6a7edf6cf3a19c66080cdd3db958108a33de4afcba5c385a70f67a1c,986717,2020-09-27 11:23:27 UTC,630972518,630956938,false,15580,0
31a036ed4e770f946829561e467cdd7a5578f5e335184b72ba9b83972c1c6756,986717,2020-09-27 11:23:27 UTC,653379411,653363831,false,15580,0
ad6ec967f0968b5e2835c8ec7b1b4c0bb6fce1b094c9a54d46b4dca2af06a70d,986717,2020-09-27 11:23:27 UTC,2225119195,2225019195,false,100000,0
568db2697ef2a2762eb695e424601f236a4ad9fa10a511ea958449e3f1830265,986717,2020-09-27 11:23:27 UTC,1962016162,1962000582,false,15580,0
5736189d40d68f07870c1b8c5a48c0fc3616572e48635b17caa898d2b876c534,986717,2020-09-27 11:23:27 UTC,10000,,false,10000,0
86727cb2527769d43d28353f4169e159597271aabbcd00c0abc427b6257c013d,986716,2020-09-27 11:21:39 UTC,8340027643,8338761461,false,1266182,0
236a4cdb509f5bc990718467e72fff96de7a975cfa6683937330de93e63f23f0,986716,2020-09-27 11:21:39 UTC,499990000,499980000,false,10000,0
67e70f96bc2cadecf44f673bb2c22dacd460a0e1a4e0092b2db7036bb6d9a8ff,986716,2020-09-27 11:21:39 UTC,3355850756,3355835176,false,15580,0
a224b35b6359bed5dfe2a6a72a06e0b0a4e8aacf995b16f7c2cb8e84be9f9f76,986715,2020-09-27 11:21:28 UTC,3371747533,3371731953,false,15580,0
f5a3eb2fe3923c7212d7caa05ce39484682b2158f2278e242e5f969ff8646425,986715,2020-09-27 11:21:28 UTC,1045429104,1045413524,false,15580,0
c72fccc8e3baaf4acff380543bb553a54852c1c765e1a846ee8cc2efa29310aa,986715,2020-09-27 11:21:28 UTC,500006900,499996900,false,10000,0
cf2572aac99c7d9c08831c1f8ad991551350d3c2a57a4aa4a18c70bac4269288,986714,2020-09-27 11:21:03 UTC,1673954296,1673938716,false,15580,0
3868162dfadd8763ca3bbc14f7490dfc0d93f4e7d0bc1f5d1627a5cfe277e755,986714,2020-09-27 11:21:03 UTC,2514651871,2514651055,false,816,0
7f61f0064a909a537f06c1af4cb7a307241069bc514e85c43cf23a6611d966af,986714,2020-09-27 11:21:03 UTC,882190266,882174686,false,15580,0
981448c1b051e58656a0ad1133b1d42ece89a1c2c2dfad5e85007e10e8339d13,986714,2020-09-27 11:21:03 UTC,1617733536,1617717956,false,15580,0
f0c321d1d33b550fb3e9cf032f337e59b4a8d89abaf9f7b43db2bb25d4d6fdb5,986714,2020-09-27 11:21:03 UTC,507141730,507126150,false,15580,0
dcff56991ac43a0f7b1cee3b87e31d18fb197b297ca264a41e06723c19498ba2,986714,2020-09-27 11:21:03 UTC,165339163,165311243,false,27920,986703
b3ca2309556c4926ffbf3f0e1aed243c3f0c768505e02f75e300ded1d1714aba,986714,2020-09-27 11:21:03 UTC,17989629251,17989619251,false,10000,0
3aba3efa636e673e8200bcfcde228b3b942121ecfea06890c3906ef23f207d2c,986714,2020-09-27 11:21:03 UTC,2176485627,2176470047,false,15580,0
0965d41189de1e81c4da8ffc28eb04a4a3864a7e00f46f52d9c21d3def731210,986714,2020-09-27 11:21:03 UTC,657370539,657354959,false,15580,0
2283d3a1162dd94add45a0a6bf3b7ac47523c1e1850a3aa17fc913397b2a2058,986714,2020-09-27 11:21:03 UTC,232196736,232136053,false,60683,986703
821abaadc1ecbc49452442929ec6459c0865546233cc88e6c8cb7cf51537f716,986714,2020-09-27 11:21:03 UTC,10000,,false,10000,0
496dab20d85281b5bae0ffaf74afd5dd4192d90cfcc01b49fd5710bda36e3e9a,986714,2020-09-27 11:21:03 UTC,1068760689,1068745109,false,15580,0
bf48d9c86ea79600dc33968582c55ec58321c2c73abe7e2958251a6d1535e489,986714,2020-09-27 11:21:03 UTC,10000,,false,10000,0
178a9c7a5dab1e6254aecaaf7e7b8d7f15d79cb52fff6650f24b570d041657ee,986714,2020-09-27 11:21:03 UTC,1774660169,1774644589,false,15580,0
d990e4628ab8313cd1f42e7821b345295de8af9a4d6ed6008d9a845004ae1ee4,986714,2020-09-27 11:21:03 UTC,500001095,499991095,false,10000,0
ca14aaedb127155904c53b2936e1bd25e3b4e6e8c456c03893bb869e38ee25df,986714,2020-09-27 11:21:03 UTC,4080217206,4080201626,false,15580,0
9a94f0e2f04ced584d6bae2b1f1bb22c2347357733c6ffe006895534c190c978,986713,2020-09-27 11:19:29 UTC,1945890084,1945874504,false,15580,0
24dea314c2cc87f6556138282ecbdbdef83b57f2235dba30590aba92c5ee10d9,986713,2020-09-27 11:19:29 UTC,247038431,247033634,false,4797,0
ebfdc62cf5152acca6269bc618661cf4d7be46d8c8958fc936aded177a114025,986713,2020-09-27 11:19:29 UTC,2666495706,2666480126,false,15580,0
771f03a93ae4e493fb0702b20853ba2c2d19ad961a959b5cbdb093e5e8b71fc1,986712,2020-09-27 11:18:12 UTC,49973400,49963400,false,10000,0
34d7f0545c7925a7311bdc6aa592a980159f728e8676eedb49ac19b7d8cf11e9,986712,2020-09-27 11:18:12 UTC,144503705,144423705,false,80000,0
a5e5de7ea4265ebcbd6180b5dfc816818c5d01e3fcbeecc34a4af1a57cc11844,986712,2020-09-27 11:18:12 UTC,43754603,43751643,false,2960,0
89658edc3cf9700e965cf23a5f9cfb314f6100427d6af82775f312bb3517b149,986712,2020-09-27 11:18:12 UTC,500011095,500001095,false,10000,0
d84c3170b9e1735bd7cd8b8aecc3ddf301a41e6b1c2e7720db5123e12e09a473,986712,2020-09-27 11:18:12 UTC,499980000,499970000,false,10000,0
6e4f806978f1b9228c550d435060ddce987f4c3bfe42c9db9e021a63e8a2d98d,986711,2020-09-27 11:16:21 UTC,10000,,false,10000,0
3dfed64a283d401d759fadaafa24ecb2ff3bcfae2f5c832cee0585b85ef48b28,986710,2020-09-27 11:15:34 UTC,6253359,6246219,false,7140,986699
0ae29d5124814ddedcd30e2996c546d6445c86360f27a50f750d57d1a51e8278,986710,2020-09-27 11:15:34 UTC,10000,,false,10000,0
b2e84f0e424abb6aab6de344f49fa55df761357b67ba3d9a3641dae46396c239,986709,2020-09-27 11:14:00 UTC,20075296585,20075294325,false,2260,0
2246ac7866c4164d9f00855c0bbe31aa52496df40ca613c94f298d0320e22058,986709,2020-09-27 11:14:00 UTC,10000,,false,10000,0
fb86fc3ef500335e4b16e0260c54e88459c13992fd54e9fd2f87b255666f7faa,986709,2020-09-27 11:14:00 UTC,499990000,499980000,false,10000,0
e5c1af5edeaebd7ce98b9906db423a398574aacf976554a511f52e44a8fcfd22,986709,2020-09-27 11:14:00 UTC,49734438,49724438,false,10000,0
dfa5d923dfca35f928ebf0d57cef3d5046d3b3983ae78aa2dd9b7dc35a882dd1,986708,2020-09-27 11:12:43 UTC,17507229512,17507219512,false,10000,0
e0e565f6bd532a34fc8e7b2b183ae687056020379381ab0adc3278efa8ebcd19,986707,2020-09-27 11:11:32 UTC,105853710,105851260,false,2450,0
7c599342773222a4beea83dba15669383d40b2791f62d5bfdb4f16c1f91bdf85,986707,2020-09-27 11:11:32 UTC,112062655,112062379,false,276,0
c7a9104a6937f82f4f53ed6ead7a14e53c983df659f36d4a5e6b05ec870a8fc8,986707,2020-09-27 11:11:32 UTC,233597629,233591337,false,6292,986696
de3d34fd778f9471edb695d961728734d30c8cf71afb05e189679efbd047aeee,986707,2020-09-27 11:11:32 UTC,165942139,165939823,false,2316,986696
5f33b1b080322250342958d9ea65c8108b8e35a3186ad22db71d55b3ff150a89,986707,2020-09-27 11:11:32 UTC,10000,,false,10000,0
b9f133f049023d112d0e6d9038464d66594a2354e38059c50285b8247470c7d9,986707,2020-09-27 11:11:32 UTC,10000,,false,10000,0
25fcddbdf83cc257ede8920b27ac7d154e564aa9a9a4bed607fd26a5fe68fc56,986707,2020-09-27 11:11:32 UTC,10000,,false,10000,0
619c810ae497fea1abc9d53f01c9fa98be076a646d965092294321509a3bb6c4,986707,2020-09-27 11:11:32 UTC,17508580960,17508570960,false,10000,0
3d35f3f5e6abe1a3a434ebdf24fef1d38951e1bb301bab5c8f9550b8626e25e1,986707,2020-09-27 11:11:32 UTC,43971395,43967822,false,3573,0
be2a0477a05221014dba268f8a6a6bcfd330149b1fd2d06274b89f77bb659314,986707,2020-09-27 11:11:32 UTC,128207919,128184232,false,23687,0
e45fbf2301e6c09db7134656d57b0dc6d117572c48f7c4e41143a32e6a1071dd,986707,2020-09-27 11:11:32 UTC,208500979,208482979,false,18000,0
942898bf41289b69776a74b5875231ed8fd7cabb5cd467e57436e85462024815,986707,2020-09-27 11:11:32 UTC,500000000,499990000,false,10000,0
9eeb908d94b3c8c383238822d07944b56b575f26a51521b34292327ce4e56fe9,986707,2020-09-27 11:11:32 UTC,112036895,112036619,false,276,0
ebb75a330ad982c2a22f6aad33ba2fec8cfcf77d51c5492ea84a6342f085fb7c,986707,2020-09-27 11:11:32 UTC,111946997,111946721,false,276,0
c2f86d321cdd86f643b6c12732f9e3556f5d56a405dbf062c120f852fe89b7de,986707,2020-09-27 11:11:32 UTC,534623078911,534623078666,false,245,986696
8d39c7c9314a231ea5a3bc791fbc4b8e204737627a9395cffa3748f90b10bbd7,986707,2020-09-27 11:11:32 UTC,247192274,247189314,false,2960,0
02e837903df9a85903fb8f9a50fb9a02ddebb872b1e1c163a0d7a5a2cfbbd6cf,986707,2020-09-27 11:11:32 UTC,4321500000,4321499756,false,244,986696
7baf2f15f32c9bd454a3898b29d5c11a9343fe14db86ec9e88e58739d126944c,986706,2020-09-27 11:07:50 UTC,112100773,112100497,false,276,0
50d977b4625d537ba862e424724cf77f9ecd3a8228ec473b97390bd2b5d8ebc5,986703,2020-09-27 11:06:38 UTC,4000266393,4000256393,false,10000,0
df20438e2d79aa5995de9bc41a88c558478bfe1bdfde26b351550e231e9c0ed5,986703,2020-09-27 11:06:38 UTC,535032581003,535032578911,false,2092,986686
55667c3493f5970cbeb0d56d67f4d165b2997e3bf5d975c368607221c9e07bcc,986703,2020-09-27 11:06:38 UTC,1000078159,1000068159,false,10000,0
2193ea7bad986974e45cf869e91b91e2bd80636b49ff973225fa5b9bf131242c,986703,2020-09-27 11:06:38 UTC,500000000,499990000,false,10000,0
973f065bdfa3e4be9ecf890559f37e2ef9970d6db9b6d9ff6e9914652896cfe1,986702,2020-09-27 11:05:08 UTC,10000,,false,10000,0
5d50ef96d98e976cee830d36c14b19c002651094e15565388e680bb883a587fe,986702,2020-09-27 11:05:08 UTC,51060,41060,false,10000,0
b49264de0f5d99d31aad597e67a6269c71e50260b44faf5160312333eda6c3e6,986701,2020-09-27 11:04:55 UTC,2500347475,2500337475,false,10000,0
2dc00b3e9aec157cb02a1d4c0d75c4dcf2fa54a0d5a863eda7f1c62dfff13311,986701,2020-09-27 11:04:55 UTC,10000,,false,10000,0
0e3e02ee470f54664e07b92a6f40abdf3a95cfa99a1eff0dc104065a4dc02a53,986701,2020-09-27 11:04:55 UTC,350084164,350083920,false,244,986690
9b52e7b69d55e82be558c90cdf37f5173e9c0e9138928b95f107d4b3fa203b38,986701,2020-09-27 11:04:55 UTC,701003484,701000000,false,3484,986690
2b9686bdb0ab42c0687f663c719271e849cf478a859961a4518b8fcf518dc394,986701,2020-09-27 11:04:55 UTC,144517570,144437570,false,80000,0
79e33b35def650e24cf7ac9ae74c3776b8f266a9281b84ad2b0615e6c4355d5f,986701,2020-09-27 11:04:55 UTC,10000,,false,10000,0
eba114a81385958f0bb283b6222ac1620aad4015375ee86345cd1702639da6d0,986701,2020-09-27 11:04:55 UTC,4504000000,4503992999,false,7001,0
80ccea697dce24eda9d616426f076f5797fad44ff9b207f0d680ac81e9b59cfc,986701,2020-09-27 11:04:55 UTC,10000,,false,10000,0
345d29e96f2c41c42041c4f7f208b186d86eef1ccd572e91756545eec6ac161e,986701,2020-09-27 11:04:55 UTC,20347185,20346941,false,244,986690
097ead6873328e379ad3e72221adabc38a429687eadedbfe325b4679d065e3df,986701,2020-09-27 11:04:55 UTC,2384047588,2384047309,false,279,986690
5d3ee20b282d0751d75c6d2ead5b7879e9f5461d915689d1684625806b066e09,986701,2020-09-27 11:04:55 UTC,231278129333,231278119333,false,10000,0
0a539af62dde4c076e87b916b0b701f83095781e4fcf51fb5ae8c2bde50d1dc4,986701,2020-09-27 11:04:55 UTC,166437718,166435229,false,2489,986690
76d661b239d3f2dfa3a4a65a9df82d6bda31bc8f658ba52c89e8cc8e3d307749,986701,2020-09-27 11:04:55 UTC,134951145300,134951142950,false,2350,0
fc1e7455cc443546f940098b02a3c7d79fc9f1651b47b2eed0432f4143880adf,986701,2020-09-27 11:04:55 UTC,2000193236,2000183236,false,10000,0
bd7d23b91ba7041447a76fb5b7d02bedbdbf78107f3c350319e4572478af5d94,986701,2020-09-27 11:04:55 UTC,66067288368,66067288268,false,100,986690
27a47eaf45337c4302748a192f392eabbbffb67618b3933afe91f8015c5fac45,986701,2020-09-27 11:04:55 UTC,247349341,247346381,false,2960,0
2cbea75354f8b1d3d10310ef3fc541a5785f7a9db8716e9df3692602163ce172,986701,2020-09-27 11:04:55 UTC,535417081248,535417081003,false,245,986690
08256ccaccab99ef1662050aec67b9e9c7b85073b77cbb01097d263b181a1c2b,986701,2020-09-27 11:04:55 UTC,17611976,17611418,false,558,0
43be867d6324830d7ffde2ba970baf1d1dc862f9e69154a2bddf362f52e5ea70,986701,2020-09-27 11:04:55 UTC,234785011,234777942,false,7069,986690
9ca2d589b16baa0fd8de9444a14317664e8038a062be6d63cbe93b609dc4e639,986699,2020-09-27 10:56:52 UTC,17508590960,17508580960,false,10000,0
a325c810cca295e0e7ef1efd6908d986d79513582e4e70d2485d11a96b9e5118,986699,2020-09-27 10:56:52 UTC,10000,,false,10000,0
46808530febc518b64f779abc9f3401245b0e9d3ba0581579fd817fca83c8272,986699,2020-09-27 10:56:52 UTC,535932581493,535932581248,false,245,986687
a19cbff7ea03534f62be585881dce9de86bf0caf80d73d77ce90f543e5cbeb75,986699,2020-09-27 10:56:52 UTC,44193625,44190665,false,2960,0
061ccb7aa5fff878370971aaa110a659a3fb2c400749cdf3f11531c634e4da35,986699,2020-09-27 10:56:52 UTC,4498010000,4498000000,false,10000,0
b42ec53978fd13f70a2edaf05174b00ab32e930c440d9931c7bcdc6ad93ed7de,986699,2020-09-27 10:56:52 UTC,247495870,247492910,false,2960,0
4e5509daab56bbcf63f4605ba109b81f831b12480ea8a73064b95862c76c4781,986699,2020-09-27 10:56:52 UTC,56346,53896,false,2450,0
d86d62840915ae1d8631f45692bc1a41ff84d3d32b90f6010d64d0de4c694597,986699,2020-09-27 10:56:52 UTC,112162575,112162299,false,276,0
39acf292d476e54ba0835823b56c76085432b557d59c23d2f7b2957cd358e27e,986698,2020-09-27 10:53:51 UTC,112316866,112316590,false,276,0
5e17d0ad6e422e9affbcfa147137ff0872dab13eb14f783c8c7281e1092af774,986698,2020-09-27 10:53:51 UTC,10000,,false,10000,0
63d8f30763733cf7135ae055b87593bb4c1a6a5b94e3dc971da845b40f7b502f,986698,2020-09-27 10:53:51 UTC,10000,,false,10000,0
6e275fe81067d571b051261dd7e802c5bdfa97242ce0ca42f2754d1bc7125ad1,986698,2020-09-27 10:53:51 UTC,499983267,499973267,false,10000,0
cbcc8c28e0deb2f85eb0b15dbe3601a7b4c8ca5953865a7aaeabeeced24c26c9,986698,2020-09-27 10:53:51 UTC,2507333195,2507233195,false,100000,0
a2e397dda0d880a9fdfdfc44e73fe4f937e75dd440527eb826d833c38e0aec70,986696,2020-09-27 10:50:15 UTC,166999383,166996730,false,2653,986685
34d5163c35bfb2dbd1f3569647455fca86d2d1149a300499b485886d603e75e9,986696,2020-09-27 10:50:15 UTC,235717948,235711896,false,6052,986685
db3f1e5830e6df8d66274604f700fce73d2857a0f5f3e7abeebafc2c8f67b8a4,986696,2020-09-27 10:50:15 UTC,44361867,44358907,false,2960,0
9bd89aabba48c16076a71ef0bfa1b3dc222bf0800e28b6646e3ae3532ad9cf43,986696,2020-09-27 10:50:15 UTC,139900886,139899886,false,1000,0
2762d048fb0da71eab103eaea729caf883ad22364ebc2174c640bcaeb823c2b4,986695,2020-09-27 10:49:36 UTC,3054170,3054170,false,0,0
618fa7d424d080f08944ce2f4d4cd1d04a8ecd2c97f1e32627e93e8baafcdc17,986694,2020-09-27 10:48:48 UTC,86000000,85999000,false,1000,0
de91af33b1b4e48d6d3fb1f48c3938a3e73e8ec222ee6e0316c633b133b4fe69,986694,2020-09-27 10:48:48 UTC,247684557,247681290,false,3267,0
4c2af902054e2d298c682376a7fb8a682a21143a0c24f0d193e86f4082bbfb20,986694,2020-09-27 10:48:48 UTC,10000,,false,10000,0
43eff955e0274fb98912c2fe86f9d541c67caabd14ab6422c5088f4b83a5153b,986694,2020-09-27 10:48:48 UTC,112360799,112360523,false,276,0
2a8308f332f9c32e6c5de3b3e6b6ceb26b4193e5147b042c32f8b11bfd116b92,986694,2020-09-27 10:48:48 UTC,10000,,false,10000,0
b44614b33850f97258c27aac9127d65c5dd3963518b4ec96b1cfcf38e6f3269a,986694,2020-09-27 10:48:48 UTC,20683596,20683055,false,541,986682
aa3d88a95af687a099de07890a5c434bd4c64632b79c3c7caa0d3602b66e2b36,986694,2020-09-27 10:48:48 UTC,5581395,5581003,false,392,986671
33a3fca817f860dee6729d90ea36b03336ca2ce26f3163f5c25e0c87584858b7,986692,2020-09-27 10:44:42 UTC,1120187680,1120107680,false,80000,0
7c8e7b1946a32dfc75e0d45b3d914df0dc6a6f0251bdc997829187c6ce311df5,986692,2020-09-27 10:44:42 UTC,10000,,false,10000,0
ba4c26a0ffbf14abe4cab631fee6b7f2a2468b19534b85260aa7f459097d9249,986692,2020-09-27 10:44:42 UTC,12846,3526,false,9320,0
ddffdf03291bdcf6d127ca9c5b18fa10975a6a45c41f75c9d4332a66fa0f94d1,986690,2020-09-27 10:42:58 UTC,10000,,false,10000,0
e08ce63e37e76e12ac4c1b49c5035aeb7ce3b542c03149daa9d8a0960c1a6829,986690,2020-09-27 10:42:58 UTC,44637712,44634752,false,2960,0
1586defa14be2ca501947647d1b6764c2662dae92bb79984a21a0ac8afad9a62,986690,2020-09-27 10:42:58 UTC,10000,,false,10000,0
939ce226bee1a9ba1d7732882f26e4cef4777407e6b50da335afc68cfc888b33,986690,2020-09-27 10:42:58 UTC,112381742,112381466,false,276,0
796a0e1f56a9e505cc98f4358da286828c0b0f986e1cbee6db715e4bb4f0d369,986689,2020-09-27 10:40:16 UTC,167655560,167653003,false,2557,986677
0acc710bdeca64d525cbe54c3569a70991fe194075d33c64a934667b266d51a7,986689,2020-09-27 10:40:16 UTC,248145214,248142254,false,2960,0
56d2bfe6f80617824f0b6712c87892a25442a1b5f3eb5cb9d64ed47e25f52872,986689,2020-09-27 10:40:16 UTC,237160993,237154907,false,6086,986677
2a543a673916a4164eb69530d7e7f8af8adfd8254e4bc30e3cc14a910b6914e1,986687,2020-09-27 10:39:03 UTC,82450049,82441869,false,8180,0
c39971f83235bdcc41cc1b511dab3c9d17bdbdf68d2fa18bc4b8dad9870aac1b,986687,2020-09-27 10:39:03 UTC,10000,,false,10000,0
19aef28f4d6869d15cfcdd9aca678e81794d3541e7e3a690832c59dd54e45128,986687,2020-09-27 10:39:03 UTC,10000,,false,10000,0
764b807506bbd297ac2c947846eb81244b3a8243bee1fdc53fa75934a13e7c1f,986687,2020-09-27 10:39:03 UTC,281358119455,281357990237,false,129218,0
edb1fb81205065e4445652cd54f8ef02302906522ca5b022c6130696b84aded9,986687,2020-09-27 10:39:03 UTC,499993267,499983267,false,10000,0
941504bef63d1988455d63620012fd9f1d8afbd9bb9c830c3b0b826be70cf5bb,986686,2020-09-27 10:36:25 UTC,2500101810,2500091810,false,10000,0
2a43b54957d2e698b573347a398e824e8d8871963bb84283d12aae1e20b6599b,986686,2020-09-27 10:36:25 UTC,45365171,45358232,false,6939,0
a6efc773b7879626425b0622ddd1f71c21d358a342068f8e614aa8c5593baf4a,986686,2020-09-27 10:36:25 UTC,500003267,499993267,false,10000,0
0a0722fee977aa50ba6aae355d79c2bf98105145190324a3b488dc3492ba5966,986682,2020-09-27 10:34:24 UTC,10000,,false,10000,0
0f397dd0c6414d1bf7ae1f61b240197ee2cbc6273a9b5bec0337158c8f033207,986682,2020-09-27 10:34:24 UTC,248372878,248369918,false,2960,0
d591d8af40fe9a60402af07a689e793b69357824085bb4f6b7fba7b6f804e4fa,986682,2020-09-27 10:34:24 UTC,10000,,false,10000,0
fdc670d0b82ce1fe9f754df1b5c763ee2b984f27cd99f33f0e08eb2c24d2688d,986681,2020-09-27 10:31:42 UTC,103086096,103082696,false,3400,0
886e744f1a17e0c42f331ddf0e2c6d68b947f8d4f2bcaedc4193e8d062281aa3,986681,2020-09-27 10:31:42 UTC,45523992,45521032,false,2960,0
178ac8f0a31945943e3f4a65376805ff840da1ba12d3e5a928b5c163f6d9d021,986681,2020-09-27 10:31:42 UTC,6617055,6089055,false,528000,0
c642d2b10efc3a500b6efa9901fd353ee444a6ccbb505b7b1b39530659e1e70a,986681,2020-09-27 10:31:42 UTC,103082696,103080160,false,2536,0
15f35d3741ba36e6100e6038b32fec7c78a67aa187676aeed0f7bcd922c8fea8,986680,2020-09-27 10:30:31 UTC,100000000,99997550,false,2450,0
b7d1240c8f24c2a053c578f1f608f3913a208be539a5bf89712239fdf1fee35a,986680,2020-09-27 10:30:31 UTC,17495092875,17495082875,false,10000,0
2dd28d3d4122931adb45a013d2e82af7dcf2ea261b200bcf7315376c38140619,986679,2020-09-27 10:30:07 UTC,168062642,168060529,false,2113,986667
07673ef5bc20efd3589edf8bb4400d25368fd2016f866553753232fc6a2749d6,986679,2020-09-27 10:30:07 UTC,237979294,237974359,false,4935,986667
655127f92295ede7a3921e79031771dfe7a1b647531e41b235dc2880fed0cfbb,986679,2020-09-27 10:30:07 UTC,210055368,210036809,false,18559,0
5b8ac5e9706b4334942304b1eec3dfbecc38fc0f8900d7aaca0ea3d082d15fb5,986676,2020-09-27 10:29:19 UTC,10000,,false,10000,0
f4d240db1bf5fb8f7371b4b65157760450b6890d95638a905cda393a3ea1c0f0,986676,2020-09-27 10:29:19 UTC,3300000000,3299997550,false,2450,0
d36f3e3fb1f38fafa9bab4380970455fa15c57874aad95de8f7f35c4868658ab,986676,2020-09-27 10:29:19 UTC,171837,169387,false,2450,0
8700fc78caca6c763b2874ea7b3a3d4f23e2d6d8cf8b0426b1d2c335e5003408,986676,2020-09-27 10:29:19 UTC,248525833,248522873,false,2960,0
595860ac97f0403983dcd2a7bbcca592f11d4ab897b18c3b2902d21a8b1811eb,986676,2020-09-27 10:29:19 UTC,500022083,500012083,false,10000,0
03140fc0fc741ed60c32e3dcef9148abba4b146d61022a494ffe972c619aa882,986676,2020-09-27 10:29:19 UTC,112577051,112576775,false,276,0
c792d87cd421a63dbd901d983f292e552ff1a69eadf45d71365742b3697b2d04,986676,2020-09-27 10:29:19 UTC,100000000,99997550,false,2450,0
8297f5e23828638a93c0a3d19b553924610b7424720602b23a3d040b9c208efb,986674,2020-09-27 10:27:17 UTC,3991346800,3991330833,false,15967,0
687bcb10e0c9d247d66ae9c9bf1d39c404f2dcee9a89bcdabe9eab2ee2e4656a,986674,2020-09-27 10:27:17 UTC,144545191,144465191,false,80000,0
9725acd5236d92e5ad3c83ad6eed8459e85284e8d920360daff9b8d5aadaa9a6,986674,2020-09-27 10:27:17 UTC,85782570603,85782567573,false,3030,0
c753a713fc740f089e8182b6911342a390f11526234095e93d8526bd24536487,986674,2020-09-27 10:27:17 UTC,10000,,false,10000,0
77941e949297671785f80e636bb6b604516df6a87ddc15ddf7deeb245d6d08e5,986673,2020-09-27 10:25:52 UTC,184839927843,184839827843,false,100000,0
1cc990f80f0ec7045cb6ac6734c7b7316480955ca0c6aca202beb7cc4bfb9d66,986673,2020-09-27 10:25:52 UTC,10000,,false,10000,0
dba1003efb80677a99e83673b9674f921aaa5b5ddd2a39029e757cd1fdb15d24,986672,2020-09-27 10:24:48 UTC,7454553,7454277,false,276,0
1871e262db8fe5409acfd80cb735c76d8154751d143e4923d6943d88652b9ee9,986672,2020-09-27 10:24:48 UTC,1524665,1524420,false,245,986661
bf2d0b87ed596974d90468bff49cec0203831c51333e28810f0eb0b40963881d,986672,2020-09-27 10:24:48 UTC,85926656121,85926651051,false,5070,0
2cce83b5af7a3b28913a346177ab1fe3b9d849e4ae43448ba6ad4ba00535a1df,986671,2020-09-27 10:23:56 UTC,10000,,false,10000,0
9f0d581ac86400da28f28317e7616b426e5a9edff61a0e85344f62e07c779237,986671,2020-09-27 10:23:56 UTC,14300700,14299554,false,1146,0
858d69598e7042d54d38dbe82aa5a2a4ddceb8c8e5da41e769c2fadc4e3b73fa,986671,2020-09-27 10:23:56 UTC,45708692,45705732,false,2960,0
1186ea11bf42c54b0ff574e8c2a66d88d420e913b5bc77e378fa8008ad772f10,986671,2020-09-27 10:23:56 UTC,1057072470,1056972470,false,100000,0
a7be210221516c91966c7a74d53201c74c6195f55c8bc161cca7b2c3d808a5a9,986671,2020-09-27 10:23:56 UTC,86306833192,86306827782,false,5410,0
81c14a2a8e72ce34ef7d378cda20d55ab7aca0687334ba5f4a0434db28b766d0,986670,2020-09-27 10:22:41 UTC,1307310,1307310,false,0,0
5f24741373fcedd8f10d7dc14a21451d83c9f7bc080a42bc87fba2c5eb757e11,986669,2020-09-27 10:22:14 UTC,376265847,376265602,false,245,986658
03c8b1c01ae9e1451caf8994f42af7a3e804147cd0729c2f687bdcbe9285b4d7,986669,2020-09-27 10:22:14 UTC,86752247551,86752242141,false,5410,0
47d00881731971173f5b329009c9b7d59ee7348f059809f7eb14e186b816acf2,986668,2020-09-27 10:21:31 UTC,86774649510,86774644100,false,5410,0
4ff6b8cdd1b4af8de00cd59c1bee0a7638081a18b5388e7fb8b104f326620b37,986667,2020-09-27 10:20:53 UTC,10000,,false,10000,0
8d3d4af3320e368d66fb16b9cb48d1275df73373a617113a3e9e1e97626ed785,986667,2020-09-27 10:20:53 UTC,168476768,168474519,false,2249,986655
3a6344ae6f24884e479a8b5143f4f132b4a4d932525d4d3f582cdf603d23eb7b,986667,2020-09-27 10:20:53 UTC,238938330,238933123,false,5207,986655
ac5ccd0640755bf661526e792f1cf4ed12459aadc84b5ea9ad242a1f260b2aca,986667,2020-09-27 10:20:53 UTC,90051100510,90051095100,false,5410,0
6b69c6e250585f10675f5bc45225bc2a76a9902b38cdcc5c482e27592da4522a,986667,2020-09-27 10:20:53 UTC,34256188,34250158,false,6030,0
8cc9aaa6eebdb99ad45ea24c8a414b5f89eb7e2d4b7ac7450a911a2e7ed15290,986667,2020-09-27 10:20:53 UTC,92866905260,92866899850,false,5410,0
2ba773d064f7dfc4d76bb3c3467737307d151491e3880cc70a7d26526ef26209,986667,2020-09-27 10:20:53 UTC,98765279030,98765273620,false,5410,0
781cd00173328d65cc89719a130c3aa0729289e3865748a41731f6dd790241e4,986667,2020-09-27 10:20:53 UTC,10000,,false,10000,0
6d5026e00e25957e6a709951291aea5415a2fd7fe3179f92ae8636360603887c,986667,2020-09-27 10:20:53 UTC,500032083,500022083,false,10000,0
a5a523126dcd8417dcbd479375df49bfc62e3ece6c392c29307e7e225a192b2f,986666,2020-09-27 10:19:21 UTC,248796035,248793075,false,2960,0
7a4fb9164ce39492506483d5dfe322c5eea6b15c9391b8d62b0e6987f48e9076,986666,2020-09-27 10:19:21 UTC,7954817,7954391,false,426,986655
4ce1c7f77b275329e866d17bd327c0f3d3a73cc25c66de293131d77b07eea15c,986666,2020-09-27 10:19:21 UTC,794315452440,794315447030,false,5410,0
22685f18a7851308b8f4774dccdc9135114a5d380ca46a870df0db152d36c3d4,986665,2020-09-27 10:17:39 UTC,500042083,500032083,false,10000,0
bc53e8e9363100ec2b2a7b51f18c8fb2062d2dc60f9bbb1286d1bc3a57397dc1,986664,2020-09-27 10:16:06 UTC,46089744,46086477,false,3267,0
b69c38cd912af2bb8efd79f67129e2a61c9386ee6749623cd4c3925b2e1ae84b,986663,2020-09-27 10:15:33 UTC,10000,,false,10000,0
b194b61eb54aa00751d45468d904ec3be75e3383d7caae0aa286f972e150d6a2,986663,2020-09-27 10:15:33 UTC,112691691,112683151,false,8540,0
380ec1f2142bd7d3acc370921a91d92f5312d84687da06951f81cbd2f8ba66a3,986662,2020-09-27 10:15:15 UTC,62101761956,62101746376,false,15580,0
555746eb898dd9539b9400b671ba9befe0b480666734cb7baaafdf38fdc37743,986662,2020-09-27 10:15:15 UTC,42363571,42318811,false,44760,986661
8531588d8a1c9eb8013d0000eb872b51261cf77e92f2854263d5c591eac81634,986662,2020-09-27 10:15:15 UTC,112720843,112712303,false,8540,0
ab9ff941a2edf1b9a8feb244e0100a6976187865c029b2e1f67688cdc2ff9900,986662,2020-09-27 10:15:15 UTC,98635185500,98635115500,false,70000,0
260e29f04edc70da34d189320558ede234bd381a543f5a2f02c824df75961aac,986658,2020-09-27 10:13:29 UTC,7020291798,7020247038,false,44760,986657
18e636ca3beb5eb3a4855d85e22f74fd42b070fef625a2a67059ed7bba6d57ef,986658,2020-09-27 10:13:29 UTC,10000,,false,10000,0
76a08884c516c3600adfed5177c662043b8347e403e4b4a9a60a62da1034348b,986658,2020-09-27 10:13:29 UTC,1386280954,1386236000,false,44954,986617
96206e987d3d1f1a86764c87b9f2a4c9e1a4a834469774c2c33735f75d4f2b1e,986658,2020-09-27 10:13:29 UTC,249097392,249093819,false,3573,0
f3f2cdfd610a947c49fdbe14d642ea4daa07e30018bc62ea07fb78bfe05718c7,986657,2020-09-27 10:11:12 UTC,240085212,240037295,false,47917,986645
865c1fccc8ac2f3457376787dcc9772b166eea44db655066789e0500ec7728f5,986657,2020-09-27 10:11:12 UTC,169061503,169040538,false,20965,986645
4d4d6b91beb912896cb9a7539e7edb9f983228b82e07a430ec9b294a723ef400,986657,2020-09-27 10:11:12 UTC,10000,,false,10000,0
fbccc04eb615bfb5aab437a460cbfb6fd1befd2aebd791e4c81e858959856c31,986657,2020-09-27 10:11:12 UTC,144948187,144938187,false,10000,0
d4ad4e12e5533f8850981b84939ea8e2ee636df863e27aaacd72f52da34ca083,986657,2020-09-27 10:11:12 UTC,544545359,544539359,false,6000,0
f9498d4477baa6c4688207f0d0d0826e3aadd33cda1a3fd06c3a47588eb9c97f,986656,2020-09-27 10:09:46 UTC,68008701379,68008701279,false,100,986644
76344635b31e8e6676318d9458481d58d5e05b1b7bacfaa357b6f71433e2ca41,986655,2020-09-27 10:09:43 UTC,10000,,false,10000,0
951faf0d4e1b2e95eeb5babe7c1fb4d348499ccea999f19992ece708d32b660d,986655,2020-09-27 10:09:43 UTC,10111145114,10111140614,false,4500,0
f1da85df688096bf6d364c95735bd1523122b6a5d4587a610fb11af0e04cc7f0,986654,2020-09-27 10:09:01 UTC,2000000069780,2000000000000,false,69780,986641
3a3cb5890b285cd035ae5518a2daf6c5c1283eeb0c88cd3b1bfabb4ff1a1ea66,986654,2020-09-27 10:09:01 UTC,1599614784,1599612248,false,2536,0
00e2949ddd76e75f37aa33004cc46ada40504995ab7817b4bff1f7f1b526a11f,986653,2020-09-27 10:08:28 UTC,10007383893,10007379393,false,4500,0
719d22e59126024df14e7c65c8bc4e08e890f2d783622cb84c9555491cfb6955,986653,2020-09-27 10:08:28 UTC,10000,,false,10000,0
3cf509403b19fe60116c9ef6a54421a58647c3abb84977db28323e151e5d5495,986652,2020-09-27 10:07:44 UTC,17354914079,17354904079,false,10000,0
2f95aaa1d6187f9c41c4062f07559e47e73ea69f62f48491bd9d5f126af399d2,986652,2020-09-27 10:07:44 UTC,1348120593,1348040593,false,80000,0
8436ffe69129fd1710e710728dff9848736235f9360567e6137e34d1154dd3c9,986651,2020-09-27 10:06:53 UTC,112763022,112754482,false,8540,0
7f36d1d557e9acfd051d09e932814fbd80670b92cf29e2fee06c86e8602c57ec,986651,2020-09-27 10:06:53 UTC,1599624104,1599614784,false,9320,0
12192d8107b86eca45e48bc87c13476e2258ff2244a72ebc160d880f4e81dc8e,986651,2020-09-27 10:06:53 UTC,46493342,46489157,false,4185,0
13fb106b4921913447231781c5832f4feacf13b471d70499022dd980756bc0cb,986651,2020-09-27 10:06:53 UTC,229420142227,229420132227,false,10000,0
c8ab54ef5a71a41d6f39b75926ca82ea4d53e373bb1ed1aa4ddb080515c91fce,986651,2020-09-27 10:06:53 UTC,10000,,false,10000,0
dd6e1f6385d70a7b66236684a027becf5aa1ad76284fc41d0571af08228e01fd,986651,2020-09-27 10:06:53 UTC,11992367378,11992355003,false,12375,0
9a9c66e9bf25ec0647c78f6cbbc54415ed769cd26db6b76f78b044cb4118fe39,986651,2020-09-27 10:06:53 UTC,2500113819,2500103819,false,10000,0
d50c26c1d1a512edb01c7434d87039afd7496cdb897bbd3698713c49c06f1172,986651,2020-09-27 10:06:53 UTC,17358733786,17358723786,false,10000,0
89972c2bb0308a8136497147d26d35408371db4099c7b4299384a78d16be1363,986651,2020-09-27 10:06:53 UTC,112804871,112796331,false,8540,0
c05a1bebfcdff864e2b26e4615b55a2ef1a920aa7713702966876d06503c2207,986651,2020-09-27 10:06:53 UTC,1386256290,1386246290,false,10000,0
bfa824df1192a4329e828622cafc8c331e732df0abdcbe292dd1a583d006fd5f,986651,2020-09-27 10:06:53 UTC,1000036780,1000026780,false,10000,0
c6c46909908fd5f1282ff46e5e21971aef9cff79ce8aded5c8c848ddfc1e3ad9,986651,2020-09-27 10:06:53 UTC,2500357475,2500347475,false,10000,0
8751b980cbe009778c569b6fbb628aea759eb0ce54fbbc634bc105564ce0a751,986650,2020-09-27 10:03:18 UTC,55637241,55627241,false,10000,0
3cb5028c01ca42f4cbe4e201174feb857daa674f34c8699ebf15ceaf90e23434,986650,2020-09-27 10:03:18 UTC,2077073740,2077071657,false,2083,986639
3623ab063f9deafae499865e693ea295429806bba86ffc8129a149a95882a979,986650,2020-09-27 10:03:18 UTC,192432094,192430002,false,2092,986639
ac726734922a0482ae2896b830ab1c8475a3f41c3514d8533ccf203cccf7f344,986650,2020-09-27 10:03:18 UTC,241245823,241191560,false,54263,986639
fc3153b6c875ad864682d0a204d53d3a2d82383d7b9ddba19b09e39cd5e8712d,986650,2020-09-27 10:03:18 UTC,212343457,212300187,false,43270,0
2e2214ab6d893620beca14b212e2acb425ebf6c05fdc62666e5434518872e39e,986650,2020-09-27 10:03:18 UTC,547924950963,547924948871,false,2092,986639
8d13dab0f90b0b48e63bbbeb9353a2829742a44c875081b07f62ecf94d28dce8,986650,2020-09-27 10:03:18 UTC,10000,,false,10000,0
8f51fb88464c297e54f7d1d359590a2e2dd2ccd89eed1000943c77a61b9f199e,986650,2020-09-27 10:03:18 UTC,23665254019,23665224019,false,30000,0
9e13908f120bfefaa38a4b490f030a784f58ba36eec6f5045679a08f4d20c5b1,986650,2020-09-27 10:03:18 UTC,111925626,111921886,false,3740,0
e93131a003d52cf5a9f3beaf075e3c094fe0d9f3b3d171739603fe6fda18ae9c,986650,2020-09-27 10:03:18 UTC,4760279714,4760276751,false,2963,986639
21edf0f44c9eb446de40e74dda563d9e301793518bae8d7fb1ecdd1533b9d015,986650,2020-09-27 10:03:18 UTC,10000,,false,10000,0
32b2996edf43d1c7497bc8366cd86d49c4ef136ec85e1a39e837fe813651dc8f,986650,2020-09-27 10:03:18 UTC,68274601479,68274601379,false,100,986638
1cee690154145c1e13124ed571bd987fcb85f166e2cf65c587477cb6111b2a4c,986650,2020-09-27 10:03:18 UTC,10000,,false,10000,0
c43934af35296eab08ef65c468c6b056b8113c1674a84b4c754750d7448e8d2f,986650,2020-09-27 10:03:18 UTC,416520822,416518739,false,2083,986639
2ccf877dfbabc287b8b3c3ea158ac15982be9eb19e9ad9dc2e528e8105da4a4b,986650,2020-09-27 10:03:18 UTC,34964000,34960000,false,4000,0
5dcf94855bb63b18d11bb93e3d69ee3c2677822aba429a654ec306c2d7085ff1,986650,2020-09-27 10:03:18 UTC,169639860,169619766,false,20094,986639
3611d8476927cde85c1ae403ae46ead13193adaf1136aa8a152221c9f8268ad5,986650,2020-09-27 10:03:18 UTC,3447144397,3447141434,false,2963,986639
5630838333c35b87640051594b7b948665258a9621e7846351b7b1018c4b5f78,986649,2020-09-27 09:58:14 UTC,10000,,false,10000,0
b1c4253d25fba8bac59f8ef2707ed8ca2f68a5346f9ac0375aafd39f8e1ddbd2,986649,2020-09-27 09:58:14 UTC,113278911,113270371,false,8540,0
d51d98cb35acdf25ca7995935f8d673e4c3ae55b498c20864a262163ec6c67e4,986649,2020-09-27 09:58:14 UTC,1386266290,1386256290,false,10000,0
2aad22280056ae74f71d2b3837a53d337d9b3ff3394289a2dbbc584414e1406a,986648,2020-09-27 09:56:38 UTC,249390756,249387489,false,3267,0
97a081824ec21123d89e703984a31bedbf1b7987c33ff31d925c329242bd1439,986647,2020-09-27 09:56:03 UTC,18176000,18166000,false,10000,0
8d891f56ef1a7c51e148ac06a1c825147b917f8022c01cc25b9b0719c3b2cca7,986647,2020-09-27 09:56:03 UTC,46698271,46695004,false,3267,0
8796b493d5efe677b8d8f6ea1cd5df6fa5d132aceafd7ad1624c7137ae0ef59c,986647,2020-09-27 09:56:03 UTC,11506306843,11506296843,false,10000,0
c3862e39526062335c892ebd716471c7fa4dafb514d577e92838da09247d85e2,986647,2020-09-27 09:56:03 UTC,10000,,false,10000,0
954669b43b348061637019ecbc2c23b54bf1fa12e856548e53e4ec7c02a7cd76,986647,2020-09-27 09:56:03 UTC,2155124,2146738,false,8386,986636
dcf3eb26106841f99660fc7d9c4c405dae2d6aad34c61fca5fff45a9c7ee24ed,986647,2020-09-27 09:56:03 UTC,10000,,false,10000,0
321dd81badced225afa843f0e61d983b71f1ae094e43404235a8ed14ef1649cd,986645,2020-09-27 09:51:55 UTC,10000,,false,10000,0
1743743d5be84a062f80f47899262ad2edc7882065530c65a244863008ebc08e,986643,2020-09-27 09:50:48 UTC,170195650,170175291,false,20359,986632
2cde3af54d0b5b053427d7cb7bf72b5ba1192c5f82e0e1c24ec637d2194996e5,986643,2020-09-27 09:50:48 UTC,551536548344,551536546252,false,2092,986631
3a63f8d5d52a9bcb174adee6fdf72fcc84fffa52fe36e0b2c74afb8a39de3919,986643,2020-09-27 09:50:48 UTC,19262498,19256623,false,5875,986632
5f2a87bc300e190e1fdad43897379419391aabbe0abf97232591d465180c1a15,986643,2020-09-27 09:50:48 UTC,249658969,249656009,false,2960,0
20451aeb009a601317d3b65a33156ee7bcfaa4eddc32370f8eea11165e00c8d3,986643,2020-09-27 09:50:48 UTC,1000089224,1000079224,false,10000,0
a48e0d44cea6e290a56c43f38ba5000978c49dff59155640ab8a44e5a6810baf,986643,2020-09-27 09:50:48 UTC,469807677,469805585,false,2092,986618
de4a67daf0f6174bd080dafe351959a5f467614bea816363fda855fb77940964,986643,2020-09-27 09:50:48 UTC,17358743786,17358733786,false,10000,0
c7e75cb49dc3c4bd2c842aeddce32b8bf39469946312f83293cdb73d48297207,986643,2020-09-27 09:50:48 UTC,10000,,false,10000,0
40af3761c55b8ddbf7b4a2450eedd2f0c026df6e1f09227c103f61117353089c,986643,2020-09-27 09:50:48 UTC,242260398,242208672,false,51726,986632
61b76f865715a0c66a2e6c8af297821e248b15d8cfc9d953939b92755454e36b,986643,2020-09-27 09:50:48 UTC,113322010,113313470,false,8540,0
079501bef3a81860c2151c25ffea00f6ce9a350dc9b11345d1e110781b98df22,986643,2020-09-27 09:50:48 UTC,144576182,144496182,false,80000,0
38b0d8a730203a61bc56571f701d90c6191e01c1ccea779eb2d62f967b79176c,986643,2020-09-27 09:50:48 UTC,499990000,499980000,false,10000,0
a727309a913f78288890ea8932580d65c5338503d365550c0e7ca50601e55493,986643,2020-09-27 09:50:48 UTC,500105659,500095659,false,10000,0
bc3bf7f056e7fe27eea748cb15425e8f391a719738d13206bb301a7ff920b008,986642,2020-09-27 09:48:42 UTC,78580121,78578201,false,1920,0
1abb9a469aa7d9b819622cba910453986b27a9dc0cc12e2f20fd7d6123a47996,986641,2020-09-27 09:48:13 UTC,499980000,499970000,false,10000,0
6689f124dc5c5c1248b7a9d2c68a2d008b09f1508949bd2d8d3f19f4a0db5a69,986641,2020-09-27 09:48:13 UTC,1014268001,1014168001,false,100000,0
0908f55d86917185f0cac70d2bae9b581c421705270e68e060761f43c1cf0e2b,986640,2020-09-27 09:47:31 UTC,49994481,49988043,false,6438,0
8b812d143d8b9fcd565fd0c93686fa73dde37dd1545c27ab625a0be0f01f57ec,986640,2020-09-27 09:47:31 UTC,21324,18894,false,2430,0
73bc6c7b948e9899c98978c2b40057a66472e0e83a7f03a4753f40014e797f1e,986640,2020-09-27 09:47:31 UTC,131510884,131500005,false,10879,986629
83545eb168168058f7acbbf0651169efe7959c6345f0c3e196836f7aae2fc776,986640,2020-09-27 09:47:31 UTC,10000,,false,10000,0
1e84319ddfb31a01724814cd19ecd2b75203c0e40bb63fef57e14b667505cfb7,986640,2020-09-27 09:47:31 UTC,46455289,46448159,false,7130,986628
753dbee08ae35ff1b6e1a6f0231a468a8aa72d3512142da77ed4bf6fd04402aa,986638,2020-09-27 09:45:18 UTC,10000,,false,10000,0
73015c80e967d0c585669d15bd164465e599893e221e60a45e9ae8cd85ebd6b6,986637,2020-09-27 09:44:42 UTC,10000,,false,10000,0
7205c2c4f0b152958b0b96377b7c8652ead900326271c0dd0335e12cf425f2cd,986636,2020-09-27 09:43:03 UTC,47400170,47396903,false,3267,0
a21a8afc11f8132c4ba62ea2a4bcb40cffc871215c76a25f10284d5304a58ee2,986636,2020-09-27 09:43:03 UTC,3402574243,3402567243,false,7000,0
bb43d6b95406f4aed09d9383b200bc5505701f6807c220235016ac6cd987bedd,986636,2020-09-27 09:43:03 UTC,185730768039,185728883352,false,1884687,0
6d4fe514a0dd17ef8bb8c052cea17ad9613c174a13d96ab8ea944aa0c5d23d0b,986635,2020-09-27 09:41:58 UTC,551916550427,551916548344,false,2083,986624
e9b0b19e5fbbb023c0f4b26d5bff7e1a0d3f391e254fc5ce0fb31ca35748f79f,986635,2020-09-27 09:41:58 UTC,2601110940,2601075147,false,35793,0
53d9d008da0a916d4892ec85645fd030f06b94d0f5cd9463d653991703c8d05a,986635,2020-09-27 09:41:58 UTC,462302,455462,false,6840,986624
2d139b3ecd198f538589804e02b6352ce04f7e57ce244a084cccd436b79781ea,986635,2020-09-27 09:41:58 UTC,1386276290,1386266290,false,10000,0
73903f4e5ec5e6a4c1b5404e442488c66a9367b330d2e92eca186f78085ad843,986634,2020-09-27 09:40:24 UTC,243402749,243358589,false,44160,986623
b917e0edd429bcdf69d781a78d7cab52049e5d80e010d6e3e5b91327793306d2,986634,2020-09-27 09:40:24 UTC,1051502400,1051500645,false,1755,0
8c4a1b839bd8b31c55a73622bf9f07db4c739faefa7bbe098d5ea3ef3467a8d9,986634,2020-09-27 09:40:24 UTC,113355114,113346574,false,8540,0
711f0188ea930a0ecb5950bd599c1b706c9cb9e8bb3f8dd7cae77b09ba52e230,986634,2020-09-27 09:40:24 UTC,170601524,170584351,false,17173,986623
54ce6d37bfd137997d36db27d95d306b28106bcf644d7b3223af3235b45a8316,986634,2020-09-27 09:40:24 UTC,249821325,249818365,false,2960,0
b069b9a7aed3c761a94c2a55a4be9cb676fbd300e342b901a6926c28abeec64f,986634,2020-09-27 09:40:24 UTC,10000,,false,10000,0
588d49b4076090bd9b0c3dfcf446c47625f6ea4161409a2a96d4817a570bcf6e,986633,2020-09-27 09:38:54 UTC,500115659,500105659,false,10000,0
ce55d681d43e6df0e255b827e284e7e932dedaeba4387903fd6bc9671f179373,986632,2020-09-27 09:38:12 UTC,4559100000,4559093000,false,7000,0
0106110044d5c493bf5f7261a918504e3ee4877e7918501beeb9658710b0d626,986631,2020-09-27 09:36:55 UTC,279132,279072,false,60,0
dd87dc4c03a0a97086c3844b92c384e8eddacb565db25ea066ab6f0b2db8530a,986630,2020-09-27 09:36:50 UTC,499990000,499980000,false,10000,0
ed7d598b32867df5a69ec7f88c1e66778d764e04d73c4417e4d5d180215b9103,986630,2020-09-27 09:36:50 UTC,2160602737,2160602285,false,452,0
24f4921c797fe0aef6522ad09a6d4078c9351ce96c53709c2458728ee6de0e8e,986630,2020-09-27 09:36:50 UTC,10000,,false,10000,0
8afa92cc795085f3cdc75a91c613f8d74243b611fbac1165dc992328a2a43f29,986630,2020-09-27 09:36:50 UTC,579445393919,579445391827,false,2092,986619
f352be4bb41e3db94804d333dd23d58d24a55027c711e57aadddf7f4d830f4cb,986630,2020-09-27 09:36:50 UTC,77118799,77116879,false,1920,0
bbcc37d4c3c259e9ae7d9667aa59c39b5e473172bb800c27a514edca48b8ef80,986630,2020-09-27 09:36:50 UTC,1000099224,1000089224,false,10000,0
cccdc1c3f5d513f807ecefb5b80263b9484a7e317803d8489b4b457d29663858,986630,2020-09-27 09:36:50 UTC,500125659,500115659,false,10000,0
bd0c335072c80587a0aa00bcd3725d429d4c8df085e8fb6ad0f9310f4cdb35a2,986630,2020-09-27 09:36:50 UTC,10000,,false,10000,0
e2489c548a9b06e40c98f48d661b89e005cd6dcffdaa4a7bb9af6ac201c2f754,986630,2020-09-27 09:36:50 UTC,96000000,95998080,false,1920,0
921a6eb44cf8129867bb7795c7d6bd9bb08102c0b6a4f38c601d04c45dc3fd1f,986630,2020-09-27 09:36:50 UTC,1000133954,1000123954,false,10000,0
1f51986aa3639da1d7824229caaf121fbcddf3be137f338dc6371b2d7394a721,986630,2020-09-27 09:36:50 UTC,113419660,113411120,false,8540,0
180f3c448b4a133b4334006232ee473ef8a9a27f2051439e8c1e5d0cfef80cf6,986630,2020-09-27 09:36:50 UTC,500000000,499990000,false,10000,0
a0c2349fcdf765f6949008cb6343c6cb89ddbfc74fb821cdcb0eca9302fde8b8,986630,2020-09-27 09:36:50 UTC,100000000,99994000,false,6000,0
95da25f9a8d7abe72297fc4176b84a5742b9fcb533ca6d71078d48fcace44659,986629,2020-09-27 09:34:19 UTC,4559110000,4559100000,false,10000,0
79e9d64145c30afc9016250c9c6ec0cd558e304e56c867416fc9ba506c827c1f,986629,2020-09-27 09:34:19 UTC,100193700,100183700,false,10000,0
5c05973a44978a2ffb84dcf65779e04048add9c2e5a9c4f695db6c0a390559a6,986629,2020-09-27 09:34:19 UTC,500000000,499990000,false,10000,0
e0adc4b06d429d748b41497817f85a3b49e329bff6d47c4193da4d04a759ece8,986628,2020-09-27 09:32:47 UTC,10000,,false,10000,0
9622bf1ea6284377eba2e795a9d9b5fc1e7aba4770debf61de8e1494ffc648f2,986627,2020-09-27 09:31:36 UTC,10000,,false,10000,0
6c5faabdebf41b4978fc4d56e0b93a0979a3ac22635ba2d53cd08603717da271,986627,2020-09-27 09:31:36 UTC,10000,,false,10000,0
072d88a47543ba1daa12ede5541759ef8687cf75ddec35b49e572a61e83adefa,986626,2020-09-27 09:31:09 UTC,10000,,false,10000,0
cb8d9d1f8d3b24a633378524d8eec6ca955f076cb059016569235aa81e099442,986626,2020-09-27 09:31:09 UTC,237440,234990,false,2450,0
7a86a527b1a20576f1f4d12df594f0276e8e1d2be28fc03c9aa524ba0bc4c293,986626,2020-09-27 09:31:09 UTC,144592785,144512785,false,80000,0
a60fcd0d37e7c97c2d2794e1d77347e0c3592ec8df2ff048b5a734aff070c4db,986626,2020-09-27 09:31:09 UTC,244417120,244371209,false,45911,986615
379ac076ccdb3bf9f62d6dce4c30dada84d79c9eafd08d70a893f31bbaf04fc0,986626,2020-09-27 09:31:09 UTC,171061148,171043394,false,17754,986615
27267acb5de4bd5d6290f0b63f15b6b55ad99e41f7db0f8f880dd29d5498e41b,986626,2020-09-27 09:31:09 UTC,118385817,118382077,false,3740,0
686d2d15d0de7f5a205b196bf5e065197116f9602acd3188e89d9f7d8a0c8cca,986626,2020-09-27 09:31:09 UTC,47552400,47549440,false,2960,0
916d433e738f338168e2f1ae4307b9be7c94e42bfe9f19465a0addf483480692,986625,2020-09-27 09:28:27 UTC,110945301,110943209,false,2092,986614
8bbd377fa58cb6fd68a13034f2ccec10a32287ccd797193e8035bff3f1dc57aa,986624,2020-09-27 09:27:32 UTC,7831774244,7831767243,false,7001,0
fa651a89c3cc44174463498321631aa5a12cff8fac382afe813e29d116650d9c,986623,2020-09-27 09:26:43 UTC,100507438,100497438,false,10000,0
bc1372ebac63fd538e9ecbccde5bbf842f362dca5d7de177f159b6b63f25ee16,986623,2020-09-27 09:26:43 UTC,182825,180375,false,2450,0
375d67f83134d04bfac3535abb3673e2666b8fc50bc781d9f39686702b008108,986623,2020-09-27 09:26:43 UTC,552748438,552738438,false,10000,0
5663edfbebabf943d4e498b820ad72237f88ff6dfb9173e6c4b8518bd726e035,986623,2020-09-27 09:26:43 UTC,250016262,250012995,false,3267,0
554f986c092689c8803e4bae5e5f752b2de78dc38a65738b35cd3b350a826157,986623,2020-09-27 09:26:43 UTC,10000,,false,10000,0
5945e8fc3c50318d38c3e4bd337fcfd3d7d5264c0b58ca48c30cb8456dec4ead,986622,2020-09-27 09:25:48 UTC,4429210000,4429200000,false,10000,0
d06fe8b361aed7c644df97397efb3b2728c9165943414e25b32f85e8fdab4aa1,986622,2020-09-27 09:25:48 UTC,10000,,false,10000,0
fcc1161ad08f4417ae523cf17d0926a92bb837c93ac27e0297f80e9b06028099,986621,2020-09-27 09:24:19 UTC,10000,,false,10000,0
10b48cc0d9d90474e4b89bc2593c11296bd4e4898090de02fd45f71eff9b4225,986621,2020-09-27 09:24:19 UTC,62257046,62244491,false,12555,0
a5aaf4529a85c14b3f2dab3177ffd0faf8c4b1b2c182879fd4ae7c1a752d2a1b,986621,2020-09-27 09:24:19 UTC,10000,,false,10000,0
847a1ee139519b1e83322c98a0e5895af95b4cae7b2a0b5ad92863330b16cdd3,986621,2020-09-27 09:24:19 UTC,68308974579,68308974479,false,100,986609
30e398a04a3b04c9e68638976495ca29f42327b713a69948a560e70e45884ad4,986621,2020-09-27 09:24:19 UTC,102188730,102181591,false,7139,986610
47b2f241311431e84b642acdfe466e380509933d35b96edd2d3c0c03cb2a3a9a,986621,2020-09-27 09:24:19 UTC,171540544,171522798,false,17746,986610
8979ee2b2d56e76e88238bfef5e984edbe4d5c923e2f15c7b2b3815ba995494a,986621,2020-09-27 09:24:19 UTC,679379896011,679379893919,false,2092,986610
4d706ef36cd293aa2e7643102574a7153b25db1cbf86a21ec60c4b37abc766ae,986621,2020-09-27 09:24:19 UTC,1558856824,1558854732,false,2092,986610
a7118fea61eefc87e2ef3346fe766f3c877c0255195aa6820cd9b85d28a06aa0,986621,2020-09-27 09:24:19 UTC,245481870,245436241,false,45629,986610
aafd323a731ab0770948db13693d26b0b81e8144f3129bb6e36142fafb170e57,986621,2020-09-27 09:24:19 UTC,61472777642,61472677642,false,100000,986526
efe5c2e916e33f8afefe8c50b08e4ddec655f812ca02cdd37b0fca4f13fb93dd,986621,2020-09-27 09:24:19 UTC,21462,19012,false,2450,0
4429a901156b699f77ede73c53e42bc5c071e76d9870b905458745f67db15f2a,986621,2020-09-27 09:24:19 UTC,10000,,false,10000,0
7c07aaa501a334d5ddb5e76b323360c4ab4377542a59883a009565ee2d6c889f,986621,2020-09-27 09:24:19 UTC,47744583,47741316,false,3267,0
1f35285858e74fb304b0a0311adc81082bdf571bc267a8e12611f325b15d63fc,986620,2020-09-27 09:19:42 UTC,117206994724,117206979144,false,15580,0
7d36661672b23de272a909523a3ab72f54deedca85f8f5d55606867dc1970a17,986620,2020-09-27 09:19:42 UTC,1245004,1241657,false,3347,986608
47c26362acf42bf167324a648a47af6f72d165736b8c1a5def131ed52fc3286a,986620,2020-09-27 09:19:42 UTC,118197,108197,false,10000,0
2ec550d8e8fe2fefa0377c0da600444d901d9f9cd8f9b9d2b71461f08bd6b8a4,986620,2020-09-27 09:19:42 UTC,10000,,false,10000,0
b19950e07a9efe6decc9786fa3ab702ce7360213218cd76c66409af6224e03fc,986618,2020-09-27 09:17:23 UTC,10000,,false,10000,0
99ccf7dcc8fd32ed605c922e18acfb7ca3e3a3eb06c5b6f8cdc41a2677c14238,986618,2020-09-27 09:17:23 UTC,232253253085,232251160117,false,2092968,0
f983801ffb960e9b1393b37a28cea3b04d2d81dd19f72b50ebf9171ab7ccad4d,986616,2020-09-27 09:15:36 UTC,499980000,499977917,false,2083,986604
002b1e37bbacc627d267f755160bd813c6d96f993ec384d0aba094bcb83adad9,986615,2020-09-27 09:15:31 UTC,36545936,36535936,false,10000,0
8cc3b343ecd6119b98754a97a4afe76ef3842a4348dab333c48062a40de49a09,986615,2020-09-27 09:15:31 UTC,2280209089,2280209018,false,71,0
420dca526abff1f475f70ee93a80616d39fcca1f35afce6bf268b69e97809c06,986614,2020-09-27 09:15:05 UTC,680189448103,680189446011,false,2092,986603
3ff13999e31468951bf0f8595245de984dc28fb329167d561e5be2651a139662,986614,2020-09-27 09:15:05 UTC,1349592242,1349512242,false,80000,0
87a53e27c30f6c19e7c7f393c9bf6e78aa7c4308608baa8f7c34e28bb8de11a5,986614,2020-09-27 09:15:05 UTC,250428914,250424423,false,4491,0
f8171475cfd7edc2f7a78b5578a23bfe46021163319e31685012b3a6ad0a6ddd,986614,2020-09-27 09:15:05 UTC,48001333,47998373,false,2960,0
05ddccfc977098bee0b9e27b2d20b888d166ab7e1449938372620a928abffbac,986613,2020-09-27 09:13:44 UTC,113550937,113542397,false,8540,0
fb06d017fcce4f4656d6f34b3ab2d0ad69b7126db53997e8cc4645f7737b7dfd,986613,2020-09-27 09:13:44 UTC,10000,,false,10000,0
bed2a599f5e7821107c52eed9090cd9731f1f04276168d1e5f627ce1cc1827df,986612,2020-09-27 09:11:30 UTC,113668340,113659800,false,8540,0
16d074bbb095a2bd5808db04d0ec651a37cf2c3d3a0aa1e76683f59fe380e11d,986612,2020-09-27 09:11:30 UTC,113609164,113600624,false,8540,0
91d399422a6ca27bc9137a5c0bde6d658c57f3cc0cc1b6137862cae87377c1b8,986612,2020-09-27 09:11:30 UTC,10000,,false,10000,0
0f55f2b4fb47e168cb2fdd92f64b949bc5134653a4dd6a1f7b1e0c1eeec922a9,986612,2020-09-27 09:11:30 UTC,172132089,172113746,false,18343,986601
6040b011089457f3df28bc9dda5cd938b4f5e173511971f5cb7781a46da087f6,986612,2020-09-27 09:11:30 UTC,58797550,58795100,false,2450,0
fea099f6ecbc254763efe90a85b01a2a75f0275a9513d5bcb8b96174cbda6057,986612,2020-09-27 09:11:30 UTC,10000,,false,10000,0
a20a30c5210152b23420e257320f22ee4728c0631d7ee819c0fd08a0368fac7c,986612,2020-09-27 09:11:30 UTC,1000002350,999992350,false,10000,0
28ba68e45a720a447b79da2ae5dca00401164e77edb2cc7b9cd6861f7eed82de,986612,2020-09-27 09:11:30 UTC,48230762,48227802,false,2960,0
0ccfe3059eed6374b2e7e9f319a6c707ea44b1256a0bfef8ea89ac01c466c0ae,986612,2020-09-27 09:11:30 UTC,615147393,615145301,false,2092,986601
e307bff7da03ee399dde5c65745033ff5c525d21407ac885da4a5ca4c4ead8be,986612,2020-09-27 09:11:30 UTC,246655334,246599859,false,55475,986601
6daaf3416fa4afc2c7de0714a1697d6909ef98366ffd441fcbc256b966f11d9c,986611,2020-09-27 09:06:00 UTC,2223682418,2223681323,false,1095,0
7c00a3cbc0feaa6d4b45a8b3d565cfc1bd81fe95efb36aa1079da257cc2139de,986611,2020-09-27 09:06:00 UTC,10000,,false,10000,0
c292694e07f721b7bd26e311ed5ad5ea0ef1d6972adbebd2b6b7c4f638095ce7,986609,2020-09-27 09:04:50 UTC,250572076,250569116,false,2960,0
36044c4f3aeb4d3c6b820af9beaa0bd39075a0371a413a274cc62329ff62ae35,986609,2020-09-27 09:04:50 UTC,681389450195,681389448103,false,2092,986528
7c1c4789b593f6bf149e3a3ee9c69b0997a4240fd289da279eac2e437629be5f,986609,2020-09-27 09:04:50 UTC,16950278282,16950268282,false,10000,0
e4e9fc84601019868fde0893baee708d9bc6660ee4ab034390ff7147b97b3194,986609,2020-09-27 09:04:50 UTC,10509751,10499751,false,10000,0
c8774af2f0c2c1be8dd36b07c5907307d14eac2f89d27cbbc59f33895b627222,986609,2020-09-27 09:04:50 UTC,111936766,111925626,false,11140,0
3d4cf7a6e253da745890a713bba59fa0b007d03467089f84f452992f101e0850,986609,2020-09-27 09:04:50 UTC,10000,,false,10000,0
26b856bd01016440d0b4c240c9c334af43c1d0dc7b1b225db74a4bcdbec1bf08,986609,2020-09-27 09:04:50 UTC,1000292579,1000282579,false,10000,0
124b3b84c81cc27c1df980028e219653dc9385c06fa43c6c2dcd1271bc87f4ad,986609,2020-09-27 09:04:50 UTC,25621642,25619344,false,2298,0
33c078abb0e56c1d6c794ca766220788db8b7656a6823543fb352d157638aecf,986609,2020-09-27 09:04:50 UTC,2500123819,2500113819,false,10000,0
2237d9577784d6cf1af0f5d904b916f73c77969e90329e7144be6273b5176dd3,986609,2020-09-27 09:04:50 UTC,247998399,247991288,false,7111,986596
c4ebfca4e529756f7bdb17f98aba45794aef9f2a7ae020f037cf9688f237dfe5,986609,2020-09-27 09:04:50 UTC,240120883720,240120873720,false,10000,0
51a72087fda9d92a6522feefa9ca9380f9c455d9b521724876a24e35be9a1e70,986608,2020-09-27 09:02:13 UTC,9999500000,9999493100,false,6900,0
cb5709cfe7aeb654578b7dedcc89f9b18757e44ff097bd9a9bdacddc94f73c98,986607,2020-09-27 09:01:44 UTC,10000,,false,10000,0
a93d8241ac61a2c4e79652345c91611d2ea160450405a2d4f269e6d7803d4f30,986607,2020-09-27 09:01:44 UTC,172535704,172533589,false,2115,986596
8ea3ee9df9b77986741e0991641489d949418deec4fd5b959cc3052407dffc4f,986607,2020-09-27 09:01:44 UTC,100000000,99997550,false,2450,0
e64da4d074dcc104ee72cf54bf1b2d2e1e3764558b1ed02f9526e8218a0607fa,986607,2020-09-27 09:01:44 UTC,856592405,856582405,false,10000,0
8d26c113c949a9ea3feaefd04ed661c20f80980ec7bd2c34896c6b1fa6557d70,986607,2020-09-27 09:01:44 UTC,10000,,false,10000,0
a20bc7ec29ce97ba7c2fc37bf80230ccc43fd22abab06387b0582b299d20a234,986607,2020-09-27 09:01:44 UTC,45310486,45309356,false,1130,0
4782d425078cd9d40dd42d2d06b1efff6110c406775321dfdf9094258ce3e573,986607,2020-09-27 09:01:44 UTC,500046514,500036514,false,10000,0
ca44397b75134f608f71d1983dec4a8e761241e71e896df42a7a37eb23914164,986607,2020-09-27 09:01:44 UTC,72465754820,72465742445,false,12375,0
ca9ce8c1600945044c40f78de7e227f0c15e7a3921688106ffc25c291d59d714,986607,2020-09-27 09:01:44 UTC,291239890,291237440,false,2450,0
7fda98de19cc83b5d4db3f610a7a74e4864f3a346dabdcd4439441b03727e54b,986607,2020-09-27 09:01:44 UTC,114110343,114110067,false,276,0
a42501d2c54e4b07a6a96e14c0fea4ddaf6eaaed5a2c7c441b820270de2ee705,986607,2020-09-27 09:01:44 UTC,48377873,48374913,false,2960,0
4fbff6b4ef8956ac1f9d666cfc9192c41cbcd1bc29085d32763445bad6864cd1,986607,2020-09-27 09:01:44 UTC,113883957,113883681,false,276,0
e3534707340610a52b05a61e6021b7ed4d617ca78cc2400c326c418eddab06a9,986607,2020-09-27 09:01:44 UTC,3500471180,3500470833,false,347,986596
899a72d8583105e9549f3a502716a7ab9b773a04c3c4e2f5cb644e0916e33bfe,986607,2020-09-27 09:01:44 UTC,254281626,254278053,false,3573,0
2c40a21d3515b9a9af03f9b3d76acd7c090366034c0746157ac1381202f57a85,986607,2020-09-27 09:01:44 UTC,113856023,113855747,false,276,0
7ccb63a2a21570733cbf93efbe1bd5a6c663c0a6a92b1460c3acca1440d802c2,986607,2020-09-27 09:01:44 UTC,43848899,43848620,false,279,986596
76f06be9a164bb49064f83cadccfefac4a6020ae5cfb4eab2d523c90558b4103,986606,2020-09-27 08:57:37 UTC,114304849,114304573,false,276,0
1c64efc7aa307853aec33e0500e9a4032ca836b82862f7937633c38f331d357c,986606,2020-09-27 08:57:37 UTC,10000,,false,10000,0
944a9f35b0f93b9ac32a4c9d609a2fa2e9d23574a57d3687b4fed17e8db425a0,986606,2020-09-27 08:57:37 UTC,594487401,594407401,false,80000,0
49c68a5c2751de08a36d1534d91e091f56031136e8c141ab3798d57de9e7009b,986604,2020-09-27 08:56:59 UTC,500000000,499990000,false,10000,0
4047ba1a25718296c900c4c2873a1c7dd6415a70378030d05d57ee6384d09437,986604,2020-09-27 08:56:59 UTC,138809,114809,false,24000,0
cd2b37ea84c66481bb93636e2a8f3f0cdd342eaa286b99e75b41742d2fd0d154,986602,2020-09-27 08:56:13 UTC,477810225,477803445,false,6780,0
f58e43568f93cad1091518588689b7b3503c5436dd6466a742aeb1cd0c05b979,986602,2020-09-27 08:56:13 UTC,419069958,419063178,false,6780,0
3ecb65f61c235f2bf883074870dcd5898d2590040d6d974edf282e45a54da483,986602,2020-09-27 08:56:13 UTC,10000,,false,10000,0
001bc55b637962f0180fbb2da919225f100faf815cb4b3a6047fe8cf43a872d5,986602,2020-09-27 08:56:13 UTC,26158012983,26158006203,false,6780,0
0d036a3aeaa9f29eb78c1c046b0a5e28ac18bfba4cdb1d3cf12a846857fc165d,986602,2020-09-27 08:56:13 UTC,606654563,606625583,false,28980,0
a3988c906828d0781480acd5a961eda4268dcc3b174c933d7a879ed721f9dba1,986602,2020-09-27 08:56:13 UTC,149870000,149860000,false,10000,0
a0f90bead15de9266affc3214ea2bcb0ae7ce03804440f904ebfef62cff10e60,986602,2020-09-27 08:56:13 UTC,466288780,466282000,false,6780,0
2ec5b99d0cb7fb3f924cdb5c9df3ca3f6750241e9adede1423c824be1237f43a,986602,2020-09-27 08:56:13 UTC,10000,,false,10000,0
598c99570a21d487c5c2b61dd0fe7268fea72d4abf2118498f3f2bd261f63855,986601,2020-09-27 08:54:44 UTC,72485767195,72485754820,false,12375,0
b7d97ec866c1e04de7e5598d0dbc85169439db03d8fa00d7078f0480956df3d0,986601,2020-09-27 08:54:44 UTC,219309,197809,false,21500,0
92162695b8b277131fe60176986844d5e362ea5c1c15e3ee37d6646d0a7966e4,986599,2020-09-27 08:51:47 UTC,10000,,false,10000,0
a786f6365de44553ebfcf6f16596dcac258a68264d53cc79dca730a5783395b1,986599,2020-09-27 08:51:47 UTC,62026589,62024669,false,1920,0
4a14088c57dfc81116740aba7a2af03f8921bee0a51cc00b15b7a953bc594ef5,986599,2020-09-27 08:51:47 UTC,500056514,500046514,false,10000,0
4db2fc8d1a596c418c327b63c8e09fcccc4785a1ebfce1fcecf8da818853e656,986599,2020-09-27 08:51:47 UTC,254496613,254493653,false,2960,0
5b4af4d801611a03a9e73f17118a61aa36717c3cfd7049b90af4278dd4ff6936,986599,2020-09-27 08:51:47 UTC,108393460,108349102,false,44358,0
e1effc7224b165b405330296559dbc5a6c3ca71ebe0e99b0a8175412a1a31916,986599,2020-09-27 08:51:47 UTC,68351821817,68351821717,false,100,986559
6468c1b1285735c1e5d1d94cdfdbe90a423b75a52a60f2e63f43ced1ea0a1d44,986599,2020-09-27 08:51:47 UTC,173084809,173082014,false,2795,986522
a11914546fb68d3a9881974c0915264b26c095dea2a6734bee68bec669883394,986599,2020-09-27 08:51:47 UTC,43804233,43803988,false,245,986588
0ff96e45b9a0f0266d7dfaba78f77144b01b8aa67a5723330dfb818001874a52,986599,2020-09-27 08:51:47 UTC,23710594505,23710564505,false,30000,0
cd7c126b42b010dcc01c43d26565a6cb72ae6ff89d93a324b5de2dfd504400c5,986599,2020-09-27 08:51:47 UTC,248931713,248925768,false,5945,986510
289a93a05b4400669d112451623efff809a5b20b25bb6c557f28f4f622e656a3,986598,2020-09-27 08:49:45 UTC,10000,,false,10000,0
c2d128a915d637b680ce77be71ee3c882977a858579bc592ecd3bf46bf76e461,986598,2020-09-27 08:49:45 UTC,11100721958,11100713922,false,8036,0
badfb829fe04c1dc10345be54533557455da3b29f99f513acff79bcda57f82f4,986596,2020-09-27 08:48:59 UTC,115238632,115238356,false,276,0
a28809c0641761b24960ba43c94c86e5fe573a49638de5d6b50cc104b28777ae,986596,2020-09-27 08:48:59 UTC,199880000,199870000,false,10000,0
25b0d3668aeac3a13ecea6c4d80e23a61ae05ef10a9147da6a0b7641eefe6aa8,986595,2020-09-27 08:48:05 UTC,500066514,500056514,false,10000,0
6e8f9890585ad7b3c14398b3d6202d7d7982c0817f7e77fc8a4f0214cc02e636,986595,2020-09-27 08:48:05 UTC,10000,,false,10000,0
813f8943ddb79aea2caf50cdafe61991d90be20e6d91634f2924e9ab32b089d3,986591,2020-09-27 08:46:35 UTC,2313168473,2313158473,false,10000,0
b744891b283901121139334ce1d0ac19b5366abcb42aece251851734b5b0cd4f,986591,2020-09-27 08:46:35 UTC,677176074,677173982,false,2092,986579
0ca5c796ee11db2acc61e62f012b5e8747cf2646390ef52a0bc0bcd712c55a13,986590,2020-09-27 08:46:00 UTC,10000,,false,10000,0
281e9a6b2e290e133085847c9034c35156c0bd4b988a2e160f3357c90be0c4f9,986590,2020-09-27 08:46:00 UTC,10000,,false,10000,0
31567f85e06e6593a9cf8a8097b86f814c0d21dcdadd9b9200e333e1e78b571f,986590,2020-09-27 08:46:00 UTC,48547551,48544591,false,2960,0
060f373fb311ab0e7400fc4a9141cb0c27f2de5e9f9e6d238ce95cbc80282b27,986589,2020-09-27 08:43:30 UTC,11064850,11059294,false,5556,0
ae4b4502045e156ee6a289565492236436a4dc6f43ff296f679a8acebb387ae0,986588,2020-09-27 08:42:56 UTC,16852902752,16852892752,false,10000,0
f4705c06bf304bae31c188bca65461067d221a9c24839031b2b9df1e09656de9,986588,2020-09-27 08:42:56 UTC,10000,,false,10000,0
f82f2d3c5cd90962ec3ff91fc83776b7d1a098a532989c5ccb26ea42ca1d451a,986587,2020-09-27 08:42:21 UTC,691388952287,691388950195,false,2092,986575
ee4f6797f395c7646755eef405eeaa4785f7d4b8f0ba6bfaa5929959a8efee30,986586,2020-09-27 08:41:53 UTC,10000,,false,10000,0
3f96774c98e2ce018645aab70ac0244e8b588edf64d8c90b31c2c4d47ba75bf0,986586,2020-09-27 08:41:53 UTC,173856300,173831859,false,24441,986574
5f64d9980aa150d4f47b351318212622caa41cdd5b474046c2ee5f4c07fed147,986586,2020-09-27 08:41:53 UTC,616439135,616359135,false,80000,0
33880ec83f166b9516ab39fd3a032801f8b7f991aceaf2fef06421500b1a50eb,986586,2020-09-27 08:41:53 UTC,5067000000,5066997760,false,2240,0
c7724c607746acb652c0890c4ece5b4a280cf4ae467c58ae609d40b220b43a31,986586,2020-09-27 08:41:53 UTC,250249118,250196239,false,52879,986514
794dcc695922f8d32a9a8bcfeaae72224049542d44b2f336cc9c58aec0756d6a,986586,2020-09-27 08:41:53 UTC,103950000,103946600,false,3400,0
017ff83e561f1058c94d71a6dcfb77867c9977398935faecb2ac743962bd40a0,986586,2020-09-27 08:41:53 UTC,17577697473,17577687473,false,10000,0
c957d817efc6b925038e0b7b36e75446cc39b6f6cce02944ac6d3918c715c818,986585,2020-09-27 08:40:00 UTC,249890000,249880000,false,10000,0
1b0bc4a7239758501069b3bf5ec6f0a77d83b120c92c694fd628e7ec68078b29,986585,2020-09-27 08:40:00 UTC,10000,,false,10000,0
80e86fb85a50b0127e2501fd30f2706dfc5c15a41e14772d61c8f253bab9a9d5,986585,2020-09-27 08:40:00 UTC,10000,,false,10000,0
bec828196fad683254af31e86354ca1aefee78d2f7f44bf39abc107abc478e77,986584,2020-09-27 08:37:31 UTC,255341763,255338496,false,3267,0
b3a5e13b24f61a9d49274cdec203e386740f34252df7391d69be89fb1a673404,986583,2020-09-27 08:35:58 UTC,10000,,false,10000,0
448fb03988783514d5000790fa48d65dd7060690d4e9cf8014b7e85305990a58,986583,2020-09-27 08:35:58 UTC,48707228,48704268,false,2960,0
31067e81bd235e3666f7a579149d12b8ecea0f956c815e54df9fda55dbcb6467,986583,2020-09-27 08:35:58 UTC,10000,,false,10000,0
bf51b0a59b3879be1d2ed68b68c4da1610ad92f4b1176f3c093006c8a0fb737d,986583,2020-09-27 08:35:58 UTC,110826786,110821230,false,5556,0
3ca3a7e4a02871fd41ed699d9953847a3d475174f880ac97101229e1441f04f4,986583,2020-09-27 08:35:58 UTC,101009634,101000001,false,9633,986572
28e700469133f81aa04943b3258ef92127620341d37e5757d84d2521392d783c,986583,2020-09-27 08:35:58 UTC,500060629,500050629,false,10000,0
e6126397def65885de845b77ae3ce9c4e18857ad1a03c43651112d1d9093ac1e,986582,2020-09-27 08:32:36 UTC,8896871634,8896861634,false,10000,0
591bb44ad476387fcc92ae63ce9b5fff7e4679ef8ae0ed49b7009cc2035e0a63,986582,2020-09-27 08:32:36 UTC,59137583,59137338,false,245,986571
9f80d15d56b71b1c8d701cdbeb899692fe67f06186151c883b0affe4a86b3da0,986582,2020-09-27 08:32:36 UTC,174570785,174567720,false,3065,986559
1de391236705173020c8c3463d1615623009e5b8fd4508935e0efbe81beba8d7,986582,2020-09-27 08:32:36 UTC,6300652,6300000,false,652,986570
fea86172963b7dd73baf9dcdbb5b9121bfce9a5235fc38b01bf1a933888f699e,986582,2020-09-27 08:32:36 UTC,255569705,255566745,false,2960,0
0b1667274d24021452b3b9fa74f1289d83839d36d0bdb446c363e5f11a58726c,986582,2020-09-27 08:32:36 UTC,98605356,98604408,false,948,986571
12f05b4db160e4723eccd331ae7d29f935e69cbc281a4f0738d35f4a6528d2e5,986582,2020-09-27 08:32:36 UTC,10000,,false,10000,0
cb565212058ca492104b24d2417da604c6a4189f38bfacac553333169362c8c6,986582,2020-09-27 08:32:36 UTC,115259571,115259295,false,276,0
d38bc6ab70c1865bedd1d85ae39d1d23f97e1ed9ff11afc6fe9a969e300e1edc,986582,2020-09-27 08:32:36 UTC,251498221,251492130,false,6091,986571
5d69a0fe0211e7fd0637aa48297569fda90f38624896bf8f0c3d665af7b7967f,986582,2020-09-27 08:32:36 UTC,88474521,88468965,false,5556,0
fd9ee0d681342fbea85995c2ec54600ae0db92dc9afc8ff0f5ef729f301b3cb7,986581,2020-09-27 08:29:45 UTC,299900000,299890000,false,10000,0
a28ec20a9625d93effd0bf9bccb25026d75eb882882f04787d8b69553eb6d1b4,986581,2020-09-27 08:29:45 UTC,115532229,115531953,false,276,0
ce756a72e3b96f62493b132e7c8a579466aed950ea88eefd8851de4f806a2185,986581,2020-09-27 08:29:45 UTC,10000,,false,10000,0
4816601dff2fdd93cb16c09ec347ecbf59d29bd15d82224d957ae450cbaee7ea,986580,2020-09-27 08:27:51 UTC,10000,,false,10000,0
a822ad7fb1e7b435e0fd5c0ad05de81be51cd17add83eb4453b0a87fcd4d5b1e,986580,2020-09-27 08:27:51 UTC,115589437,115589161,false,276,0
97a96e95ab4ead5b62e710d1f889d1e80bde74bd97e6b54d474fe266e2b6b7bd,986580,2020-09-27 08:27:51 UTC,118792843,118787287,false,5556,0
c1380d121753c398d7b5f05337bffc49db902f4e5a63d0c8d0c242a87e316627,986580,2020-09-27 08:27:51 UTC,43308325,43298325,false,10000,0
d9859edfb85c2b7e8076a51f1b60905f52292f8bd66565ced86312f128ca3a68,986580,2020-09-27 08:27:51 UTC,757638745,755544917,false,2093828,0
58557c515b8f807615b561b7736adb7205eb32dc1ca56e6e26365eef4bd1bd4a,986580,2020-09-27 08:27:51 UTC,299850,289850,false,10000,0
1c23820f58814950e90b5472525824ee6cd34a895fa22d86d9f7673a423e8c9d,986580,2020-09-27 08:27:51 UTC,10000,,false,10000,0
9ef372d1eb5499d573177e5e3d5787de03cc105e5a462a909915f4280d40955c,986580,2020-09-27 08:27:51 UTC,77020245,77010245,false,10000,0
6001860f9d1d26f43cea8c5b5be95bc525034360aa1c79b88093ebf3ff8a10a6,986580,2020-09-27 08:27:51 UTC,115562072,115561796,false,276,0
a734cec75e315e03e370ec585d7a38548a1ea2d4f66aa31883012ecb2f4f6be9,986580,2020-09-27 08:27:51 UTC,48863633,48860673,false,2960,0
63a88aa7700f5ef096e94b0dc64779c76886c27136d99353342a33cd84beaaa9,986580,2020-09-27 08:27:51 UTC,10000,,false,10000,0
aaa63c8df015ed467b237059380a2de611adea858008dc1bc1ded6807dbc6efa,986580,2020-09-27 08:27:51 UTC,68551721917,68551721817,false,100,986569
97fc3aa08d56e6dd09ab9b5c5356db09f56a852e5bffc95d1936cb1dd7e620a0,986580,2020-09-27 08:27:51 UTC,452832322,452752322,false,80000,0
9d48252b4ec72fde4410fd3f217e2e5086e32aeed333ce8812e78b7e50250d5c,986579,2020-09-27 08:22:55 UTC,10000,,false,10000,0
16411fc40d886cc2fbb9630252dfd0b72205b4fffbcd150e0c4e78ef1f7cabbb,986579,2020-09-27 08:22:55 UTC,342785390,342775390,false,10000,0
6b314e247ddc27053c5c88cdff83dd148bea559e3319e5fe2d00ac1fe1ba8e09,986579,2020-09-27 08:22:55 UTC,10000,,false,10000,0
ba89b3654f75d058c62ba13b02d636761adc702eb6f216eb8b925eb13791344a,986577,2020-09-27 08:20:07 UTC,252975784,252969185,false,6599,986566
c646c9c4ef9dc8eb5ea3e4beed5a0b5f69efbbfa4fbc54aa156e5aef6ffb655d,986577,2020-09-27 08:20:07 UTC,10000,,false,10000,0
9c835e6a8adb3044179e195d633811ac5c3f3f6b27429f5b23dfb6c109db84ed,986577,2020-09-27 08:20:07 UTC,175416043,175412874,false,3169,986566
778c91c9ebfb425f04c14b1c1bd9dec89ed12da8ba05fa4a392be3b8185b1de4,986577,2020-09-27 08:20:07 UTC,738003001,738002759,false,242,986538
129a3c11b6ef878e785c583c62ca5043bf9b3d5cd02f93d8a1e2d6fe272d623a,986577,2020-09-27 08:20:07 UTC,500002091,499992091,false,10000,0
4147b35c3c93981189b6224530b22c70f9c1428065b1aeae63f2a00c45bc62e4,986576,2020-09-27 08:19:10 UTC,255763745,255760478,false,3267,0
0a0a134be0be2cbd5ed3d8485955ac07ab81675f043248d2eb7d539dc5aced81,986576,2020-09-27 08:19:10 UTC,500012091,500002091,false,10000,0
f29974f28295487a579941b946b18ad5317f598cdde7b3df9477df98c9a24ca4,986576,2020-09-27 08:19:10 UTC,918975000,918970000,false,5000,0
180c3bd2cf4f6772ec175c856173feb38883befc3762dcaaf16b87c69e8c746f,986575,2020-09-27 08:17:50 UTC,15981400000,15981379540,false,20460,0
4a320ae3e1f5b58dff7480d6eb826d5ba6592fc63a0f1b56b2c2a085e4366a4f,986575,2020-09-27 08:17:50 UTC,702488452532,702488452287,false,245,986563
15553830c66f8768fb1312827013f1fe739bc6ae71c1bd098489cd0efb9599ea,986573,2020-09-27 08:16:57 UTC,10000,,false,10000,0
5777e5f4e67f80fc0bae17256889e3cb0ab0c15915f13e58f6c220d82dce2e4e,986573,2020-09-27 08:16:57 UTC,10000,,false,10000,0
b866fc96e4f309e1cdc020696c12ee5ef5e19809b3408b135bb875f624fe7dc8,986573,2020-09-27 08:16:57 UTC,17390829582,17390626582,false,203000,0
4c9059dcf901ddc4ddc7014378834d35e53e4e8e8493ecbbb08b5ea91e565431,986571,2020-09-27 08:14:09 UTC,2500022629,2500000000,false,22629,986546
7d288d864b13da97d77a65350cea16c5bfabbd597138d18becbefe9989702ea8,986570,2020-09-27 08:13:53 UTC,1406835093,1406833001,false,2092,986558
f05f56b6d3816a26ef0de4e1b508339a0e92b7c77cb3e33de00ed209c0d28752,986568,2020-09-27 08:12:44 UTC,10000,,false,10000,0
b35c4d5b72494705db3de2155a3551bd0fd749c0e04005c45b73a59c4325cd85,986568,2020-09-27 08:12:44 UTC,49076897,49073630,false,3267,0
74d9e366c88bfac52efc8226c0248fcb9bd0cab534a64f51c520070e1a93e2f9,986566,2020-09-27 08:11:32 UTC,115628341,115619801,false,8540,0
e55883a0416606fceb26a1fb31abc0cc813b05de02ee100305a52dfef6472807,986566,2020-09-27 08:11:32 UTC,2416337176,2416335093,false,2083,986555
d1f53ebbb1bdd2491c6e91a0452c37c5f796ddf5f6157ccacf6dfc2f42be5bb0,986566,2020-09-27 08:11:32 UTC,10000,,false,10000,0
c54b9a15cbd85e41397dc2a4026a05b69a038086b3815ce71ea2e7d27b0ce1b6,986565,2020-09-27 08:10:13 UTC,10000,,false,10000,0
017cd04b36a2c091f5a7ec45f10b61ac0bf10495e7b76e378e440f4e4fcca382,986565,2020-09-27 08:10:13 UTC,10000,,false,10000,0
6279aff0827b230123f49aa1c032ed3efd44849f08a7251cf931448bb3bf84cd,986565,2020-09-27 08:10:13 UTC,255912638,255909678,false,2960,0
dc1f6130956bcb417c88d7876e2ad211784b951131bf71f54745ee49d1a27a52,986565,2020-09-27 08:10:13 UTC,82335110,82333018,false,2092,986554
62742900bc0b861acde2009eb3fa08c9be2b3f4e105eede5098903dda17edc52,986565,2020-09-27 08:10:13 UTC,10000,,false,10000,0
e5c20b12c2424bb97c2d56211cf6d2ae4aa8c8f9b6989b5ddaeb06ddd756659c,986565,2020-09-27 08:10:13 UTC,254138460,254132269,false,6191,986554
60bbda21cc12e68bbe39f1583d40fc5f412bd42df7c3a040948829ec86a3ac05,986565,2020-09-27 08:10:13 UTC,6573932,6559534,false,14398,986553
c1891cea386b3b04d40baddb1f75816b8f51360d385f35c3f8f3eedc1eac744b,986565,2020-09-27 08:10:13 UTC,176059104,176056445,false,2659,986554
223ea4fb9a98793398749eca80f81cdcf267780738cbe31fdea08526f9112655,986565,2020-09-27 08:10:13 UTC,474767013,474687013,false,80000,0
c277d008739e147b93e9214f5a9f81591aa1a92cbfc840027b5e9123cbaa0c5b,986565,2020-09-27 08:10:13 UTC,83538076,83528076,false,10000,0
a3c26e126b774baae48f63d9f217ed392e8dd32407654723362f8f1db99ae435,986563,2020-09-27 08:05:51 UTC,3500481180,3500471180,false,10000,0
7a55f662677a6c3d1a5dc57239b2cac99ed1ed1551b09a43feab9014274d9d4a,986562,2020-09-27 08:05:31 UTC,248667207254,248667197254,false,10000,0
57cdc6a2fc0b9a106b2b855dff8b4f142471960e3c265f8d4cea2d005d5522a1,986562,2020-09-27 08:05:31 UTC,3000086289,3000076289,false,10000,0
68183836bc54dc6503b628eef3f3093305e8556d696f92b3601f4129ea18464a,986562,2020-09-27 08:05:31 UTC,4885914104,4885912021,false,2083,986551
60ded030f525ac9833f775a481fa2560bd540e2f768e1b530b3c9da7a067fdd5,986562,2020-09-27 08:05:31 UTC,1000302579,1000292579,false,10000,0
53e40bb7d6166f96b438379d4f55957b98a6e65300b2f5a1aaf546d7c9b76474,986562,2020-09-27 08:05:31 UTC,10000,,false,10000,0
fbfaabff5884d2076f78c9da083e33bfd8d4a0ca92babef2bc9aa3da522ecd37,986560,2020-09-27 08:03:12 UTC,115772285,115763745,false,8540,0
b7cb5c7172ed817c77236ee7710c8b1c6b8b81600f64b3d69fab77148350af14,986560,2020-09-27 08:03:12 UTC,10000,,false,10000,0
062c96ec122bc764d665c09ec66b2c572fa7432b8a2613e7bc85f64a2b3c9441,986560,2020-09-27 08:03:12 UTC,99658889290,99658886940,false,2350,0
a079105f755d36f396ac471ae88d5930a22d1f7de09dfadfcf817230724728df,986560,2020-09-27 08:03:12 UTC,49768747140,49768731560,false,15580,0
900de4415169d17be57dfed702fc3757fa2fd29a081aa8cd509528654160cdc3,986560,2020-09-27 08:03:12 UTC,49289451,49286491,false,2960,0
cf6e7422b13812d2100821eee371efc2c32b6043cbd4180036df3f7de57dc39d,986559,2020-09-27 08:01:25 UTC,256205269,256202309,false,2960,0
0b452b300666a732ecf9d493ef12032080b96df7122afe5168334ee06b7622e6,986559,2020-09-27 08:01:25 UTC,770000,760000,false,10000,0
a8bc05f37902a0961a2af5a20a2f57dfeb7ac00cd981408dc3d9e3a4799a9811,986559,2020-09-27 08:01:25 UTC,95910551,95907588,false,2963,986547
2937615895381b66449ac63755532202988261b384a9c688de74549895f67042,986558,2020-09-27 08:00:39 UTC,21130298,21129758,false,540,986462
2b7f53dc441d9db29a709afcd304ad1bc6b2df4c66bf3749efa27cd0c1fdca59,986558,2020-09-27 08:00:39 UTC,9041402,9031402,false,10000,0
96b2f7ec7a08eadd9e2f7366b72a3a121eda9656aace08e25198e814bd4b90b2,986557,2020-09-27 08:00:27 UTC,176655809,176653594,false,2215,986546
5c76f66539bce231f500aba047e89733739d1ae0966dfe221467991c76833155,986557,2020-09-27 08:00:27 UTC,255326042,255320093,false,5949,986546
7f108a02734b3c5b67898b462d2fcf3afdd6fab1c06a45931e386f0a5322d7a2,986557,2020-09-27 08:00:27 UTC,10000,,false,10000,0
0cf04bdc97348a4df096af45c4dcb68750cf8b37a7c026486b5e505301211e0a,986557,2020-09-27 08:00:27 UTC,2437596452,2437568509,false,27943,0
a100b359319b9c8c653765e0b59c169a55365f7e14400a27daa95e0522829a53,986557,2020-09-27 08:00:27 UTC,106014456,106014212,false,244,986546
f890363e81685e4a3425e87140a963c854801a8c8e9743d3a77417dbbbcbcabe,986557,2020-09-27 08:00:27 UTC,10000,,false,10000,0
93dd1dfe46f4a6249efbcd764e35a91489fd9a4a387e4c6039f6e43ca2c3254c,986556,2020-09-27 07:57:43 UTC,17077715382,17077705382,false,10000,0
c056267f0e3fe0934d2f5d3e93f9033ba64243054f9a70f4c3a08f47a6a839ec,986555,2020-09-27 07:57:31 UTC,1000788,1000396,false,392,986543
3e3522c73c7c1267f52fa2014b93d7c6c3804f4774764842befeb21bf69ad624,986554,2020-09-27 07:57:18 UTC,99901123256,99901120906,false,2350,0
260169f5916421444c966cf0837117c9f5cb99f670c1f2c1b47a1921203e45e8,986554,2020-09-27 07:57:18 UTC,49439668,49436708,false,2960,0
4db9f371effcc7ab47d55ff4df0cf1209d916ba9c6635adc98a07f68367bb4ee,986554,2020-09-27 07:57:18 UTC,115958462,115949922,false,8540,0
a7db755cd95e3a0da7d07e84e6dadb37887aef135c238bef002bfd7b9e2b5cc8,986553,2020-09-27 07:56:48 UTC,10000,,false,10000,0
87ecec73aa91710846b4498f4a6c6c87174898d860f229b0b8b466359aef88a0,986553,2020-09-27 07:56:48 UTC,17077859082,17077849082,false,10000,0
660f4599c81228a1547136d23baff8a40b0e39e9d9ef02efc7cdbe80a0d0ba5f,986552,2020-09-27 07:55:41 UTC,116159728,116151188,false,8540,0
81e85425900a406a4123b2b7d633f8a37bfb7bad31a5305200da8a8bb69024f6,986552,2020-09-27 07:55:41 UTC,116408583,116400043,false,8540,0
bdb7595f99e0e5ebf884a5711bddfa8d587bc245d1f21fbcb7b491f0a89faca8,986552,2020-09-27 07:55:41 UTC,256403474,256400207,false,3267,0
cce8c46da956f01c7fb40620c8a47b1488becba25fe5f83e24d7502ca8c8005e,986551,2020-09-27 07:55:01 UTC,32973213399,32973200000,false,13399,986540
dfa0de9da801a6ea6a716820cf122fd5b01f1ec9ddf5b52b2173defb26fc7bb6,986551,2020-09-27 07:55:01 UTC,99947500000,99947497650,false,2350,0
f358ef12c4e87b0bc5d95a3bbf9d4c6875094b0c0dcc85ca013a27df869428dc,986551,2020-09-27 07:55:01 UTC,116438028,116429488,false,8540,0
27541ea31d351844dcd9a64681cd9b692f920a5af9543165e22770146cce134f,986551,2020-09-27 07:55:01 UTC,10000,,false,10000,0
8490e4e7004b1d40b7516e9ee5dab39335fa53718dff97c33a6b7cc2530b99be,986551,2020-09-27 07:55:01 UTC,17077869082,17077859082,false,10000,0
4b6140ca37636ea61b716bfefa323f8f1ecd3721abfbab81ec4c3e614a7f2c56,986550,2020-09-27 07:52:59 UTC,19558684841,19558674841,false,10000,0
ed14319360af4309eb9d8fffd5ee0f7594ea8a55287230bf24ec7f81e3585ecb,986550,2020-09-27 07:52:59 UTC,10000,,false,10000,0
9bce16ba1cbdaccd54f99511c4b1cdfbdc8ea604641172e7948e33fa294f744e,986549,2020-09-27 07:51:28 UTC,100000000,99997908,false,2092,986537
5780dc15aad291f955c5dfbca58e68a3e7f55b5eebaf4823167bd62c0d13ecbb,986548,2020-09-27 07:50:16 UTC,256760492,256701575,false,58917,986536
559626c057b4a123685c3470309c0698c88c10a2f448c44d9d690c610c38e5fe,986548,2020-09-27 07:50:16 UTC,177265600,177244635,false,20965,986536
b04c81a217f5d53850c9c21cbd6e7b09d6dccfb736c0bb67e9c6b03587dad246,986547,2020-09-27 07:50:04 UTC,2446339259,2446337176,false,2083,986451
306f15db9727e0be7bc8d38d918a130bf693b48598bc4d47c474ac0632a5638e,986547,2020-09-27 07:50:04 UTC,300881543,300801543,false,80000,0
ee818a9a1dc77746baeca4ec9130a8d8355fd12365330397a039f5755c5d90a5,986546,2020-09-27 07:49:14 UTC,49668777,49665817,false,2960,0
7c96f6a85266a4b578b915c873eab2c374ecd7433ddd8f86bbe4e8c0e4880b06,986546,2020-09-27 07:49:14 UTC,16715000,16713870,false,1130,0
81cc671043b09eaffec612fca9d42c73c24b113cee20cd68def3fae6a6649e10,986546,2020-09-27 07:49:14 UTC,99956500000,99956497310,false,2690,0
3602e19c14a4844e758957bc4e609f5d57167335a5df5e5cc4b7a3a8472d6186,986546,2020-09-27 07:49:14 UTC,10000,,false,10000,0
6843a012ed02db15d8322f95b321cc08c38e70091bf4a05d6362aab68e09289a,986546,2020-09-27 07:49:14 UTC,10000,,false,10000,0
f93db9c3de33685c08fe352c469ad4e41513617a5116d3cfa31d47feae38acbc,986546,2020-09-27 07:49:14 UTC,10000,,false,10000,0
d31bca28b4a1c7568d3a2a5c45e4c59dab58863666e1dd0601b6b16a01b499b4,986545,2020-09-27 07:44:33 UTC,10000,,false,10000,0
08016339e6e01fa439db1961a78c27b0f22d19d0f1af67ec90d8397db2203c53,986545,2020-09-27 07:44:33 UTC,200184000,200174000,false,10000,0
94f23218065c9e7445208403078680c6407abd54d5cf7befb3cce80fdd5b09da,986545,2020-09-27 07:44:33 UTC,68656522017,68656521917,false,100,986534
e914cf430ff098f3624d501be5c4fa72fd0df6af3a980de982c6e30850da337d,986543,2020-09-27 07:41:32 UTC,3268479356,3268458647,false,20709,986532
cbb9318a1460af88738d45c70c544e54f4d43af046f65931bafc579bbf9d69d3,986543,2020-09-27 07:41:32 UTC,256606819,256603552,false,3267,0
5825e374cc3bcdba6a7b3834013d14eb94fbe71bcdb80ee06348e56367290f1e,986543,2020-09-27 07:41:32 UTC,10000,,false,10000,0
d649833fed05f383c62e23d5eafff311abc52516e7b00e68dca2d912183d438b,986542,2020-09-27 07:40:41 UTC,250,,false,250,0
928bdc4230311b445d03e0128213af0ea0ff6dfd7402828cd17229e05644fd23,986542,2020-09-27 07:40:41 UTC,257703517,257654489,false,49028,986531
340753cb9bf6379060dd1f1c902043ad3e90f11b44dfeed26735abb486bb3cc1,986542,2020-09-27 07:40:41 UTC,177814436,177794649,false,19787,986531
8210fd2842b2a3a7df1cddeb7b45d5a4b70ea9167fd6c547f9422ed2f48a2a0d,986542,2020-09-27 07:40:41 UTC,10000,,false,10000,0
4afc81e8ed46932e2337bf03140065e7fcb84cbadde75e849560e29c94be9fbc,986541,2020-09-27 07:38:09 UTC,116525382,116516842,false,8540,0
d4532c3ba18593744dc616ff4be575cb407bc182afe67c415076bf15c5ceb25e,986540,2020-09-27 07:37:25 UTC,78908,72908,false,6000,0
057be516c6bc907a63528ef851ba6fba34f035242688fbc7f38f88dbbb13b414,986539,2020-09-27 07:36:34 UTC,499998538,499988538,false,10000,0
59cb0013118d64b5d949ccc66522d47dd8d6efb145d9c3bfd0f6eb5588038c9b,986539,2020-09-27 07:36:34 UTC,10000,,false,10000,0
30d8c66cbc9f832c13fee56aadc5211bf7f395747af43136970f0be5253f666e,986539,2020-09-27 07:36:34 UTC,500013947,500003947,false,10000,0
c8c2415167cb402b01c88398040c4e5097f0d5c62334404ea141ceff3093f6a0,986539,2020-09-27 07:36:34 UTC,4257627642,4257625559,false,2083,986467
4f95bc8d9fe19e5ae792b6f51366dfeb97cce487904352d590d1d7f5e9dc3f3f,986538,2020-09-27 07:35:04 UTC,43827805502,43827605502,false,200000,0
cdfc8b6a85e8949ffc0607754fdca1c26ead5ab5e7caf2de5f18ea697dc4b074,986538,2020-09-27 07:35:04 UTC,49931577,49928617,false,2960,0
30a074ac70ace813a3792a2549ad3b5aadec27a227b71db8ebe236a7c5633a8f,986537,2020-09-27 07:35:01 UTC,68769060427,68769060327,false,100,986526
7b980b07d5d3a1a0d191a350b0ecd27cb6d67ea2ce6c0fe141d25b4ee157cef1,986537,2020-09-27 07:35:01 UTC,1099898500,1099888500,false,10000,0
ad9a0a1c110fcb3efc2be69d754dfe60da7fd703fa529f51a50f19cac39c2e6f,986537,2020-09-27 07:35:01 UTC,500008538,499998538,false,10000,0
ac7f4701f4f25f65713f1251760b094c2aca4aa9c4b26d4b806d82507b15325d,986537,2020-09-27 07:35:01 UTC,499990000,499980000,false,10000,0
130ac0e16b052b910264692d7e34c1f0f5a8b082fd475762854ec0979d9e644b,986537,2020-09-27 07:35:01 UTC,109649347,109647255,false,2092,986526
cc3015d94b1e0491e5ca10bfbc446d7c5bc21ed0d80a8e2cb389b4aae3988e04,986537,2020-09-27 07:35:01 UTC,10000,,false,10000,0
00f69953c9041132ba524617f00c8a52de76bd43040d9184eb60d5616968372a,986537,2020-09-27 07:35:01 UTC,256833475,256830208,false,3267,0
293c4f3f5859544a9695b16b45b97bb35f59e48db328751b56862db347d93435,986536,2020-09-27 07:32:08 UTC,10000,,false,10000,0
a5ebdd48c58d08e45daae646070b4c4070fe0cb14d77452a428d40d9a2a2f51d,986536,2020-09-27 07:32:08 UTC,104302938,104257803,false,45135,0
0a2400d80da4068359e77dc0314329a273ffeb51971f98761ab7a92a24c9ee9c,986536,2020-09-27 07:32:08 UTC,231152487,231072487,false,80000,0
ea24040dbe5e8d2a343c935ac08e242d61dd771f9ce52850220fb24f0d7d0074,986536,2020-09-27 07:32:08 UTC,500000000,499990000,false,10000,0
5e995dd6587c81f079352d88a66b80b71fc93f01bc2a88fffc056dd67dfddcec,986536,2020-09-27 07:32:08 UTC,10000,,false,10000,0
9b5b16e97f264e3c6de48f5753f8c9e74f13ad5f27a03643f72db5147f6677e7,986536,2020-09-27 07:32:08 UTC,258919230,258868358,false,50872,986525
4cfdb012cf42fa5907c26dd8a60f55f5d0b27b10b51c00df2257f6cf212ac9c1,986536,2020-09-27 07:32:08 UTC,178454235,178432416,false,21819,986525
295cf49dfcc14f1b765bc135a1092496f3f22f2759c8a654f0d936eb56c1b877,986536,2020-09-27 07:32:08 UTC,4543130024,4543127642,false,2382,986476
7f998c94a4b2e45b2e92efb6efbfa3ba041034b8bc85b69ac8559c5707eec796,986536,2020-09-27 07:32:08 UTC,18558726303,18558716303,false,10000,0
6d82b203aacdb15d07a91901d14bf49833f19132baaa0f5ce8593f216ab783e7,986536,2020-09-27 07:32:08 UTC,10000,,false,10000,0
49857f84958f55ad73565b3772cc71858129b50860e9e802ed46e335c120bcf8,986534,2020-09-27 07:27:03 UTC,18859260578,18859250578,false,10000,0
fb2cee29682d834c617f4b1a30deb79b6922c80c76a2c72a0aad27cd6b465fa2,986534,2020-09-27 07:27:03 UTC,132349889,132343889,false,6000,0
ad7da84e5c1825b2a0cb51b46bed5f13cae79448f493e729d25f6284ee160e24,986533,2020-09-27 07:26:34 UTC,1006610,1000744,false,5866,986522
b55ad6e60ccc0a3091d641ed07a5f8e5b6e940c82217268fc2d54d7429c5f52e,986532,2020-09-27 07:25:58 UTC,347750236,347748654,false,1582,0
be826641f387a4d4810fd9ab915ee531885abf5f94115ed717922c004e41d479,986532,2020-09-27 07:25:58 UTC,10000,,false,10000,0
f1c58d76658f5663ddf610b9b84fcbe2b633d00e06926be654894e32a69a70a6,986531,2020-09-27 07:24:28 UTC,10000,,false,10000,0
aabc445f5e2fbfe77070bd13a6af4f18850ceffe9d415601edb99708c8a3bae7,986531,2020-09-27 07:24:28 UTC,50162452,50159185,false,3267,0
a3664fd9e00e02a6e2d536c8a5674f70c3030762e9f485cee2657990f56de054,986530,2020-09-27 07:24:11 UTC,257034889,257031622,false,3267,0
16a1b5ab496cc8147ec2e45ff6a1571ab78f3eaebc5609889f16c948e9cb61ce,986529,2020-09-27 07:21:52 UTC,251000,245000,false,6000,0
fd3e76c8adb103a555e43a552afd57440f8e927af598281c4c227f1c6fd2706b,986529,2020-09-27 07:21:52 UTC,613460000,613450000,false,10000,0
b3ebb83331fb149467b30be0d26c7ac157170f65b5744ed3d41b1efde31f4e96,986529,2020-09-27 07:21:52 UTC,130342795390,130342785390,false,10000,0
aeddeba6264fbbb30d35a55458e52a4ccd41f318deda6766c116c0b1996df4ad,986529,2020-09-27 07:21:52 UTC,260755358,260697278,false,58080,986517
750c94206dc1ab41642366d8ced72f4d5350d668ca70a31991b2071772575895,986529,2020-09-27 07:21:52 UTC,178977560,178958644,false,18916,986517
8451e8bdc42ce0b963f40ca08bb849255bac9775a5c79d788e1253b27754e9fc,986529,2020-09-27 07:21:52 UTC,5017812490,5017811902,false,588,0
d7ac5fba8644796af4ecbbe55a8a3540179f30e64ddc3f5e0d1553a1db9d5ef5,986529,2020-09-27 07:21:52 UTC,18859270578,18859260578,false,10000,0
caa787fd858f038af9db08554c9a8d37dc44ba1b9a3dd8b72911480d110aaa0f,986529,2020-09-27 07:21:52 UTC,5543630099,5543628024,false,2075,986517
c8ac4a33654c57ceb71ae2f60194e9645dc125984ee4d292100469f8784971bb,986529,2020-09-27 07:21:52 UTC,10000,,false,10000,0
7da02b69f0abbb19d7427e14904c222eca1958a83fc44339b9c629f84a8fedc0,986527,2020-09-27 07:19:26 UTC,51272345,51269385,false,2960,0
243fb88e59a84061d717686ee337617618487ef44c9006f504aeb4317747bf21,986527,2020-09-27 07:19:26 UTC,499984746,499974746,false,10000,0
201d32f4b1799009d83c28085f8e85c04adfba81dd87651158580050a11577ad,986527,2020-09-27 07:19:26 UTC,10000,,false,10000,0
87b87992bb6c9dfaac10a61c0972f1b45a3994e8176a0848e27654ecc767751e,986527,2020-09-27 07:19:26 UTC,10000,,false,10000,0
bad8a8b0ed87e9e4fe96ed2b2e8b5e452a6f0f5f47c929b805636dc82a42b082,986527,2020-09-27 07:19:26 UTC,116601304,116601028,false,276,0
c82faa6f96e089d3c7fba3ffe3e3d5a559ea74f88c2164a4b298bb331961afe4,986527,2020-09-27 07:19:26 UTC,5593479942,5593479699,false,243,986516
fd676e51eee3e3dae980c15ea24dd10ede7bb95701e737ab502097d4f0de04ed,986527,2020-09-27 07:19:26 UTC,10000,,false,10000,0
89f005e3f720b70ff3c9bff1a76ef5ebb1b137b1f8359023d05b3020366bf905,986527,2020-09-27 07:19:26 UTC,131351771,131351527,false,244,986516
1f8a98fd03e15e70d2414ccaa9ed235d11e9d8b9e23a22efea152bc2a09480f1,986527,2020-09-27 07:19:26 UTC,347760236,347750236,false,10000,0
4819bfa35ff78cd3397559795bfc6ebfe2b32cd80130ff4e45b0f53052818ac1,986527,2020-09-27 07:19:26 UTC,58795556,58793492,false,2064,986516
1c5aa45e107f99a871f4111ebd9b692b3895f6019c2d3058bcdc209c824f6c9b,986525,2020-09-27 07:16:24 UTC,4455000000,4454992990,false,7010,0
1293c6a5a8aea91bed710db8433214f1ecada10c44f34ef870ad49067a7b81b1,986525,2020-09-27 07:16:24 UTC,7061576,7054876,false,6700,0
e214de0be4cae54c74bf9b830628f65a917a096498e9148240735f64c34dc491,986525,2020-09-27 07:16:24 UTC,2707333195,2707233195,false,100000,0
5fba13f867738f195ae90407bcaad7bbfc50839db92e87d7087d50ff250f9664,986524,2020-09-27 07:14:38 UTC,144723761,144643761,false,80000,0
709f1898ff2c5134d196769291d204cbb96638dfae70394207c22e961e6006ae,986524,2020-09-27 07:14:38 UTC,499994746,499984746,false,10000,0
3d0497615badc45ea56dcbbb9ec878e5a0e668e160e4b06fe72d739789a6fb24,986523,2020-09-27 07:13:43 UTC,712487952776,712487952532,false,244,986512
51e759447aad57986e8b87ac94864ce9293ab158dd061d7f2982995f5172afe0,986523,2020-09-27 07:13:43 UTC,164959855,164949705,false,10150,0
b03f8edcde9e3b02dd719fc720b8aad7f3fb2a5680397df46003901d5c5a5cdd,986523,2020-09-27 07:13:43 UTC,51430179,51427219,false,2960,0
a909dcc36d40888d3c02af625bfb17de6a4ad68e0e683f3a872662df8afe4d43,986523,2020-09-27 07:13:43 UTC,500004746,499994746,false,10000,0
ebfc66e32893297fea3705f06bdf74cfb77588018d3c83ad133238dd4ba01510,986523,2020-09-27 07:13:43 UTC,4455010000,4455000000,false,10000,0
fb482e2f4058dee389cbca43716dbca6c31ba88339961f5526a5a2fc6ac406a8,986523,2020-09-27 07:13:43 UTC,10000,,false,10000,0
715a8cb34798d3ccb490d87d7026c62b8cce82c0d412a60ab77c66ff235300bd,986523,2020-09-27 07:13:43 UTC,347770236,347760236,false,10000,0
46a506f00f4304376e33110e2012848c8e1a5a55774791edb0158133674b79cd,986523,2020-09-27 07:13:43 UTC,257197252,257194292,false,2960,0
e8e5e015780e5a3f673993351af81536ed47f2c0c7febf9951e3618de0237161,986523,2020-09-27 07:13:43 UTC,289339245,289239245,false,100000,0
78f232b499b1f1e8952ae27a31455c4d1c3f0f9b366c3d4cff70a58f3685bfa2,986523,2020-09-27 07:13:43 UTC,10000,,false,10000,0
da61db3aa49c893434042ebe15c79ba97af71e884757f6639c0ff70579bc04ec,986521,2020-09-27 07:10:22 UTC,179343142,179341163,false,1979,986509
a65d73f5d1c01949d37ea12e9ac75229fc1b5134dff565d25cf0bb850dc9c9d5,986521,2020-09-27 07:10:22 UTC,262183396,262176151,false,7245,986500
f37f579188298aff447bc613d057bc7ee5a5f9edfb21f2ce6920c0341f18f31e,986519,2020-09-27 07:09:19 UTC,153077867,153077623,false,244,986508
bdf3ac7e2a632111d945ed85cc2278ced42be4d6665d1c7d486186ba2f7702da,986519,2020-09-27 07:09:19 UTC,51590597,51587637,false,2960,0
cae5d98d2122f7d1a8dee9b333f88eed9f2e2df7da6d5ef401b447d56619ba0a,986519,2020-09-27 07:09:19 UTC,10000,,false,10000,0
fe565419bdefedcd731390abf340c773bbfd5931d453bb3a8e05da1d7ad05e7f,986518,2020-09-27 07:05:59 UTC,2500229133,2500219133,false,10000,0
db2f10abe3c4cb0cf6b338fee1f90a9b402b923733f531f4944006e03ac37567,986518,2020-09-27 07:05:59 UTC,10000,,false,10000,0
225d8eddccb4d735592aa97745943e225b489ce80b564d6c36194d6c129a85a4,986518,2020-09-27 07:05:59 UTC,5659274754,5659267754,false,7000,0
bb56f2f9f4dedb2a0741b144b7913b99014d82e7d7305d9b500ad346eea3903d,986518,2020-09-27 07:05:59 UTC,1500048538,1500038538,false,10000,0
66555b4da168f5bd4f057f6b8761423a2d02128e33efd68e3ea4728a289dd465,986517,2020-09-27 07:05:07 UTC,347780236,347770236,false,10000,0
9619fd1e97c111ce4ff71092a1534bcda7bab83a3927888ec68cde54c759169f,986516,2020-09-27 07:04:52 UTC,500009267,499999267,false,10000,0
c8bcc805c7bda3f729f6e8855f86286b41f9024ec48f0e5b35818eb98446ce25,986516,2020-09-27 07:04:52 UTC,33130,23130,false,10000,0
c2f130f7f90b5054eae4377dca5d48244738e6287b0b2b7ccb0c5584238cb82c,986516,2020-09-27 07:04:52 UTC,3000096289,3000086289,false,10000,0
342a17c8e5a9d3b1a123f4601730e10a962767e3e4d4a9dcd6aa2f5e39882336,986516,2020-09-27 07:04:52 UTC,2500581389,2500571389,false,10000,0
495b53a3f48db291f791f1c0b4f91580ec23af30706c8b8e18e40f5d9c4b090b,986516,2020-09-27 07:04:52 UTC,10000,,false,10000,0
91959862a4ee79a6f4037fff78c89961842d7d1f397683f58d27b87fcba1efd2,986516,2020-09-27 07:04:52 UTC,20235731,20211731,false,24000,0
81e0ba30a674b2f240d47341c2561c62928f8a87e315a0ae78949264c281d44b,986516,2020-09-27 07:04:52 UTC,247397704843,247397694843,false,10000,0
f0de1593005b86c607a1a249f25342fc7df7b804dd57decf965811121a8affdb,986515,2020-09-27 07:03:25 UTC,639871073,639863943,false,7130,986503
3472cf42e6b128d1b90f0e5328a9ef668c718a1981353db56eac73f11b9a67a8,986515,2020-09-27 07:03:25 UTC,1257019,1251145,false,5874,986504
4fe0ed3a5f78f3b4f328cc971298502f073772bce0112f7ba6660f0e46bdabba,986514,2020-09-27 07:02:20 UTC,10000,,false,10000,0
076f8f0e933f03c806222d87fcfd69186394c9293c138d3eac3dfee93101c1f3,986514,2020-09-27 07:02:20 UTC,133410,121410,false,12000,0
897ff5e11e05745d17fd3e985c930aa44e6c59a5fcfc8751cb3e91974e764667,986514,2020-09-27 07:02:20 UTC,4966740180,4966739765,false,415,986501
5c4af46b2b5f441acaefa2a09e314e40b977d846411e589af9f7d03f846842cf,986514,2020-09-27 07:02:20 UTC,500019267,500009267,false,10000,0
e2827e2d2b86c9e2b9bf37784f4d5c1f190ea859b88f6f873baf7a6c657d8364,986513,2020-09-27 07:01:12 UTC,2717433195,2717333195,false,100000,0
0d84ef642dedf54dec273d253a7a5faf5924fe3b7bd8d2ffb7a766d822a917ff,986513,2020-09-27 07:01:12 UTC,291664,236464,false,55200,0
1f8ec28236b2104f22b9cb7a6bd8ab02d4d8bdcc3dbfb4ea8fada677b0043c9e,986513,2020-09-27 07:01:12 UTC,320010,266010,false,54000,0
964b32d83e41564a6507cd9709b5be114eb6ccdb36a43aa1cb8ed663c4728f62,986512,2020-09-27 07:00:39 UTC,257349709,257346749,false,2960,0
615e198430e4bc1e4540396376814e5781f3300a248681b10b131dfe392fc257,986512,2020-09-27 07:00:39 UTC,179868556,179866377,false,2179,986501
aa6a77a46c0a6da54784846e66e4ed8bf83f73147d1cc5d1244940e9bdc24e77,986512,2020-09-27 07:00:39 UTC,263204948,263198589,false,6359,986501
af81f91bd3a430c461664c4ee569be3a10155f0e9a713da07d3bd2113cd1081d,986512,2020-09-27 07:00:39 UTC,10000,,false,10000,0
2127a11ec91a8e4fbbc639e35bfdc05f58d5d9b24d9bafc91903de9d718247eb,986512,2020-09-27 07:00:39 UTC,229284800,229283218,false,1582,0
58001fc53d03f3b74e3b54aed447fe1cf902f457169f6b951c840fb91fcd2144,986512,2020-09-27 07:00:39 UTC,118507018,118497018,false,10000,0
a885e4fac2838379e9f05c81866c4d33e25d953a06b4803222d441400900c000,986512,2020-09-27 07:00:39 UTC,10000,,false,10000,0
edf6e0381e447122d6ca50bac97bfdadfc62cda8082c98b21215ed3b97202600,986512,2020-09-27 07:00:39 UTC,289895968,288620065,false,1275903,0
04e8062519e433490ad39de72f22b90006ae20dc63e43e3b0bdd0f72769ef95d,986512,2020-09-27 07:00:39 UTC,176435778,176435398,false,380,986501
3d3ffa1a3cd57eae7c8ad26ccfbabe422eb1d964ffb3e871ae5ec64567034c8b,986512,2020-09-27 07:00:39 UTC,19126046,19125209,false,837,986501
21db8c4ddb4710ae60c2c6312c18301cee138e765fbb13ab670faaf6ead519e0,986510,2020-09-27 06:58:11 UTC,18209505703,18209495703,false,10000,0
18506f71f4c1c9a13fd5782a4ab0bf922d484bdc9d9e89002c6792e908d0a764,986509,2020-09-27 06:57:05 UTC,51888767,51885807,false,2960,0
f4f59f05ad2e44b2abed67f9c15b708be339fa10272b5aeb41d826032db9fae1,986508,2020-09-27 06:56:39 UTC,116828797,116828521,false,276,0
ef8f1d6913e1cb876aa17f52104d4a1992e499074a389372856d2b66eba273a5,986508,2020-09-27 06:56:39 UTC,10000,,false,10000,0
3126c74380ab96846c8377d4b0cab6aef0799d424d09fe0a9250bf3aced71e4a,986508,2020-09-27 06:56:39 UTC,58928112916,58928097336,false,15580,0
a5d52197c58fe65889ce2931e1f5e555148fd66a2b8d5261774ba4dfeb14b968,986508,2020-09-27 06:56:39 UTC,19044677677,19044667677,false,10000,0
23e9190c5bda39d13533276543a643e7780afd134937c974cd4d0ed87aedfcee,986508,2020-09-27 06:56:39 UTC,9891727931,9891726789,false,1142,0
274598acb5844d5e38f0213ad9354cf6c2574cb73f0a2c8c1409a0112e6ee6b3,986505,2020-09-27 06:54:27 UTC,257524447,257521487,false,2960,0
56976237322e298dc93383bb07cecb19337337eeef4b09736f21770f54a4f787,986505,2020-09-27 06:54:27 UTC,118517018,118507018,false,10000,0
bc671b08da6a566501d9964b06ef8bde726be1ac2c9e3dd0ad00dd16b80c5548,986504,2020-09-27 06:54:13 UTC,144740441,144660441,false,80000,0
53d6969a5a364515fac09e07a59535aa1e9f81f35bbc683fd38f236aabae6011,986504,2020-09-27 06:54:13 UTC,6599969324,6599962324,false,7000,0
7038ce622f8f4add51b778eb67885cb9079a298d5efb8f05ed4f3f11c1d45cb9,986504,2020-09-27 06:54:13 UTC,10000,,false,10000,0
a766e5dd52928a14908468308001541846875de8e992f33e95553be0b7258c69,986504,2020-09-27 06:54:13 UTC,52030955,52027995,false,2960,0
485104174e023269e22bcc1c99132d4dd92701415a18c9731d16aab2ec751ac8,986504,2020-09-27 06:54:13 UTC,19044687677,19044677677,false,10000,0
bc5d4492f272a96418a424946367fcd9118a5f73f6f2c17e4a4c0172eebc4c85,986504,2020-09-27 06:54:13 UTC,12787249794,12787046794,false,203000,0
ae14bddb5e9311aa4423b5cacabb7818ca5fa4c6724b4e40a9c5868f7e7fb30e,986504,2020-09-27 06:54:13 UTC,6593980184,6593979942,false,242,986493
8131c6248a91790e4c29db3f5f7dfa3c0316a5d141fbc95fbbf8da2278e1a9ac,986503,2020-09-27 06:52:02 UTC,6022878513,6022868513,false,10000,0
552c39dc976a6c704555688659f3c94bcc0f4e6e691eba57d232b1ef37c6b640,986501,2020-09-27 06:51:11 UTC,1013053,1012660,false,393,986490
4b9ae4a9efe12b8fed2c931ee074005904be32ede1436659dfb386daa7afe057,986501,2020-09-27 06:51:11 UTC,6499971616,6499970470,false,1146,0
e9a07bc547e61969f4eecf843caeed8ec0af1bb25dd33ac1d7f2e7275397aa7a,986501,2020-09-27 06:51:11 UTC,117079073,117078797,false,276,0
e9ae7dd9b801c0fd77064e910ada24a62c77aa93e64e2f3a4902ad30749bde35,986501,2020-09-27 06:51:11 UTC,499980000,499970000,false,10000,0
e5d328d71717a3d758c1338a1df3234c0486b3b930b2b5c0aa9be0609504583e,986501,2020-09-27 06:51:11 UTC,264613210,264606201,false,7009,986490
2f5346823f4b077da52590b499389fb755dc64d92987476e14a53d88dbef458c,986501,2020-09-27 06:51:11 UTC,118518600,118517018,false,1582,0
1e6f9e243aeccdb47b026dde1da56ddc08af268b85a0ffda673a0365ad34cb3c,986501,2020-09-27 06:51:11 UTC,257689619,257686659,false,2960,0
61af6185efb97c88f3b037d272ac1ed09000dc6b9cfc1b7b2978a714dad187d7,986501,2020-09-27 06:51:11 UTC,1588226132,1588222332,false,3800,0
3218774fd9c1809f812e6f43a2e4abba4481912c7c35b2c0476522935eb4beca,986501,2020-09-27 06:51:11 UTC,130342805390,130342795390,false,10000,0
ac6ded16c32dc419316af8be293685289938b13ec8a28d3ce2680bfd76fb7cf8,986501,2020-09-27 06:51:11 UTC,180249458,180247582,false,1876,986490
4317a2f2244c137641ff06d972c6fe00ba60ebeec7386dc8d5fdd3c7191983a3,986501,2020-09-27 06:51:11 UTC,105357486229,105357483539,false,2690,0
66f10fd39466f1bd93d770dba39830d18af0739c4e8f59cb27c31d17062800c0,986501,2020-09-27 06:51:11 UTC,10000,,false,10000,0
264f1ee4f907fd9a4fad37e4b8abb51b92f2469508de51686d7397f94f14d7c8,986500,2020-09-27 06:49:23 UTC,6499981616,6499971616,false,10000,0
c03b36a3a2f0a48e13ea9508c9b1b6a3c2645b0c6c50d9c3804d454dd30ec5bf,986500,2020-09-27 06:49:23 UTC,10000,,false,10000,0
cffbebd8e776a18a7453ef885cd9a933a583e289989f45c0f85ec8fdde3635ab,986500,2020-09-27 06:49:23 UTC,175759334,175759090,false,244,986488
c6037202d548a5fc63fd6f7febd70b98dfcd3283e79a7487d623de6932d56448,986499,2020-09-27 06:49:14 UTC,10000,,false,10000,0
f0105a927117862affac2289e8e595a8de382ed26043c944b1043b328f3ce9de,986499,2020-09-27 06:49:14 UTC,500002960,499992960,false,10000,0
968dafab249dcb1b2af68b3b506886b225b7020c45174de3ab5ee6d423226034,986499,2020-09-27 06:49:14 UTC,229294800,229284800,false,10000,0
4fa6448da2362f702621e653cb76292b839196da6bc87a52f1c1f08b400dc129,986499,2020-09-27 06:49:14 UTC,79723172731,79723160356,false,12375,0
1705aea2ff46ba201513eff445f916d46289aef6804136749d55cd69dacc4797,986499,2020-09-27 06:49:14 UTC,499990000,499980000,false,10000,0
dbfb30f3a554d5675b63a29734e51125b9c484664aa8ada80aef0530d4abf906,986499,2020-09-27 06:49:14 UTC,7001068970,7001068282,false,688,986488
f601332a341a89511dcc6971bc91c94a8d5c393311cd3223b4fcd7d51af6c5a2,986499,2020-09-27 06:49:14 UTC,2500000000,2499997550,false,2450,0
0c9c97ec558831fddfe9a680185b13e370eeeecd00948159dc914f4ee655058d,986499,2020-09-27 06:49:14 UTC,737487453052,737487452776,false,276,986488
6ea925ae04f382d5960fc092feee087be3a5bb42770c5154880f60ecd15dde08,986499,2020-09-27 06:49:14 UTC,499990002,499980002,false,10000,0
cb4a14447645c86abf037fab1f105af2147bc69859cb56ea09a3e06f894638dd,986498,2020-09-27 06:45:59 UTC,500000000,499990000,false,10000,0
031d39c92d380c7001e69df603b0e3fa743e183444c729048897b288e24fd71c,986498,2020-09-27 06:45:59 UTC,10000,,false,10000,0
70709086e9d9bc1a90be3f96b0f96dfc7f885d23ae9dff953f477c4c25703238,986497,2020-09-27 06:45:19 UTC,6606916925,6606916681,false,244,986486
8bc49dd313840c41b14807941f55b68d950322ea2319c23987dee207bb4ccb61,986497,2020-09-27 06:45:19 UTC,52190898,52187938,false,2960,0
f7efc7247bb81f4fce5adeb5bf913d0271fe8d3a9b60924756685d03aaa699a6,986493,2020-09-27 06:43:47 UTC,114491862756,114491860406,false,2350,0
0289706f064d957ba5a0f917d67a32fe7d33de3e570d771c805f32403481ce63,986492,2020-09-27 06:43:40 UTC,10000,,false,10000,0
1600da78f5900c5ab61cdf6ecffa715f48c7e35c2c4d0e26a60fbba18ebcd207,986492,2020-09-27 06:43:40 UTC,117221860,117211860,false,10000,0
97ad1253b1051dd68da69ba7c8ac1b17b931a14507b12b52492d7740ea4966bd,986492,2020-09-27 06:43:40 UTC,6725435770,6725435525,false,245,986480
648ac2e2577a0575cc0e20d6409d1fad6b3e965c7ffd69aaf0e0ddeb32ab1d41,986492,2020-09-27 06:43:40 UTC,10000,,false,10000,0
249dccd87d748e9967daa300d573553d5e37d8b995664198a069189f731a24ed,986492,2020-09-27 06:43:40 UTC,752647653297,752647653052,false,245,986481
ecb45590a91ac237c755f9802d0503f317d350e3c964c2b99c43209575a85872,986492,2020-09-27 06:43:40 UTC,499990000,499980000,false,10000,0
3a218e947b6abad1e5467be35525fbf13e367e877a3863a1a1a7464ef59f9ced,986491,2020-09-27 06:40:50 UTC,500000000,499990000,false,10000,0
6eadc97fa73a110f7f5ea26cdc5a50e5e050d4aca119f333d49428be43ee2152,986491,2020-09-27 06:40:50 UTC,182622,163836,false,18786,0
2bf39d7147daf9d9d83103236c80e3f69a1cc4507aa851e049ed5b36f24b7834,986491,2020-09-27 06:40:50 UTC,180551319,180549408,false,1911,986480
eb06af9ce6f6209b69e5db26b12164e32e909be5e426f6d8d9278b62924ea19f,986491,2020-09-27 06:40:50 UTC,10000,,false,10000,0
4c8f1b9b96eee521579558f1ee485f50cca1e196318cc44ab0a0aa2431d495e6,986491,2020-09-27 06:40:50 UTC,265693742,265687925,false,5817,986480
155f477661980504c5e9f2d44ef9ebbcf7e9aec9aa62e2f72d87b57fd45f63fa,986491,2020-09-27 06:40:50 UTC,229304800,229294800,false,10000,0
01a114c212b284f7a7a69d3da192bf93d43a79d64cda043b540cd085b193d1fb,986491,2020-09-27 06:40:50 UTC,10000,,false,10000,0
8661a2a051a2348b41b88fccc7aa0da87ecc13c3e0e78b9b812da0d6ea83e2e4,986489,2020-09-27 06:37:33 UTC,144758804,144678804,false,80000,0
6a90a7c51a2aa7bc041daa3fc45b577ac9532c7aff242948b11449c14815031b,986488,2020-09-27 06:37:20 UTC,10000,,false,10000,0
8e02f7f549e8044bbd500c268b27b106b1498ff56512e1a7054af5c64213049f,986488,2020-09-27 06:37:20 UTC,213955318161,213955118161,false,200000,0
1b95937077039ce550a90cd9c9b4178ab802e304dc1d4812fe6d429fe666ae84,986488,2020-09-27 06:37:20 UTC,257844525,257841565,false,2960,0
b62c561cc3a6c7e28eca2a813a96b38b7693ba447aa5b6d18c7cbe19679a972e,986484,2020-09-27 06:34:55 UTC,10000,,false,10000,0
da7e4d235b9528cec91252ec0bdac6331f7ac74a7c102ab0cde09123c08e2f67,986484,2020-09-27 06:34:55 UTC,117108356,117099817,false,8539,0
563ce4623b05e0dc7410b62661275cc8c49d71fc3a8abd74b7ef2b39b78afc5a,986484,2020-09-27 06:34:55 UTC,15091602,15089342,false,2260,0
f2cd325ad68af21b42499cca2ff4184a46b38d8f906780479879b8d7ddf644a8,986484,2020-09-27 06:34:55 UTC,10000,,false,10000,0
4894d44e0e32def36de8dab1de9b9aa4b49a4234a11f18910176f82223931686,986484,2020-09-27 06:34:55 UTC,39455502,39439552,false,15950,986473
20a21be9c557e5207c5b06d3cb4e8a5360912bb9933704891e0257a345575a78,986484,2020-09-27 06:34:55 UTC,229314800,229304800,false,10000,0
577a5a14dd735bad629b5365210fab87938e4015f1c6eceb57600cf2b1b7a5f4,986483,2020-09-27 06:32:43 UTC,500000000,499990000,false,10000,0
55c3b63c729232e93eb77dc6619b1afcdb49e08e33a0b70b99c7194f1bc4e631,986482,2020-09-27 06:31:43 UTC,10000,,false,10000,0
dd97b874d20facce7bc6940be185e2f9317932f10719992581a97ec54630a98d,986482,2020-09-27 06:31:43 UTC,41300525,41290525,false,10000,0
3f3dac822b3da20a4b298df7b7712981bc83215d4737ef478c3b6a17aaef4090,986481,2020-09-27 06:31:22 UTC,52350791,52347831,false,2960,0
e8cad0b2be7520701e4c2fbf11c57875a4e2bccbebe2eb42aaa0b1d1c42adcfe,986481,2020-09-27 06:31:22 UTC,180970272,180951071,false,19201,986470
3cb0fc567d3d7954b762bb1596f28f936f064df3d900520a37be10dc0edd2c32,986481,2020-09-27 06:31:22 UTC,225862696,225860605,false,2091,986403
961b7c43d51115c909e30b11cccb39d090a2c99c0bd31ca9192a1febdc5f168d,986481,2020-09-27 06:31:22 UTC,267067936,267008384,false,59552,986470
af02636c63156052f748244a393bd9d554ec395cf81200e984fa84961c9ca497,986481,2020-09-27 06:31:22 UTC,325562282,325512282,false,50000,0
f3e2643fa6d7f4d1d226a65c4fc9c4cd28bcf1434e848938eef6f23ef600882c,986481,2020-09-27 06:31:22 UTC,18467344763,18467334763,false,10000,0
cc7370c841259da470f68b89817610b73dda1a6bc66bc94d1a0a5e3025a40800,986480,2020-09-27 06:29:35 UTC,258099890,258096623,false,3267,0
c47cb360f8b1d11c8a7801413870852329f45fa4dcc120c2329b54dc56d9eaf7,986480,2020-09-27 06:29:35 UTC,10000,,false,10000,0
e12263e463c6d32f5fb2201ac68356ff20ff9dcc538307b130db0e7fd2c7c700,986480,2020-09-27 06:29:35 UTC,24787449,24782759,false,4690,0
d35747072b3d9088e96fb0169412fe8809b159d59fd5f0e9992af7a41a9436af,986480,2020-09-27 06:29:35 UTC,516030449,516024449,false,6000,0
d6f8757daeca59935dec07461ddbce99cd6af087cce8eec374616cb11c7165fd,986480,2020-09-27 06:29:35 UTC,119913798596,119913796246,false,2350,0
bb52ad03d13d285848737c8d42836c8e6d0bc94ef3d797cde6a2758a80cba6e1,986480,2020-09-27 06:29:35 UTC,27543850,27539231,false,4619,0
049113d23e8cf0b7ba5cdae65e2ff96598ade80169a0a9102ce82db34e161690,986480,2020-09-27 06:29:35 UTC,10000,,false,10000,0
79a63ea17f77e94679dab09becf512e6d96a832e612042e39b4a458ef597d9aa,986480,2020-09-27 06:29:35 UTC,132073504,132063504,false,10000,986469
fbecdac1fb4761dbd934438a0a4465f26f9ba903c6265fdca3e8d1bb4ba9a94e,986480,2020-09-27 06:29:35 UTC,500002960,499992960,false,10000,0
9ea0a4ccbe43b55925eb050035a076295565c31dc5539541d18f2eb9be9ce4bd,986480,2020-09-27 06:29:35 UTC,117128802,117128526,false,276,0
97a433778073e9273bb4377a8b21be400b7716a649a4a9f14887b13a9eb1b415,986480,2020-09-27 06:29:35 UTC,10000,,false,10000,0
5c5f63330bd8defa52bbaa3a8be349be3890d2e792c9a2857901922c89128f25,986478,2020-09-27 06:24:13 UTC,10000,,false,10000,0
edb60538a87a5015713699c8116690b127cadfe20ee76dbeac43efd8225bb482,986478,2020-09-27 06:24:13 UTC,5201881454,5201871454,false,10000,0
f478f8cc800acf3126c8c1c10986c1528a6eebdf338ab1be3615422cb1b08f68,986478,2020-09-27 06:24:13 UTC,10000,,false,10000,0
89de4651144f46693ee468d6ed5348980058ee93b5f2535a12263dc212628cd4,986477,2020-09-27 06:22:30 UTC,240676410,240673960,false,2450,0
707eb9638e5f21bcf80d0512c7d837e93f2f8d4d8a13e35579059f5022fcef76,986477,2020-09-27 06:22:30 UTC,117507661,117507385,false,276,0
5e249e21998e0dadd453dbd1d2cb08ee8a358cbd38484295d62495290d49798c,986477,2020-09-27 06:22:30 UTC,120899904452,120899902102,false,2350,0
0b0a3709b92fefa8034de4961710c09dada6cc57823cdb579abe0f35a45bb077,986477,2020-09-27 06:22:30 UTC,181401176,181399061,false,2115,986466
d8261e5ce6f047d4332872b1ef3ec8cf29a8b72e6eb2d08f2bf6ccbbe450c2d3,986477,2020-09-27 06:22:30 UTC,268242928,268236393,false,6535,986466
6e0ebc9b7904445e59307e7ccae03870d3a2631fcdbac99cd1451db7879b542e,986477,2020-09-27 06:22:30 UTC,52634365,52631405,false,2960,0
06abb0f47f4f382aa67734d3a99f01aaff2bdc4e099a8039d2a0ebd6552b91fa,986477,2020-09-27 06:22:30 UTC,117306104,117305828,false,276,0
ebbd66d2580f02f0540b420b2df66b9c184a7316c2340b21beb57b24defcd890,986477,2020-09-27 06:22:30 UTC,6954750814,6954750570,false,244,986466
8c2fc09b211962ec65a3472b0a6efebd9d6440802011878232cda2790e445bed,986475,2020-09-27 06:19:49 UTC,499990000,499980000,false,10000,0
01a4428f540768d7a4ad2a48a61fb8069f4ea973bf04dff923d0b40390c25741,986474,2020-09-27 06:19:42 UTC,258555443,258553352,false,2091,986462
7d8b3de81faa2e8ba6013bde85112e47be5cc33c3815a063606dd7ab38fd9b3d,986473,2020-09-27 06:19:32 UTC,2159653040,2159650949,false,2091,986434
fc9ca4a5015215409c7fe44886c7f96ae8deae5ebf491158ae570bd851a2125f,986473,2020-09-27 06:19:32 UTC,10000,,false,10000,0
437aaa2f5e77f385513eea6150b261420f2b2027e86d8755e5ebf5207dba8786,986472,2020-09-27 06:19:13 UTC,4003362864,4003360191,false,2673,986461
60fb9c24d5ef72e027e01cb4835eba383d93965becde65a359f216acef5694fd,986472,2020-09-27 06:19:13 UTC,500012960,500002960,false,10000,0
99be84dc08236d2c9c0f80544ae9e5f2b26d9a330a5566e16931e3e3567f18b2,986472,2020-09-27 06:19:13 UTC,10000,,false,10000,0
cd80daa6fc16af6a82f7fdc2375b37bc0aa51bdc2f340242a47f463da218af89,986472,2020-09-27 06:19:13 UTC,5201882600,5201881454,false,1146,0
d1ade947453bf3436be979f3457319349db1ba9a389e6e93fc4de224f3af1ec1,986472,2020-09-27 06:19:13 UTC,1148828507,1148748507,false,80000,0
894a82e01574d53e6d01cd65f38274dc23e733183555c9724a05e69d63c99ee3,986472,2020-09-27 06:19:13 UTC,10000,,false,10000,0
84099fad6f02d191830799af2eb9aea9a0b66308f4e714a4aea1116dd049911e,986469,2020-09-27 06:15:19 UTC,10000,,false,10000,0
ff0563739ec7795901f9ce8016974e51ae155d694c1156d796b0f5393762ed2a,986469,2020-09-27 06:15:19 UTC,500022960,500012960,false,10000,0
5bf70b7d16c1548e7bc14abb764a75514aa58e684e08c4f07adb6ebac2c18e78,986469,2020-09-27 06:15:19 UTC,10000,,false,10000,0
c5ef9ddfeedbd936037735c6c26ca8914304d28918d03c25afbeb5bb31a9364f,986469,2020-09-27 06:15:19 UTC,966522737,966520287,false,2450,0
3161353c5ec9ce173dfb7730d0c8ff5d43e3550c023e6392d3a3e0ad4bb154d1,986469,2020-09-27 06:15:19 UTC,258260354,258257394,false,2960,0
8820b5fdf1f36ffd775ef2785d5311c4d483954fdf3d21435460e6009fc102eb,986469,2020-09-27 06:15:19 UTC,7724268,7715730,false,8538,0
fcbf7e4852d141e2ab56f6c1f15015375e3a032e122a7114824d4380bb121d37,986469,2020-09-27 06:15:19 UTC,4756737004,4756734801,false,2203,0
a33abb8bfa7a7a9de8ea9a5ee35c2ac4a43139256c42bddeaccf421bd28e1dd8,986466,2020-09-27 06:10:21 UTC,181927034,181906364,false,20670,986409
35fd16421ce1ddd27d614e0b2388d9fe7c39c1da589d19244d7f310201626f66,986466,2020-09-27 06:10:21 UTC,10000,,false,10000,0
830deff10595634ef231e1cd63427009a99209ea4ccf57ca1c545ddca0cd8b0f,986466,2020-09-27 06:10:21 UTC,10000,,false,10000,0
8af03660fca244422960a543ce474d734ffd32278f8e7a7aea44a53e18734bb6,986466,2020-09-27 06:10:21 UTC,166300413,166269733,false,30680,0
94722604fdba549969243af1610125edc001f4134bc412e41e9466fdf78b6cc5,986466,2020-09-27 06:10:21 UTC,269463022,269406749,false,56273,986455
f4bc8f7ef8291027ac96053aca8d1638467743cb9e307faaa6ebc8f94865f455,986466,2020-09-27 06:10:21 UTC,73282434,73272434,false,10000,0
7ae12ecd544bb91a699c7cf11dec4e04be86bf4734a07c81b01d897f74a118d9,986465,2020-09-27 06:08:06 UTC,10000,,false,10000,0
1dd614e9f1d0e26cdb41e6b7df6d3f7cd4887f66c991195361949440546410ab,986463,2020-09-27 06:06:12 UTC,2000375397,2000365397,false,10000,0
d457b90141a0bc36dea84c82a500c43834cd33e3f72c0e13ce1825fdbec1e04f,986463,2020-09-27 06:06:12 UTC,52902844,52899577,false,3267,0
9472a1967d8b283d2ff86420f8b2c096314e31f9a61abb14e9b28b5594ea8e1c,986461,2020-09-27 06:05:26 UTC,245799137542,245799127542,false,10000,0
ca94d387a1f5fd7f15a3ab1a8eb5974834aef2532291c200cfffec40b623c8af,986461,2020-09-27 06:05:26 UTC,2500044721,2500034721,false,10000,0
0ef9c7034d38c3f93a332ca8d783efcdd287454b75c57affdb320b3badd58afb,986461,2020-09-27 06:05:26 UTC,117559965,117551427,false,8538,0
a7b54ea54a382b221739869f35e5d47322fa5c9277473336fe4ff96ed0c48e73,986461,2020-09-27 06:05:26 UTC,2500591389,2500581389,false,10000,0
741658c56076120af06ac3680c254efeefa50c36083b60c60ca32589474ba0aa,986461,2020-09-27 06:05:26 UTC,294918697,294916606,false,2091,986450
aacfa0d0db01fc867a31965f32bb6282e6b8d4ad073101a60a97a03d68cfae3b,986461,2020-09-27 06:05:26 UTC,10000,,false,10000,0
1f5b824b0c45b10e8d5887c18e576f5572084c45de8526695f7d5065ca8ed413,986461,2020-09-27 06:05:26 UTC,500000000,499990000,false,10000,0
989f22bda55da1ed4a8a8dea610e585d0776fa8a33a4b10a4d84ff1095bc9619,986460,2020-09-27 06:03:20 UTC,10000,,false,10000,0
381da5e2d58808e421cd917de43c2c049f2a08ed02399d12cb0ed00987018e58,986458,2020-09-27 06:02:22 UTC,645933,635933,false,10000,0
39a342442bde203782d820481860a054af248929d1053ffe66aed0acee526df4,986456,2020-09-27 06:01:19 UTC,5000394293,5000391911,false,2382,986444
d4f6ac38f5e2b0702dd0a4602c171a34798e44f4b52fd96476c84bb9462c87de,986455,2020-09-27 06:01:13 UTC,10000,,false,10000,0
ff3b7b843ce0863e9f1e761eb18cfe5601903bfae47e028e5550090034fab444,986455,2020-09-27 06:01:13 UTC,270992653,270937797,false,54856,986443
0122f1e0aca773171a9b7264f9f0b8a91954b1a8bec69d5269c702f1797dd41a,986455,2020-09-27 06:01:13 UTC,6335299275,6335293214,false,6061,986444
b5ed9eae07f22b9d78d377e76161ed0ad6b43f91a3e3b5b0220ee90758be6f9c,986455,2020-09-27 06:01:13 UTC,182398694,182381823,false,16871,986443
588ee64c164c9d28bd0f73005532c7622ff83d160b598eaf8e194bfa78e97486,986454,2020-09-27 05:59:40 UTC,10000,,false,10000,0
59ce2941f0d171c81f8be8d42e6cdc8dafad02410b92dd874b568b1175323713,986454,2020-09-27 05:59:40 UTC,72779795,72779695,false,100,986443
de3fdbb9b2ef8c30b58a8e2f2c277a4ca3654e03c56ecead0f37a7075f7c369b,986454,2020-09-27 05:59:40 UTC,436358161,436289857,false,68304,0
d97d854c4262f7be8e7c5dc140d7fc403981ad661276fac4f00216d87b6fa20c,986453,2020-09-27 05:58:12 UTC,34260,34160,false,100,0
8708bbafef034afc8c22285f03ad47a50217aed4df8140de56f156c2c9b675fe,986453,2020-09-27 05:58:12 UTC,78901,70363,false,8538,0
ec9224bd33ce804076151fb300e14a21b5340c857f674f69fec7ac4726412ca7,986453,2020-09-27 05:58:12 UTC,98567,86837,false,11730,0
80512c6efbb7d49cbbbeb1ce9c24b9cd6a489c5d20160502b535e446b6f41381,986453,2020-09-27 05:58:12 UTC,10000,,false,10000,0
144d9f2a65c643d8a2fa20a8254e3d0b2a86a5f3688d73ee16b2a9221872a341,986453,2020-09-27 05:58:12 UTC,121671923721,121671921371,false,2350,0
1dbbdd97f0e11ead2bfa899f4c892bb01b7103ff0087ddec5b28c3037d5b7aee,986452,2020-09-27 05:55:35 UTC,258424586,258421626,false,2960,0
17e9ba10d5bd3806ae2519aa722127a48814f619bdabebc02122a576418ecdae,986452,2020-09-27 05:55:35 UTC,10000,,false,10000,0
2ce6ecaf96433f79145676fe115b18cf5d36b124214b8804fe7a6c2d14e074a4,986452,2020-09-27 05:55:35 UTC,10000,,false,10000,0
f000d9df677f1be189019f3627eb59fbffdbe3af5814452e7c446b3558a89146,986452,2020-09-27 05:55:35 UTC,77078233,77072233,false,6000,0
264c2e963376914303e38ff8c2222f0e015ec23576967f2c0be9955250c84be9,986447,2020-09-27 05:51:20 UTC,10000,,false,10000,0
199f7238f999b1fe707ca0cd2d3ee4abbe6d388f5d58bf19ccfee5d8e39add51,986445,2020-09-27 05:50:25 UTC,183099603,183074305,false,25298,986376
4107893f6b74e3bd8cdbd7762e29b70c203fadbc3ad3352688c4be40a11b601c,986445,2020-09-27 05:50:25 UTC,272270867,272214269,false,56598,986433
3be5523487cb6cff6f79eec2fc4c79de9ec6e5f8c48dea22fdddd42d36d0bc01,986444,2020-09-27 05:49:57 UTC,108170,99632,false,8538,0
1799aab4ec14beaba42694d8926ba24ed8ab79d256f6f69078ac72db10b56055,986444,2020-09-27 05:49:57 UTC,10000,,false,10000,0
ba08a7e1231b56ecd2eeea513edc7518c6c7194646f036db34e078975e1abb98,986443,2020-09-27 05:48:54 UTC,9030087889,9030086307,false,1582,0
17e6394163667cf140597ce893f4c5a4c98dd455440675996a8dffd92bf72d9c,986443,2020-09-27 05:48:54 UTC,734267916,734248611,false,19305,0
4284197537712f5186f9d224c8770db1106924fd17885ba06019e248aa3e8530,986443,2020-09-27 05:48:54 UTC,226873900,226868344,false,5556,0
bfc38c5a5213672fdb69ac03a2f448c01bd55f0b07ece44b390962197a9f66ee,986442,2020-09-27 05:48:07 UTC,15954577495,15954270355,false,307140,0
98af488bdeaebf7a6e5ed5e126e92de8d4bf25ad50cb3c277aca2a3ec5b7e77a,986441,2020-09-27 05:47:52 UTC,10000,,false,10000,0
64b90203e7f6bb2bb3897d7c5e098fc1c0f4bc8d190bff13bcfba9076368cd5d,986441,2020-09-27 05:47:52 UTC,316406,307868,false,8538,0
e747bcf0e2d0396454e88093625a0c456f29b1998f4a6406d0128056c87175c3,986441,2020-09-27 05:47:52 UTC,208500,199962,false,8538,0
da8e26f1a2092467b0573adcb399f84cbbb7011fa3e893f2dbddfcb06713a922,986441,2020-09-27 05:47:52 UTC,28154,21794,false,6360,0
aa007edb70c4a3b396a131ab8cfb93e05806ea123bc4c120b93dbff288488e12,986440,2020-09-27 05:45:55 UTC,10000,,false,10000,0
f1c4f03584dbdd4b505bdd1fff562f2a953943df5f7fd1138af61d2913a45849,986440,2020-09-27 05:45:55 UTC,117233263,117223263,false,10000,0
1faa48401e61d606b06138f1bc31b5dcbece9e05f786234ae171e4dcb8e26453,986440,2020-09-27 05:45:55 UTC,80379895,80379795,false,100,986429
34b196dfbf6df129e45dded0d4ae3e3b9e7adaca95df0f7852574217468a1f9d,986440,2020-09-27 05:45:55 UTC,53498418,53492091,false,6327,0
cb80a2b3e51966477bd21b4808b7cb6630a56aab2ae4486fa77694dff3b8867d,986440,2020-09-27 05:45:55 UTC,573621804,573553500,false,68304,0
a9847d294c35b71521b4799403ce4bd537076727d80feb7ae45c329145e27a78,986440,2020-09-27 05:45:55 UTC,353482,344944,false,8538,0
b6012c18e0e6304379d14d06b9c80bc185820cb3f70d5051872db13b8ebf4571,986440,2020-09-27 05:45:55 UTC,10000,,false,10000,0
10fd91e4a31e7ff28b0d5913f3a4d24df0013dc16f425cb578069bb8ce3773b3,986439,2020-09-27 05:42:01 UTC,12537545787,12537540830,false,4957,0
d57098cd9df27831ec73d4d5f8960ec24b71127d51c7cc948d3d2a45f7de0edc,986439,2020-09-27 05:42:01 UTC,10000,,false,10000,0
250c06038e6bdb79bdaee8d801bfefcf8be4af94648a769f98f6cef16b3bb618,986439,2020-09-27 05:42:01 UTC,273526805,273474561,false,52244,986428
e154f4acb48be42dfe3f7e7cb4cf15e4cc808278ddc572a81abb482fad80d8f2,986439,2020-09-27 05:42:01 UTC,620365106,620350404,false,14702,986428
1a49245860e03a950c3e5f13f19d6058c5c2bb0b33efba9798cc726d54747213,986439,2020-09-27 05:42:01 UTC,183805308,183782913,false,22395,986428
d1ba99bd7db5c337d00d375f83937ea9285617dce6c1bb85bad3a01bb7a31a47,986439,2020-09-27 05:42:01 UTC,13908,3908,false,10000,0
03b18a81a642bf5c548afd2d17a1b60c14365b78bd86f27f34d4486a42b14db2,986439,2020-09-27 05:42:01 UTC,10000,,false,10000,0
e97549a0555d179938d142d40b908fe8625ddf957e848c996a596fd621131193,986438,2020-09-27 05:37:27 UTC,1500448695,1500438695,false,10000,0
d5ab7569694723a321dcfb17425ff4a7f29544ca0d6d7181a55f7bed066172b9,986438,2020-09-27 05:37:27 UTC,18088218726,18088208726,false,10000,0
94afc844d83671c48296996a4c929560d0ac4358d2a64227acc419272a7873da,986438,2020-09-27 05:37:27 UTC,34435288956,34435276581,false,12375,0
86edb4e2967e183ccf027a863b33e1fc6f9eab43038b95504467a42dee1fe503,986438,2020-09-27 05:37:27 UTC,347851635,347849544,false,2091,986427
f88773bbc589a7f2e20480e810f747fea6b4799df53eccb711bb5e54507b0e3e,986438,2020-09-27 05:37:27 UTC,10000,,false,10000,0
3acc41786204537702afa7f05270cc3c32edab3830915c806aa105d689322597,986438,2020-09-27 05:37:27 UTC,85714498206,85714485831,false,12375,0
e44ac42c4898bc353a2aa3d0d8484e34d9838692b5f626506af4465dbb7cbae8,986437,2020-09-27 05:35:03 UTC,100000000,99997550,false,2450,0
9c7e573ffcfc1a18efccccb64325dd55d5bcc4fb0693bc18080bf20a4b409e9b,986437,2020-09-27 05:35:03 UTC,10000,,false,10000,0
22c18225377359ca8e01a35d472890855296369c2213c8bfaecb14825b295375,986437,2020-09-27 05:35:03 UTC,500195021,500185021,false,10000,0
f96390fb5444023d5e2b5d1c5b778d39bf81926ec9ba44ad479c1a5eb2c02321,986436,2020-09-27 05:33:28 UTC,392272,383734,false,8538,0
5c9a04b851893f42c173a5e313e919a39f6ef2c6f56c6dc2836203a77de32b4e,986434,2020-09-27 05:33:08 UTC,275430000,275420000,false,10000,0
a243c5bffeb66dd90726a883ef86cfd8e3d2720bad0e3c71e8273161c1bbf0fb,986434,2020-09-27 05:33:08 UTC,258903755,258898652,false,5103,0
76f3df0ab809a49685c9a13040e3a1da3303a1d2fd6848bbea1637a49b80f52c,986433,2020-09-27 05:32:54 UTC,126000069652,126000067302,false,2350,0
d064e01ca2b8b2da6fcba596f5bd2d0573ef3f79ff903318ac6eb7614c526ac6,986433,2020-09-27 05:32:54 UTC,322575660,322555660,false,20000,0
2c3408ab3b19b0b24f47d9719c15f2edd90f265039b66f740acce641513439a0,986433,2020-09-27 05:32:54 UTC,274701770,274648587,false,53183,986420
8f8890b8d34a9df3741a8d17a8362c54b4e74c52b7ffaeb1e1f7821bb98d006f,986433,2020-09-27 05:32:54 UTC,10000,,false,10000,0
07ee19be9c59eaf25b9ed5ad79f76f4953a2eac3b6bd4265c9396e420ce7746f,986433,2020-09-27 05:32:54 UTC,184350572,184331353,false,19219,986420
5714c39ed12dc998b7feb3815a9e9e7c09be08b107feeb34d3f73f4785af2e26,986433,2020-09-27 05:32:54 UTC,344595660,344575660,false,20000,0
ee8bbfa18b5a49414e600e1b7e559d8d9bb44fbc39b551c013d63af19dd1c3a1,986433,2020-09-27 05:32:54 UTC,10000,,false,10000,0
dc6c529912a107fb8aaf01c8e1cd542bbb2e93f0db6387004670eac163ff1788,986431,2020-09-27 05:29:58 UTC,432543,424005,false,8538,0
1e06360e89a3c82a5c89ca9293a93f50b524313d59217aa243738c580b6933d3,986431,2020-09-27 05:29:58 UTC,10000,,false,10000,0
2038722298388bdf507c36d1600418844107735597c6703c763507675e7c9d05,986430,2020-09-27 05:28:11 UTC,10000,,false,10000,0
f85f42cbcbc971808ce3302fe5bd9ab8eb8b1ee961765dd00e0dfb23286fb840,986429,2020-09-27 05:27:28 UTC,23551476,23541476,false,10000,0
9ed6d3594c9c2c37572774a0660b92c3a7394e16d722281cefc38edba395a5f2,986429,2020-09-27 05:27:28 UTC,10000,,false,10000,0
8594f04ff941e90666f0e9ab930bcf578d41f7873d923e997e80748b1a598f2b,986429,2020-09-27 05:27:28 UTC,3765306,3765206,false,100,986418
5d229ae643ee744e649bb222d1e85509d098ad30f2b710a886e934feafe23f43,986429,2020-09-27 05:27:28 UTC,7181626805,7181624714,false,2091,986418
bd22d82a06ab181e3795bed6245a5c6e84900b57a2c261ee1a31d4c0f0de1dab,986429,2020-09-27 05:27:28 UTC,294530189,294461885,false,68304,0
14f323f5cbd526089488251b2c876efa5fb9c86c80f43d8919dfae6501c4c056,986429,2020-09-27 05:27:28 UTC,53741035,53738075,false,2960,0
924cd480fa2bfa900b52bbe07997c2f7329f0c9ed764378154d997ef295717ba,986427,2020-09-27 05:24:47 UTC,10017800,10015540,false,2260,0
f8b501a93253805cb352cf52e85060ecc108dd978732902adb8a7f147ee769a5,986426,2020-09-27 05:23:47 UTC,106179440,106172550,false,6890,0
d78f69b955cffef0b97d196d1d9c486b9a5c3f94482fed134fcf97cc2e540fa8,986426,2020-09-27 05:23:47 UTC,85749539,85731539,false,18000,0
1af6ff2aed500a17ab0f6689e257f50ac4ee70f863ef57c785a2c60b62f8451d,986426,2020-09-27 05:23:47 UTC,500205021,500195021,false,10000,0
47deaf62e2961d00172159e9fa78cec705f3f8a2d0644aa1b6bc523d9774db89,986426,2020-09-27 05:23:47 UTC,329519815,329507942,false,11873,986409
b69aeece67f94647c8636be4f5599ff62f75cc4a8105d697a7de74d472e0382a,986426,2020-09-27 05:23:47 UTC,652770,644232,false,8538,0
c5dbb8c9413f52593f91f3b01b7075e75b3c14500e8a6e0931f9f459dd7d31c8,986426,2020-09-27 05:23:47 UTC,259096152,259093192,false,2960,0
5b8954b5f35eaba62f610434a2594ea8240b4c5e2b21617f4037dcb177def31a,986426,2020-09-27 05:23:47 UTC,10000,,false,10000,0
e937a09d2dddfb3a56990692571e9aafe48ef947252d3ac0f13500cdcc70494b,986426,2020-09-27 05:23:47 UTC,571902,561902,false,10000,0
6c95eca94843905198e130040ddc6f3a6e5a184b335c12c3dfc4fa0e3cb16ab6,986425,2020-09-27 05:21:48 UTC,10000,,false,10000,0
8848dc8344c842b87a753f29f5a622302c7c4efe0b5a9752b4611448f8b7c453,986424,2020-09-27 05:20:45 UTC,275891784,275839182,false,52602,986413
a9b4f58f527b8f5f203597b1c256cf1af83ce8cc583702e3ee29724f90fcd768,986424,2020-09-27 05:20:45 UTC,500215021,500205021,false,10000,0
7b0d238f992b3a64f891f2f04d5f3766344c991bb3c59ba3479097aaa839236a,986424,2020-09-27 05:20:45 UTC,10000,,false,10000,0
f9a2fd1adad5d0a508f6b66a1ac8ac018bd24e2f318397a0f2fa4d43dd0f7aea,986424,2020-09-27 05:20:45 UTC,381947362,381945271,false,2091,986413
a302447f87af8dc620d0f9d20847bb2f64f681c83908cba7dc89bc4850d36a63,986424,2020-09-27 05:20:45 UTC,184757680,184738180,false,19500,986413
f9d288d2432158a45b365641567eaca9e417fc3c0e8802ededdadcad43aed9eb,986423,2020-09-27 05:19:30 UTC,51090000,51080000,false,10000,0
caff812d48faa58a25aa017e109d1b1dd66be85ab2ecbc5704bb1731632f7af0,986423,2020-09-27 05:19:30 UTC,200076828,200066828,false,10000,0
02e4d3a24035e4d267bd6a910e9353c57f8e920f319cac1be5ea963efef9af58,986422,2020-09-27 05:19:11 UTC,54180066,54174657,false,5409,0
4c45fc63e7169141735fa74d7cf72a2dade270b63872ff639d181d2028552975,986422,2020-09-27 05:19:11 UTC,705698,697160,false,8538,0
0cd8cd83059c8b43215587187f57729e825305b0e149a1d5feafc84829e8a78c,986421,2020-09-27 05:18:15 UTC,516670741,516667001,false,3740,0
01ef392f65f4a6c85e3287555f2e0622a724e6ffd05b0398e985c752dfb0ac29,986421,2020-09-27 05:18:15 UTC,10000,,false,10000,0
83884371481a08c8eefdd09233642729e687a98823ef3315d2587692067951e0,986421,2020-09-27 05:18:15 UTC,753146655388,753146653297,false,2091,986409
2bff89cc350c743133dfbeb9ea374730bfec7394213a8a52a4a5c24753b1ad56,986420,2020-09-27 05:16:49 UTC,285488850,285486400,false,2450,0
238aaa7d9c03ae74db902c4eddf294c6469073e3ad4229fc6796d14375e39947,986420,2020-09-27 05:16:49 UTC,499990154,499980154,false,10000,0
6966c5d9615ea5136d84049132ef778d5853351b8ba084856ba1501d9f5a95a0,986420,2020-09-27 05:16:49 UTC,296303179,296240018,false,63161,0
66d1d6c702d065d0c2efcea418cc9ff9d80dcd8a74dd138392180c91e929f5df,986420,2020-09-27 05:16:49 UTC,15281128888,15281126805,false,2083,986409
c0bd64cebb02b47e19c0999f10990f2d5797261c17973abe59dfb3ec16dc295c,986420,2020-09-27 05:16:49 UTC,68548288,68538288,false,10000,986407
40b3229eb8d5260c6ec48b31c03df4de8b84d667dd9ebaec7671a1cfa0ab9255,986420,2020-09-27 05:16:49 UTC,413862,383862,false,30000,0
4a3f5739bb3c383cd92f9eb449741004b5685b2045fb6d13e6047e68171d6831,986420,2020-09-27 05:16:49 UTC,276959940,276907355,false,52585,986409
fb713dc50f5476992777b73a939763a5032944f341842d657b883f3e3497e261,986420,2020-09-27 05:16:49 UTC,10000,,false,10000,0
c416393606af9010fbf088bbc562c70baeaf02c39efa083688b9e087e4b13b32,986420,2020-09-27 05:16:49 UTC,112505210,112495210,false,10000,0
2d9f4cabcd6334147b99b788ac01c9148bfb6be97b61f9e9884a45a31cad93ee,986420,2020-09-27 05:16:49 UTC,5000000,4951300,false,48700,0
041db3d7cf1e282011f242e66bcc21747d0175b695148155b30f121b65ab3562,986420,2020-09-27 05:16:49 UTC,65621920,65619660,false,2260,0
ea5c109efd31eb3890b2ac64a01c199e65f6e4db25ab3b61488455bcd2b19b55,986420,2020-09-27 05:16:49 UTC,185203226,185185459,false,17767,986409
7fac4274b4ca0f50a9daa1f748a43a707b68462b395e529223b0dbd71d91ebaf,986420,2020-09-27 05:16:49 UTC,259364385,259360812,false,3573,0
4a78bae1810c99cbfbec2e52e9a8b771b30047f3d593cf7139375828feac9b99,986420,2020-09-27 05:16:49 UTC,10000,,false,10000,0
9b3eaedcb52a604d2b3821634b514aa816e4ab4d96609f6bc7ecc4d2e44432f1,986420,2020-09-27 05:16:49 UTC,51100000,51090000,false,10000,0
eddb1e23423c4c01794eba2b41caefee4523e69cde7cd9a509fcf49ba5665d6a,986420,2020-09-27 05:16:49 UTC,10000,,false,10000,0
851706e5c057dad9176adc22e5eaaed402c1196d25dd51a6a805554460951139,986420,2020-09-27 05:16:49 UTC,10000,,false,10000,0
a266cd36d8dfea4006aff5d82056cdf2b310c68da7c685a0f1f348ca340919a1,986419,2020-09-27 05:08:53 UTC,5016428,5011682,false,4746,0
3e213d6490a4ef3a4f042fb01109d84a14645d197659c91c8d4be886022b46b3,986418,2020-09-27 05:08:27 UTC,431779338,431711034,false,68304,0
7c9db16727e0badc3b8f45b96db8966082397d10abf0549a3b15ba469ba0f137,986418,2020-09-27 05:08:27 UTC,10000,,false,10000,0
28ca97c56392bc282d4b1aefe6da5a485d3a2bf1d14c9ab28434c1a1d8c6871b,986417,2020-09-27 05:06:14 UTC,100000000,99997550,false,2450,0
7619a9c119e8f491557c1ce4d74973ade12a3426c4886e9a54b5cc71acdbbdf7,986417,2020-09-27 05:06:14 UTC,10000,,false,10000,0
9352f0b38b9e03119662e328483c35dd3ad08a6c8346ea683f2bad076a2d68d9,986417,2020-09-27 05:06:14 UTC,1000030466,1000020466,false,10000,0
a8dc3ef8356fc615d00c3b7a3d9191e9c1392984a9bce860a8aef142c50fca9a,986417,2020-09-27 05:06:14 UTC,2500054721,2500044721,false,10000,0
aa153761d2d5561ab8412c1c10b74423fc1cc3bdbf137a9805ce2f2f04e8e7d9,986417,2020-09-27 05:06:14 UTC,243548000673,243547990673,false,10000,0
b966675359ed7c193480319c4b7bf8a010b3fcadc48a626d4986f5c2a699be1d,986417,2020-09-27 05:06:14 UTC,3722329,3717710,false,4619,986406
dd56553e4ab81c98c01cb51b1d01d9552e5ba2b82576388ecf7f10fdd2d931e6,986417,2020-09-27 05:06:14 UTC,3000047799,3000037799,false,10000,0
dd8c835169ae483d0868d035ddce34641e825ad523d009ac4f831543df206a73,986417,2020-09-27 05:06:14 UTC,5000404293,5000394293,false,10000,0
c066a5eac34bc261eaa63b8ef00496d09448f914558a59a50a6e474aa8cccbd7,986417,2020-09-27 05:06:14 UTC,43004,33004,false,10000,0
b4e86fcb380586680759ebe99e95b830cc21fc9e4d1b76e22c8ed437402cb35d,986417,2020-09-27 05:06:14 UTC,10000,,false,10000,0
cd466170a93132fddc2219a9f365e40fcd97e9cc9fb2687708ec993ed13d5b1c,986416,2020-09-27 05:02:34 UTC,109736,99736,false,10000,0
371c06c69a830faf5bbd52afaa8b0b3656108542aeaf951827ea0f9198f7060d,986416,2020-09-27 05:02:34 UTC,18001543276,18001533276,false,10000,0
57161cd0adc185abf1cfe98e97b18495a19cd427dac52b0925830ff75ce5849b,986416,2020-09-27 05:02:34 UTC,301582748,301579504,false,3244,986405
018a582300e95f295e929739fb74c13c762b3435037a89ad6d795f0c17c32d9c,986416,2020-09-27 05:02:34 UTC,30630,28710,false,1920,0
cce1934e2985571c5547eeb6dbb3a6fec94339d2a108fdc7e3c6896681d0ccb4,986416,2020-09-27 05:02:34 UTC,15407930,15404575,false,3355,986404
617a6796fe024e9b10ea19a0dbcc738edb22465f961e799d941ad0645925f067,986416,2020-09-27 05:02:34 UTC,10000,,false,10000,0
14b4a66c048e87dbda2fec24ca4dfa117d3ccd31ca0bb76a4a2d49e8df8ebdbb,986416,2020-09-27 05:02:34 UTC,54364392,54361432,false,2960,0
87f939c298bdf38cdcaadadcc461750e2bec7d45e9e649376577ca0dfe2c7c4e,986416,2020-09-27 05:02:34 UTC,500000000,499990000,false,10000,0
8b5139f25dffbe50ca317d464f1d9c72e4ec77eb41a466a0df505f57f461a285,986415,2020-09-27 05:00:16 UTC,55832,54042,false,1790,0
0028e382de6b44a88cd2ea34a6ef1d06619da5eaad90fd6af2b9c3dc8995e3cb,986415,2020-09-27 05:00:16 UTC,278099641,278046236,false,53405,986346
798bdaeffba2536180aa98ca164352e18582ea0c80c4f0c59156781c794a50a8,986415,2020-09-27 05:00:16 UTC,186864503,186839786,false,24717,986404
1e11cba607a4ba413d8e62454a75648a7c1ebc777cce6a45d9d8c4214272a8ef,986414,2020-09-27 04:58:52 UTC,10000,,false,10000,0
bd488b46dcbb01dce2e65c6eb4bcd6564fc4bf3f89ee8cb926ff2fb7cb20a565,986414,2020-09-27 04:58:52 UTC,500500893,500490893,false,10000,0
ae639a92408e122a9862dafe9265bcdc7a0fd5d0a7c338c8780aa6493c1471be,986414,2020-09-27 04:58:52 UTC,338367000,338357000,false,10000,0
63adc3faa35d3377509ec91a85991f2f2e1dbb1bf790b183f3fb2b6e6c24ff1f,986414,2020-09-27 04:58:52 UTC,20483013579,20483011488,false,2091,986403
b1e23048796444ff290a3842a0113a7063691e9c0a16edecdbf25d77ad5348f3,986414,2020-09-27 04:58:52 UTC,10000,,false,10000,0
16086fc6761821c6dc2abeb59278fbfa48ebfeed29fce830d1253d427c359e74,986414,2020-09-27 04:58:52 UTC,166469191,166465451,false,3740,0
6d971d4354208d3ef386facb5b9b4160f86a777107656164d52db80aaf00a7de,986413,2020-09-27 04:54:26 UTC,299995480,299991740,false,3740,0
68b8ae91e90fd998553bf4ad555f279289127eb864c81ffd9973fc8a2d1cb4f7,986413,2020-09-27 04:54:26 UTC,736323,727785,false,8538,0
8b41372fae851db330aa0c7e53424ddbef3c8ca05841f36be3d28e79fd0b4924,986413,2020-09-27 04:54:26 UTC,10000,,false,10000,0
39d1a875b03ce8368e21113b57353a3ef267804c0459ce40bff5c62fe3513b42,986413,2020-09-27 04:54:26 UTC,21166439803,21166437712,false,2091,986319
1d63a6cdb09de10eef95c6489ac4bb0dd4eb4fa072a2f22244a603f5e6e63fe8,986412,2020-09-27 04:53:27 UTC,10000,,false,10000,0
c8a677b1b46d5c67dba452867aaa0fad26f6e29d9e0698831a09ac5ebcb56dbb,986412,2020-09-27 04:53:27 UTC,2014325,2008325,false,6000,0
16d46978ba46cf2b0a2a403d70d1c1da8b0659eeb77b6e104b91e93459780db8,986412,2020-09-27 04:53:27 UTC,259767973,259764706,false,3267,0
62d2b5b69dfbf68197a2927ae04da50cc026535527af4cedb7481687959ed211,986410,2020-09-27 04:50:45 UTC,667866,666720,false,1146,0
b78fd4b050011cfa01a0d18b0c6921907a084f99a0a4562ea809027926aae86f,986410,2020-09-27 04:50:45 UTC,144860396,144792092,false,68304,0
c4fdd928e13716a4e8ab0277eb29cb22d9d4f33c69361e5fd13f5f2117c5d29d,986410,2020-09-27 04:50:45 UTC,988963914,988961654,false,2260,0
507f16f55d78dade25ce625decafe7ab3399f15b12b26375f851143482cb9ac6,986410,2020-09-27 04:50:45 UTC,857107070771,857107068389,false,2382,986399
4c3ac39326c84bea9dd321685a8026571d5200f13258e469593b772aad6b3839,986410,2020-09-27 04:50:45 UTC,1758246709,1758244449,false,2260,0
953f1d1087feb677b2c17b5772afbb99cee687dab3a55a1f7f12521009cab6cc,986410,2020-09-27 04:50:45 UTC,279460506,279409099,false,51407,986399
3baa7c3f8ec2a11ad5fcf3ab25993d384b91e21c5d24cdf15131718c7ed96567,986410,2020-09-27 04:50:45 UTC,10000,,false,10000,0
80f2763d290d88931243283a07c387759b3df502b603dea720d30f69438918f0,986410,2020-09-27 04:50:45 UTC,10000,,false,10000,0
f115abd37ebf5a6d73b1e85c48c91f4035f17d3025aca334596eff806ff21b9c,986410,2020-09-27 04:50:45 UTC,10000,,false,10000,0
f1c2844f13d9e86207320d44f1b397c5c3d5926197c9e4202a560d3ba17d0035,986410,2020-09-27 04:50:45 UTC,413418453,413416370,false,2083,986399
e62d040c759eedee6dc7a73586863747ad2827cc3408afb5689a5ec61fdd2f74,986410,2020-09-27 04:50:45 UTC,187548447,187533600,false,14847,986399
1b808c8600689d363598b0d352897297f68a0f813fff6d1985cfdb72cf2366c8,986408,2020-09-27 04:45:14 UTC,518000186,517997926,false,2260,0
3a24388f210376ba2d1b0c3ae76f3e9b61d8f3a1fc4e779efa29d5f12edc4137,986407,2020-09-27 04:44:57 UTC,10000,,false,10000,0
2010c288aeae930942f3d510753902da670c6da614d795208a9269e5d9eeb753,986406,2020-09-27 04:44:20 UTC,806415,797877,false,8538,0
6c7eae12b3cea86cc03f2f7abcbc3924e3e80ca2909d9e68b40772be7d18dc50,986406,2020-09-27 04:44:20 UTC,63034,53034,false,10000,0
55fec7440e27c24cdc0507c0dd9305c98b0679b8da85805bce5d3664bd3aeae6,986405,2020-09-27 04:43:33 UTC,54536576,54533616,false,2960,0
a60752b6eac4a8579e1e9c02eea2b5387ae366e50e93960a28470eddfff23272,986405,2020-09-27 04:43:33 UTC,500510893,500500893,false,10000,0
bf68a1db79e21f1eab432039a2738873a7d2fdb5882d0a8b7edd9e34ca544846,986405,2020-09-27 04:43:33 UTC,113568760,113565020,false,3740,0
a093afa014190ae22c7b99d0286b7ee85870cb4effcb0672d32b637dd55a5935,986405,2020-09-27 04:43:33 UTC,10000,,false,10000,0
bbeb9cf304636411da7e7bd0b060fdeb779df9b380c7b6c7f7c8c6a974e0237e,986405,2020-09-27 04:43:33 UTC,10000,,false,10000,0
0bc74f85c759f59f06b85c9125ab91ccd57f9e0406eae077f7efedb736794678,986405,2020-09-27 04:43:33 UTC,18048550,18046100,false,2450,0
a12d8ba7306a141557595020a0578b9cac4a8e4232899784b5c9e93436a9a75a,986404,2020-09-27 04:42:07 UTC,881770,873232,false,8538,0
a3205c932a618058d5f16f5b0cfcadb7b3491b8607b3d64aa989c4e9390fcbf5,986403,2020-09-27 04:40:58 UTC,500520893,500510893,false,10000,0
10e1636fb338fb774af7534d923ed9ff30e625a8f88cdfb9afdd13851d1c38d0,986403,2020-09-27 04:40:58 UTC,1884003926,1884000186,false,3740,0
cb6f827ef15e8f284e7a6e02b891355a796b3249876d130b72174dbf753a9baf,986403,2020-09-27 04:40:58 UTC,188200894,188182546,false,18348,986392
e00f1a756de53b3e761986538e9f7b83f8976397403352608a6918364b2a238b,986403,2020-09-27 04:40:58 UTC,1033630598,1033623598,false,7000,0
37d1aa5a616055805e349f9bb0b83de194ef1ea1989e7fab2b4c21f6549a1f92,986403,2020-09-27 04:40:58 UTC,989024,980486,false,8538,0
94c7ce26e203e25197e862f6a8552caa0abbee1ca44fa4e9cffda87c5eb895ee,986403,2020-09-27 04:40:58 UTC,280855699,280801099,false,54600,986392
7bd96aa7ef39e4cdf658512a5ae4e8d82edf6b15897868852825a49e78899f62,986402,2020-09-27 04:39:32 UTC,387360000,387350000,false,10000,0
25a17c3d78797bc4b20e7791b16cae3e4fb3e3141f92f831c5458156baa0e42f,986402,2020-09-27 04:39:32 UTC,10000,,false,10000,0
9ea4b1ec6bd7f328f4161e98dbd7a89d5f9fc0d236963cdf4744bd3a4ae001b2,986402,2020-09-27 04:39:32 UTC,10000,,false,10000,0
cf333ee68ef7d0dba0858a46e68373ec7db7d4943bcbc72dcf1f35410356e03f,986402,2020-09-27 04:39:32 UTC,18961,15561,false,3400,0
815bde7a9c237d1066fcee608af230d14c431fee51c95c09a2d884f04dcb8908,986401,2020-09-27 04:37:29 UTC,1000054890,1000044890,false,10000,0
006653a5020138e5128c14c8cfa3ee2a330320e999e1e16145fee780894e4ec5,986401,2020-09-27 04:37:29 UTC,82808,74968,false,7840,0
521ae07c11f1f1beaaae77c8ff86895d2a47281ea89035000148a834ac23b151,986401,2020-09-27 04:37:29 UTC,45287,34147,false,11140,0
4b991e3bb9692f0f669b87d819952ba30c652a7aa95869e6495a6430903bebcc,986401,2020-09-27 04:37:29 UTC,1002059103,1002057348,false,1755,0
146e994a5a84c74a146d9d36ded1cc785cfa5ea48f29ad84cace4b6dd2d349cc,986401,2020-09-27 04:37:29 UTC,10000,,false,10000,0
2849676a5236731d4ce693fd6472c920668b94b45ea3b2aea2f6650d1cdbac71,986400,2020-09-27 04:35:07 UTC,259974612,259971652,false,2960,0
e46292af57545163a2cb836362a1dfc7c2a1c3d949e89d09805f513c4e300286,986400,2020-09-27 04:35:07 UTC,2028857893,2028854788,false,3105,0
64f534df0ce04a60d345515287e84c004b18b66ce643c8ea8a31a23180337436,986399,2020-09-27 04:33:22 UTC,10000,,false,10000,0
4b5aeffa03d1fa8b9f6dd3c8e42092ce43bff9c2c6851937c043fa6dd048c719,986399,2020-09-27 04:33:22 UTC,10000,,false,10000,0
f93c880533928f7bbcc897247f4d39aee2529590318bef9afaa5c3f8435b69d9,986399,2020-09-27 04:33:22 UTC,500016520,500006520,false,10000,0
a2252a3d49ae3de78d2d431a231d0c91f0d9f3320b82032f69bd487ca5850818,986399,2020-09-27 04:33:22 UTC,289903750,289835454,false,68296,0
073d36c3ae016c6f7824d522abb36f1b9aacf9ad670943565c2188d5116f3227,986398,2020-09-27 04:31:00 UTC,189064495,189041793,false,22702,986387
b38465a2f0088f65deaf1a2b5491df012c5f6bb66b7d8a90af2503ddcc3833be,986398,2020-09-27 04:31:00 UTC,207599328,207593328,false,6000,0
e30e8fece7092729f4591b13597420cbf9f8076416c1fd40f022f554ea8ee571,986398,2020-09-27 04:31:00 UTC,54576758,54574715,false,2043,0
094464b7dc4293db43bdcae62411638a44fb2c975426f0273d5657104ef3cf98,986398,2020-09-27 04:31:00 UTC,282390419,282335896,false,54523,986387
629903faaa0413f27313b840049b9118aeee299b5e0727450aff8f12b1e69ec0,986398,2020-09-27 04:31:00 UTC,10000,,false,10000,0
8cf5630a0b1e0efe081c96db51f8b9c13506d7de52438d7da1c91f9c91e38150,986398,2020-09-27 04:31:00 UTC,24562375,24556506,false,5869,986387
1ee450c056a096ff9fcd619a9105144101a8e3ef8b1aa33c86ac3a518b9d46c7,986398,2020-09-27 04:31:00 UTC,2137278269,2137270440,false,7829,986387
faf55bf7a577887b2c74e29d5fc924fce0a2b33e4d6e7417190663bd2f71fb6f,986398,2020-09-27 04:31:00 UTC,5405812342,5405807462,false,4880,0
34e1759720731af490a24b9475f0b113c9bc39f96be7a0c1bd66ea3e283ed462,986397,2020-09-27 04:29:14 UTC,5408637,5398637,false,10000,0
a7471b72248f44fd3bbce0a44fc579f4aa826c8833bde599de3fc8e1f5cbdf61,986397,2020-09-27 04:29:14 UTC,2999910000,2999900000,false,10000,0
98bb6073377a152077124c810a2d9d2fb81094fb8cd7a43df0a8ba14794bcc10,986397,2020-09-27 04:29:14 UTC,10000,,false,10000,0
63b3c3e1667d8dd1f38c7ab945e15b8c7de2ea4b2c2d8f30990dc60986b89f43,986395,2020-09-27 04:27:37 UTC,3000065039,2999965039,false,100000,0
483402a2ca304380f5dc72479aacada8e05eadd5814a032011e062a44aab17d0,986395,2020-09-27 04:27:37 UTC,1029970,1021432,false,8538,0
1c9f351e42566eb073616e18e169ce6e9b941dc1052af46ff4e34a94f7db6d81,986395,2020-09-27 04:27:37 UTC,74813,59180,false,15633,986384
55adf11fd0532df306d8c9a59bd458e32d068b016869bd03eae33356120e5319,986392,2020-09-27 04:26:18 UTC,10000,,false,10000,0
f6cdd657b15e4272f9d2a037aaabd8d067e69f9fe5567aeb082906e7b9ac7109,986392,2020-09-27 04:26:18 UTC,192788598,192786515,false,2083,986381
ae34826954a6e61d660fe9ba58ca0db5b77126d53fbf29ed439fd014418b0704,986392,2020-09-27 04:26:18 UTC,572719808,572701808,false,18000,0
ccaf0624a6ecb7b15abc6d15a03d6345f1c5107aa63058c43abba87f9facd8d4,986392,2020-09-27 04:26:18 UTC,267670,265220,false,2450,0
03c2827f3234d2f7586aa4d1398ad2b70be9e7ae94608bee47c87cfcbc69a6d1,986391,2020-09-27 04:24:39 UTC,1001173769,1001160901,false,12868,0
42397303cf31c95a724ad52d903d35f6a50d025c127293475fbff18cecb4a74f,986389,2020-09-27 04:24:11 UTC,10000,,false,10000,0
d7ff5123310a33fd3bb87bbbcee104d8d7838eda9e2333abe2647a2b30cf98c6,986387,2020-09-27 04:23:30 UTC,1222230,1213692,false,8538,0
8e6b8da2050a657c66241b0e621c8426e8034f02b1df3a66153f6b3f58fe5912,986387,2020-09-27 04:23:30 UTC,10000,,false,10000,0
f5347ffe314d8edc55387dafe112864610a7651d65a67b0978e45f8d865c1dfb,986384,2020-09-27 04:21:11 UTC,1296540,1288002,false,8538,0
befaaa6f1bb7ca476f60d9ad5e13ecd4ec98582177fb56b775cce04b8f57feb3,986383,2020-09-27 04:20:39 UTC,189854485,189833525,false,20960,986372
0a7589fae54707c5de0d020a110785f5ac219bd2673cdfe57dace16b1e7b88e4,986383,2020-09-27 04:20:39 UTC,283568516,283517101,false,51415,986372
587007e3c555cac767a5370231cba4b35ceb52bb1baf67b8abc466e6dc8055d2,986383,2020-09-27 04:20:39 UTC,1334203,1325665,false,8538,0
e0136fbacf7cefac5b40716a8c645fca883f9536d3844d72e47bc13d66b5f578,986383,2020-09-27 04:20:39 UTC,1371866,1363328,false,8538,0
2d977ae076bf66d8c5b54bee3cfd49b7ff18ddf272c044e02b1be63eadc7b974,986383,2020-09-27 04:20:39 UTC,10000,,false,10000,0
44b88087a91b8cf44b5465ecb27b0524ff212656b5b52d2e51f024256c4fcc13,986382,2020-09-27 04:19:08 UTC,10000,,false,10000,0
dd835a487383141ebc92edea22fa038c5d204efab71cc43b9e486ae87ef7781e,986382,2020-09-27 04:19:08 UTC,26541440,26527037,false,14403,986370
2d32548b81fd801b5cfc0f3b78a5ec41d445597ca28c10f8b2509b70debf1f02,986382,2020-09-27 04:19:08 UTC,21366111654,21366109571,false,2083,986371
3f81af543239a674e8067cc02aa4d476858c28bc37f0bca83efc3327302aea9e,986382,2020-09-27 04:19:08 UTC,260279110,260275843,false,3267,0
100e7e733bbb54dc623f88d6f08a37aafabe780bf14041b3e393d16f1cbbbaaa,986381,2020-09-27 04:17:46 UTC,1750370,1741832,false,8538,0
711eca4ca21b85dca086d10baffce49a6da3904c736389d35dcafbe281f17e5e,986380,2020-09-27 04:17:14 UTC,10000,,false,10000,0
ae4466e145eadb099bc1e622472b3fb4e95d0ddc4bb9299391cbc039921f4111,986380,2020-09-27 04:17:14 UTC,54733647,54730687,false,2960,0
c9b50cf4cd3a51b4e0957d222f47b7009358b0d6da08f8c5380742499a813f64,986380,2020-09-27 04:17:14 UTC,102713897,102707897,false,6000,0
7667b54ae6cb887706c87aaf469b7c32a7cc7eeed40d5cd21df622f68d871502,986379,2020-09-27 04:15:22 UTC,500026520,500016520,false,10000,0
950127532253174bc88b191f5a418e0dca91a7656c18cc68442e667e327dd7d3,986379,2020-09-27 04:15:22 UTC,1926970,1918432,false,8538,0
f7089e503148ff91ce457fa899a1621de0c6e74be1247cf31a77db9229ddf27a,986379,2020-09-27 04:15:22 UTC,144898194,144829890,false,68304,0
9f7a2e13e7e7050dd7a6fd27c9ea5c8b5c7778e36881e0c3e016ffab981c7f2f,986378,2020-09-27 04:14:09 UTC,10000,,false,10000,0
1cd6ec0e84e7b86ff6fee6d3db311fcf480b92c9d4ef702ab472063e34ec7bd7,986378,2020-09-27 04:14:09 UTC,53820,43020,false,10800,0
cdb47775831574eef73322ac42d363dfb8fa7597fab8b97acce5d645b6e7f962,986377,2020-09-27 04:13:46 UTC,10000,,false,10000,0
5a727d8c2764b3d8523a6c2f0e74011921a61d91cdc958ab4ad01823f411c74b,986377,2020-09-27 04:13:46 UTC,4098112,4096019,false,2093,986365
7dcc1448b42f5520c9b069bd6ebad6e4bcea484d2d779374d84c9a75279246b7,986377,2020-09-27 04:13:46 UTC,25261987852,25261985592,false,2260,0
79bea0dcf8f56385306d2829531facb91772d28163da72429dd0bd29c41c612f,986377,2020-09-27 04:13:46 UTC,114999307,114989307,false,10000,0
b7ae35589047e5dc64d2ed051bde40f1daa7513fb19212385e06dcef2511e521,986376,2020-09-27 04:12:28 UTC,260429022,260426062,false,2960,0
fd9f007bcd2b87257449071e4697e8661fba9475600925c5ba2278c14eda2419,986375,2020-09-27 04:11:14 UTC,190579935,190559555,false,20380,986363
382dfa19e8e7b0371b5c3c4470dbbf1d8f1e74c1254ce212e99996873575a1ca,986375,2020-09-27 04:11:14 UTC,10000,,false,10000,0
eb40287b5c71677309707214bea2420a4cadc1e93e584b7d6a4f8ca19ae70ef4,986375,2020-09-27 04:11:14 UTC,1986784,1978246,false,8538,0
388e56e2b3ce20497983c9a3e40edf36eb927f3769fe4390b6e79fed363a40c8,986375,2020-09-27 04:11:14 UTC,2492964353,2492948773,false,15580,0
aff090f3511697303c32c45e05658afed1ea3f822d1ad345c610c68286be8336,986375,2020-09-27 04:11:14 UTC,284978154,284924433,false,53721,986363
d7bb22121c6c2880341cd953d97ee4bfdce6e06a4c46752b6a18d783801aa90e,986375,2020-09-27 04:11:14 UTC,313320,307320,false,6000,0
8f154d08f809063129cec3fb238de55e123c0fc91a2b1b17a82c73bcc89074c5,986373,2020-09-27 04:09:19 UTC,10000,,false,10000,0
1ceffb049af053208b30624f47d27ad79bb8b6d9a8ade9fcd22ffe2aa3854bea,986372,2020-09-27 04:08:48 UTC,34923295,34913295,false,10000,0
1aff91a11f711eb36836f2cb9ef2e4bc8a13a693c3901e8ff89cfb9ee846d0db,986372,2020-09-27 04:08:48 UTC,54888468,54885508,false,2960,0
93323aea792a93daef3b3c3fbec6bcb183d7bd7980f755b7b866d48e35b7f214,986371,2020-09-27 04:08:04 UTC,30295843,30293760,false,2083,986359
7b6252d9bfcbc7c75d4ebe0412befe2430d5456cc3bfa4ea069896739e564685,986371,2020-09-27 04:08:04 UTC,16532,12740,false,3792,0
3f3e94fcf2d6c535fe25c240cca19ce7288e3702dfb8fad3aecbe1df6ece9fe0,986370,2020-09-27 04:06:22 UTC,10000,,false,10000,0
dae8b1124d524c9e9e22686980414b705b4ef43e75dfc5dea235b0c4e908b03b,986370,2020-09-27 04:06:22 UTC,500093000,500083000,false,10000,0
a6d93a386d6711338dc2e09f5119b3216f2d4e388e46beafc4363598073e9220,986369,2020-09-27 04:05:44 UTC,61491254442,61491154442,false,100000,986305
e139198c08f0ae9bc51d2bb947d7f99f7f5d8c778a8830b1db6cc88a9c188503,986369,2020-09-27 04:05:44 UTC,2225272,2216734,false,8538,0
6c18598de06435ef6a90451294983a91098c0e96cce6075fda61ae0cdf1d50c2,986369,2020-09-27 04:05:44 UTC,1500014542,1500004542,false,10000,0
da382d0654cef66caaf9cce776cfa72aa5c5698db45e6fd62593f5c4d3c5c706,986369,2020-09-27 04:05:44 UTC,242811662402,242811652402,false,10000,0
d47ed392f70183ce99bf88e72e7771ce4489efee0dab8e48016e0475bd7d06cf,986369,2020-09-27 04:05:44 UTC,3000057799,3000047799,false,10000,0
7ebb960a0bcc8c46c2d7e8f4ff6f5d5952aca038ecedbc00943108a223f6382d,986369,2020-09-27 04:05:44 UTC,10000,,false,10000,0
17807709a1617373377e23c502842b1cfb63352df2208baa8029821874f347a1,986368,2020-09-27 04:03:14 UTC,10000,,false,10000,0
4fb1bc72da19d594efe496198d2fb45867e31d506d9fd897c541e20ad6be2658,986368,2020-09-27 04:03:14 UTC,17825256634,17825246634,false,10000,0
283c5dd456d6ec376a1ebeefc3ea4ee5b36bbc9f2980ec362563d09e3bfd0a0d,986368,2020-09-27 04:03:14 UTC,260586904,260583944,false,2960,0
4b10445a36e78717bf9529cb68dddbf8082cc56e4943d9e1702a309442266166,986366,2020-09-27 04:01:17 UTC,10000,,false,10000,0
b52d9d38288de2b721b2e586298f7aaf5beba46931468b040b937d23affe8a1b,986366,2020-09-27 04:01:17 UTC,26634,25488,false,1146,0
5cce5d0603e709c634ec6c4099e948a0daa724f330a48f7c215ec6f6c11267f5,986366,2020-09-27 04:01:17 UTC,2682344189,2682340356,false,3833,986355
16fbe3f284e427032cf49c39a654b9ed30d735fd1fb30638eac13550906926c0,986366,2020-09-27 04:01:17 UTC,500393754,500383754,false,10000,0
f33ea6e100662de1e7bf3f659d38fdc1e3833c9a35fd7c528a0783c24d5f48c7,986366,2020-09-27 04:01:17 UTC,1026798688,1026710751,false,87937,0
d30e168d46d097d0dec2493ddd8472d8bc0f95f187b67864186c3027c3c2da55,986366,2020-09-27 04:01:17 UTC,286186661,286140155,false,46506,986355
fbb7404d5964b39f64d7071a28af369f3be625badb46b8f6e53020032ce47533,986366,2020-09-27 04:01:17 UTC,9271019,9268935,false,2084,986355
6dd04d53541721ef7927cbd80bb2ba129e8ffc148f3bba2fd614eb4e4710cff1,986366,2020-09-27 04:01:17 UTC,349205188,349202226,false,2962,986355
645cf407fe31f2bd2d5073e2aa9483535fb880c35c002ee77d6f6b322962d4d1,986366,2020-09-27 04:01:17 UTC,191493004,191473495,false,19509,986278
904f3b55c3d9774f2d19fd6e310a934b372c48a9acb62dcaca476ed6e4076d3a,986363,2020-09-27 03:58:10 UTC,1624017213,1623948909,false,68304,0
21a45b09cc40ff1d5ac94163ecc317a67a29589425497af1b73f810752d7c417,986362,2020-09-27 03:57:20 UTC,52650,42650,false,10000,0
d2c75e2f7d325346cd26e2ccc08fb7519f9ee4c7905eb9e6eddfd157af0d8dfe,986362,2020-09-27 03:57:20 UTC,62890243,62880243,false,10000,0
acfefd3757714cde5fbd778a23b8b2879fe825032a4c143a80324976f5cb211f,986362,2020-09-27 03:57:20 UTC,2274060,2265522,false,8538,0
ef7fd9dc60b59d70b8ca30a8c4648d2bd0c63aa2f0ccfd089f4b8a0c175b1e41,986362,2020-09-27 03:57:20 UTC,19079000000,19078979540,false,20460,0
b370a9a5c4550f4f8a2a71f2812dc7cb7044c332b6076c1ff746aa0d71bbfef1,986362,2020-09-27 03:57:20 UTC,77190,67190,false,10000,0
1e5145309b614ab6d8e30f2349e91057a4c118643b92c98629c7635d26dcc2ef,986362,2020-09-27 03:57:20 UTC,16704262005,16704257896,false,4109,0
14aadc050afdd3bd42a3c55ea5e7d3e2a63784969f0ca63a25f058903529bf2d,986362,2020-09-27 03:57:20 UTC,2311325,2302787,false,8538,0
92ac2aecc3336a7fc0705b62509eadf3979a26528f0214784c54b56d6d59425e,986362,2020-09-27 03:57:20 UTC,10000,,false,10000,0
6235aa043877a90a30c969b856b5f9bb61f7d4ccada120e3b22625025b779234,986362,2020-09-27 03:57:20 UTC,10000,,false,10000,0
d29c876f098f25f5131100547bad3a6839ff935601f7dddc536504ec349efe9f,986362,2020-09-27 03:57:20 UTC,92879995,92879895,false,100,986298
061a30c135ffa5beaaabd71cd3cd41a3729d309a7c5d31a6918e4dac62e2ec7f,986361,2020-09-27 03:53:10 UTC,10000,,false,10000,0
f378fcd821d08c9390e67217e823ea10b43691415be96e53845a19fa419169d6,986361,2020-09-27 03:53:10 UTC,95051560,95049640,false,1920,0
9489e19bc0da4bcdd486dc8083dbfaecf2d3d0d0309ed416c2f2d2adbf445d75,986360,2020-09-27 03:52:52 UTC,4905612102,4905601196,false,10906,0
1a4be7725a2d8b08a49c4a5565c10f9305c3f92bcc3d4d8fa009ab87afbe3b9c,986360,2020-09-27 03:52:52 UTC,5925664525,5925652150,false,12375,0
94f0e2fd5c5dcc652ffd4b3909fd12e90e9d8ba4a6b4e3f17d1a78ae3a00bbef,986360,2020-09-27 03:52:52 UTC,40445114036,40445111654,false,2382,986299
016eb4b59bc726910128e4fbaffc5e941f88299927bb63d954cd6d11a8ac77d6,986360,2020-09-27 03:52:52 UTC,80239171,80223511,false,15660,0
ed6aebea3288b33d966f7c9cd227ceaba5d420564a24417b10e6829d916be7a7,986360,2020-09-27 03:52:52 UTC,192044337,192025417,false,18920,986349
8bbebbfc17cd49ca435637ceb840d3b38349c1a55faea66548b428b77be5ad6a,986360,2020-09-27 03:52:52 UTC,260848420,260845153,false,3267,0
c0a4dfa09899801820551df0d19a79b14250df3ad877d4f05975822fbe6e3ed2,986360,2020-09-27 03:52:52 UTC,4905601196,4905598660,false,2536,0
fcec9c3d900c3437fe61439b721de4bb0a384335ce900d03801c4432a88b4197,986360,2020-09-27 03:52:52 UTC,51524400,51518400,false,6000,0
9c4e634f536d44518fbd7e46a8e9790bc6db020b4795dfbfe6fa989716d49142,986360,2020-09-27 03:52:52 UTC,62892163,62890243,false,1920,0
be9207d5a6d6215a627c0bd370b28f931dd7af5a815c706327e1d536fa170b5b,986360,2020-09-27 03:52:52 UTC,55209013,55205746,false,3267,0
ce46a7804f4d5148cad202bb555d7e95310498b40aa2645cbd80b8e56d03fe32,986360,2020-09-27 03:52:52 UTC,287596422,287547329,false,49093,986349
a1ac71de1bc170c0d2fb5a0fc60d5ace2e81eb1b7e54d9b91aee8e6f56eb25d2,986360,2020-09-27 03:52:52 UTC,200375016,200372566,false,2450,0
348104e1bc1c42c86dfb7ab658c171d2f65eacb4ba897ae827cc07e5b911c8b7,986360,2020-09-27 03:52:52 UTC,190103820,190101560,false,2260,0
0ddb45c3bbabfba12bb9430ce15cbc08495c534892172a8961f13cba9b42b960,986360,2020-09-27 03:52:52 UTC,38051000,38048550,false,2450,0
8fac8f1703490804ead5d85a70799ce69471153bdecb5b92a64a5c209171fcbb,986360,2020-09-27 03:52:52 UTC,10000,,false,10000,0
2347ae5874c55fb2cab22d7248efba31d377639b1c4dde0df5a9b70c8947c30b,986360,2020-09-27 03:52:52 UTC,10000,,false,10000,0
b1694147cff673fd3e0dc5dfe85cd1b9cd21848cf3dc21aa7c0e057b4f1e2266,986360,2020-09-27 03:52:52 UTC,34120131,34119131,false,1000,0
304d64d55b20223d90d075d3eee137fa3ed31286dd2de6c53f3404e7188fd5f6,986360,2020-09-27 03:52:52 UTC,10000,,false,10000,0
8bf196981c5baa30d2b98d13c0707f853f86a0f11241a627f401cd567f442bc3,986359,2020-09-27 03:45:42 UTC,10000,,false,10000,0
1ee727d2e2b179b3f4b190ddf412e3f719fcac8f5156bad0c61f71872088f9e2,986359,2020-09-27 03:45:42 UTC,46370780652,46370778561,false,2091,986348
63e49ef791684bcaf2b2c82b06053033bf55df61d9ac416875e14d9c8353e33c,986358,2020-09-27 03:44:42 UTC,10000,,false,10000,0
b5c50745ce3e7c80320adde2256adc061eb66e24cb301a07956ac831fcda6951,986358,2020-09-27 03:44:42 UTC,114330838,114320838,false,10000,0
f91d5c8c5d7625d4418d327d60706eebb145f73b649d990d0ffaa9230d31977a,986358,2020-09-27 03:44:42 UTC,17622439256,17622429256,false,10000,0
e748b0ffeb5e805bd41e7e851a43bcf0c5bf9ef5b99aa8d564a2bc44b5d2944f,986358,2020-09-27 03:44:42 UTC,500403754,500393754,false,10000,0
f3682141634660bc9171dc7b641abb290d0d5ac1c3bf865be90cee69d6e11753,986358,2020-09-27 03:44:42 UTC,277670,267670,false,10000,0
799cd7da30463ae648d834ec1e53f45ba418f26b7b1a4899e7b05c38aed9ef55,986358,2020-09-27 03:44:42 UTC,261003322,261000362,false,2960,0
986a185cf5328f572c111780bcb5204544b1ae6273da233a8dfb2a4e091bf77d,986358,2020-09-27 03:44:42 UTC,10000,,false,10000,0
8a307685a685268d2d26a4c9d14dcf73ec7694d1f392f2e0654c61554fcf8194,986356,2020-09-27 03:41:01 UTC,55882570,55878691,false,3879,0
ebfb8f6bc0d5d575c9276afaa716c7fb54fa08994d3e7f521ae6668a7f60dd70,986356,2020-09-27 03:41:01 UTC,18937362181,18937352181,false,10000,0
4aa03d72b2b70a53bf6dc03cc31bed5100dbdc00214c33cff84add98f65277fb,986356,2020-09-27 03:41:01 UTC,10000,,false,10000,0
20c9898cbecb0ad6529e089cea09ddb395fbcab03b8ad7d63e72eb67a1e00593,986356,2020-09-27 03:41:01 UTC,192608262,192588506,false,19756,986345
59e675f146f20e0714d3f8003e2189cd4a7cf9f2455317a0ccc95b0b2e68cb8f,986356,2020-09-27 03:41:01 UTC,288699146,288647142,false,52004,986345
3d0132134c5e55fb3983dfdc97130a58dae711aaf4e19a0755192242f3e716e5,986355,2020-09-27 03:39:23 UTC,500413754,500403754,false,10000,0
87e3ba553e1c5908e1ecdc2b0478e0303a47b2ef4640e531fc01807a0341787f,986355,2020-09-27 03:39:23 UTC,10000,,false,10000,0
75f8f08f5faea54bdd918ca22208446e59c0cee3836e75672236bf35bdd0357c,986355,2020-09-27 03:39:23 UTC,11545418067,11545154714,false,263353,0
41e3ecc9543632745a2fdb7593a31081d7ad41aa998de066d5a6d6323fb16fca,986355,2020-09-27 03:39:23 UTC,595126330,595058026,false,68304,0
432899a00ec4e0dc36c8cf6b282165e677e492512d0ab4eeae217f8f0c3e5af3,986353,2020-09-27 03:37:34 UTC,10000,,false,10000,0
bef7bace1dc968b305216f3c5a49c5c02539858573f74f377b6f87f6aece73a0,986353,2020-09-27 03:37:34 UTC,1549668,1544994,false,4674,0
e4b01c02d38abb6bbe2736cbf57ea542afbed3faa66bbcbd797f4ca2c8ef93e7,986353,2020-09-27 03:37:34 UTC,131188,113188,false,18000,0
dba1a68c17fb55e9f042923a52e3ace6c59e18eb248cda5a0082a426184e5ebb,986351,2020-09-27 03:35:34 UTC,10000,,false,10000,0
7d446824e5c0d7618d21fb88f1eac543f682f5562509340ad75a8d73a89b5e3a,986351,2020-09-27 03:35:34 UTC,444632110,444630019,false,2091,986340
578c6e3d75d237d4f6ebb0fcd5fd507e5a555aaef949aaa6f5cba3045fed6af3,986351,2020-09-27 03:35:34 UTC,1012874834,1012872914,false,1920,0
1835715fa35b5b91a4fdfe157c8b40e57bf051e455de95ff6ccf81837d1b7f63,986351,2020-09-27 03:35:34 UTC,500063267,500053267,false,10000,0
08e61fec55466464eb13a238c3137463f2d00f3223335f8c9e2e66be17ea74fc,986351,2020-09-27 03:35:34 UTC,2354967,2346429,false,8538,0
b47418a56df5c7e6dd45947cc90a3592c3234e8fb6ca4a878a994cea69ef32b2,986349,2020-09-27 03:33:17 UTC,67134939,67124939,false,10000,0
ea2f7bcbf4331bd8a2e40e743da4e1845c61212913f6a2e9d590ed54821e0e47,986348,2020-09-27 03:32:50 UTC,10000,,false,10000,0
e2a507a944f073355b2a30c8c65c7fa540d045e3006ff07fa2342c67376028b8,986348,2020-09-27 03:32:50 UTC,18937372181,18937362181,false,10000,0
1a53dba7a5f435210d9c2a2c40ed28e4ff7700b056d92a9e5970825bda619312,986347,2020-09-27 03:32:13 UTC,111666,101666,false,10000,0
48b794e81ef851a73fd921081875c5be20074b70c8890b3c2e23e8cc01f13e92,986347,2020-09-27 03:32:13 UTC,10000,,false,10000,0
b260137e3624926683434e9ccb57cb75f2c588b717b9336d322fb3156cd8a34c,986347,2020-09-27 03:32:13 UTC,289932791,289881663,false,51128,986291
a6775f79a2eb38c4b53d3ff9150c01ec13ca6672188ad03495196a70532dbefa,986347,2020-09-27 03:32:13 UTC,500008540,499998540,false,10000,0
1e7cb7389a056173121d2e0387d773bf6ce8f25d88acd81cd9ba35032cc9f0ff,986347,2020-09-27 03:32:13 UTC,261392114,261387623,false,4491,0
1a43091b125c78d892845810f626d735f4ec366f70951b3eb1204417e50fbe30,986347,2020-09-27 03:32:13 UTC,18443202254,18443192254,false,10000,0
b5eeec66559d2586a786e272d0d2a36d23f1fb065cf4f93e009cc95d571543d7,986347,2020-09-27 03:32:13 UTC,192959792,192942892,false,16900,986336
68c245702657a443de9bf72983b68ddba54693784c6b49814d954f2585cc216c,986346,2020-09-27 03:28:25 UTC,10000,,false,10000,0
3726f3a3517cd158e0c69e4998ddda74d9939fcf38e2c030d0d967cc48768070,986346,2020-09-27 03:28:25 UTC,271619,269169,false,2450,0
e40f460becf2961873229e70bd8bbcb40a3023040979851f4b8a19f026bb2e9e,986345,2020-09-27 03:27:42 UTC,500018540,500008540,false,10000,0
695a42e983ac8d91959991de467f09c629999d905c62b0aa99aeb1bd2455c65e,986345,2020-09-27 03:27:42 UTC,10000,,false,10000,0
fabebef3d6bc7d8facda160bb6b38c2e87c01d0d84433cfcfdf37a8f4b71d710,986344,2020-09-27 03:26:26 UTC,133384,123384,false,10000,0
adf2268045c6a277fe6fc2c79b071d0a0759c0b65957c2df5810b2a5d0d5d325,986343,2020-09-27 03:25:25 UTC,908908349,908904609,false,3740,0
c6253fab6718a28abed9e45cae68c140fc1f1d6848cec55f7c44d573c90a732e,986342,2020-09-27 03:24:56 UTC,10000,,false,10000,0
39bd3628849124d95b7a0f0b2d11e87b6e68f3f8abc146423a99064f33b46109,986342,2020-09-27 03:24:56 UTC,97645466,97645366,false,100,986331
da2d3778c854d70839d490e0d6e8104db773607a0a10fb86e3e17924d17cdbeb,986340,2020-09-27 03:24:04 UTC,975292101,975283724,false,8377,986328
779a975ff3e5cdf0dde3b490c48028255a36bc96b6358a1f898e67a9ceab8caa,986339,2020-09-27 03:23:00 UTC,134614066,134594066,false,20000,0
6e1f11bc7f41ced523ba01def5c51db33270eb846cbc738b55c0990286971e5b,986338,2020-09-27 03:22:42 UTC,889907617,889839297,false,68320,0
0539fd170cec54264f9221fcdd9c3eb82791701b7e083381865570a16fe7c11e,986338,2020-09-27 03:22:42 UTC,10000,,false,10000,0
5f7e83726f238063b33bafc7d73a264de984452e39a4d54341afd2e5b09a0e4d,986337,2020-09-27 03:22:02 UTC,312753203,312747983,false,5220,0
f24eead2e3f20c8878f132e68a2e4cf43881625710acf877f3136b323590ede4,986336,2020-09-27 03:20:26 UTC,10000,,false,10000,0
aefff614323ec78e568e5bb2538573993d5febb24992eaa403f7d5e02a950b54,986336,2020-09-27 03:20:26 UTC,13546,7662,false,5884,986325
1b0a115c10a4e1b0aafc03467039c1c8574e6e2bce9513a2d3b225b7a3349498,986335,2020-09-27 03:20:07 UTC,290912628,290869049,false,43579,986324
f2173d92921c0c95b6e00b04a72ebef0f886deadf0257ea47be4add32e597d9c,986335,2020-09-27 03:20:07 UTC,56063667,56060400,false,3267,0
90870eed0f94897126db4be57ef00d1486dabf51fa8bf1aea0660ee1b709e062,986335,2020-09-27 03:20:07 UTC,18443212254,18443202254,false,10000,0
d351a450b0424de04bf04a1fb9357c0bb43e63b9955a6aed9b5bd59b15d961e3,986335,2020-09-27 03:20:07 UTC,10000,,false,10000,0
e0fe55111d1dda7db871b6ffb18ab853859b54510a61250915152ae5e1c6fe45,986335,2020-09-27 03:20:07 UTC,193311886,193295291,false,16595,986324
94d634a7a3b938d0188b0c8623a9ef0637b351103d92fb8dea862dcd56dd08cf,986334,2020-09-27 03:17:29 UTC,18564801703,18564791703,false,10000,0
4901857dcaf95bcd9a6a1059e0cedbe8da5c118a60459ca1f4566f1e67a10e81,986334,2020-09-27 03:17:29 UTC,281619,271619,false,10000,0
87a602a7484dc202adb886be4239c4b47bcbb7ee573d79161ab9e50a688e89ee,986334,2020-09-27 03:17:29 UTC,10000,,false,10000,0
8cb02c360de26fbbaa4562f35bb560f809970113edf092d624dc7d130847adbe,986334,2020-09-27 03:17:29 UTC,100010000,100000000,false,10000,0
4afbc7e0ae155a651ef555e766613ebaf19c2e62f8bc69fda6e71f58594b85cd,986334,2020-09-27 03:17:29 UTC,499980000,499977908,false,2092,986323
01a7ff9d12d2802eadecb0c436b5f473f1975c06dc9cadf1cc2d6db60cca427b,986331,2020-09-27 03:15:12 UTC,23405782,23403690,false,2092,986319
e0761063081d39d2008b96c42d14acb13ba9276beefa2671a5eaab943259f8c1,986331,2020-09-27 03:15:12 UTC,8585130808,8585128716,false,2092,986319
42d5255dc31d255fff54a5658796626d3a93dcec2f7c386d5c8dd11ab9dd9fbc,986329,2020-09-27 03:13:54 UTC,1553310427,1553053275,false,257152,0
c8a5bb7e5c81840b177e2a9f61e07bc6991e1d9bbdd5ee2b00d5558315e6fc11,986329,2020-09-27 03:13:54 UTC,10000,,false,10000,0
3b4deaf1cfd021d90f3f06886a7368e857860eced6231e3468e6962c0bb36e10,986329,2020-09-27 03:13:54 UTC,2601624368,2601622248,false,2120,0
489219070636dedf99914f74199ae3c945089812923aed318ef8e8e8bf548aad,986328,2020-09-27 03:13:25 UTC,714011950,714001950,false,10000,0
d09d34245ae5b7aaf7f5816b949f9f1761e1fecde0d83d171a879c5dacf051b4,986328,2020-09-27 03:13:25 UTC,261621355,261617782,false,3573,0
11952ae133794ffa054cad50f3086000fe18d050294b8be4a0433e4f097c379d,986326,2020-09-27 03:12:35 UTC,10000,,false,10000,0
1b9ba567be1b9863fa5047514cca6941c1894ecb1236ce2dd5fd6f864b628a9c,986324,2020-09-27 03:11:20 UTC,5135298,5133368,false,1930,0
85b3843672ff3b13cb56ea6655ecfc3752811ccc76631313918a004e6e233420,986324,2020-09-27 03:11:20 UTC,193764130,193743532,false,20598,986312
8a85efc5b14b36bb013b66e9e52aebccb629e167af55be6b300e640392a64879,986324,2020-09-27 03:11:20 UTC,4782622994,4782593516,false,29478,0
1e3bbb509bb583c646ac76465e30428b6234a08ec84a8d4da940e0377162446a,986324,2020-09-27 03:11:20 UTC,292346667,292291269,false,55398,986312
c91a593e264f9f7b5dd6204c5c7e56724167eff5aa1d5a779f9912aec9582039,986324,2020-09-27 03:11:20 UTC,10000,,false,10000,0
27183b19108ba6be3185c0d0ee3c83a16a3134e2a06156ab7028ddae20806aae,986324,2020-09-27 03:11:20 UTC,10000,,false,10000,0
f230c000865632665cd05439336c55ca0e07094de5631668ed46baee48c18e02,986324,2020-09-27 03:11:20 UTC,718512658,718496274,false,16384,0
5d563878b0b880f300cb783d5f92e2ab3bf3a36135a0a7ae298f3a74c4e5cae2,986322,2020-09-27 03:08:16 UTC,10000,,false,10000,0
60853b67f911509a88ac8c3275082efac7d88a3851413723f5717b9ed6487e9b,986322,2020-09-27 03:08:16 UTC,56286138,56282871,false,3267,0
b4de2e4e34524d737f16f96ae0009dc62e95848d6bd458cf8194ceb43ebbad67,986322,2020-09-27 03:08:16 UTC,49530157,49528073,false,2084,0
ed95da86a327cb625b9653d8cc39896bfaf586b36763d7179655da26ce8e4f56,986322,2020-09-27 03:08:16 UTC,500143193,500133193,false,10000,0
4aae6b7a223997a83583cb2fe5bce0d3d7004ef98dedaa4fbce13309eb592563,986322,2020-09-27 03:08:16 UTC,908640209,908531309,false,108900,0
b2671851c474b1b9c0df47bd0784de995abfe1adeb186320966623f6ae900898,986322,2020-09-27 03:08:16 UTC,224799218,224796768,false,2450,0
e3bad9a9f0d6c6c131c38fd6f78460a83b4f9e674ebae59a5aa02e8c50b096d1,986322,2020-09-27 03:08:16 UTC,1000000000,999990000,false,10000,0
a9fb3e61b4472ca96dd443dffc4c98f92bedb392630df25225f8e472535c2345,986322,2020-09-27 03:08:16 UTC,453157798,453089478,false,68320,0
44855ff2774840ffb3db7c99c37ab8c22eef6e71cb294d8440601674adf7f8d7,986321,2020-09-27 03:05:06 UTC,34363430,34353430,false,10000,0
b4104684deb5bd61c82fe1ec5deb2bfdf81467486e5fea738a04c42eec69e45e,986320,2020-09-27 03:04:39 UTC,2405527,2396987,false,8540,0
ae77c6844e672c8c6f52b3a58af378e0df86307383859ea334fc1b2e41bbcf31,986320,2020-09-27 03:04:39 UTC,10000,,false,10000,0
4102380411eac80c340fc27e33667613302e201d64651744ee336bc511694f55,986320,2020-09-27 03:04:39 UTC,242655308881,242655298881,false,10000,0
074f915f0a7f54ebb0a03572207a29d2cc634d331e554ddb9ecde702dd285e07,986320,2020-09-27 03:04:39 UTC,500019686,500009686,false,10000,0
e9cabc2c8caf6066a703db78a19c0db988a965ddf4eaec739dba2f09ce9afcd6,986320,2020-09-27 03:04:39 UTC,27625191,27621835,false,3356,986309
1f9df0c7f062409af6e3bab13102e13213b24728104e52feb91e7afc5851c546,986320,2020-09-27 03:04:39 UTC,379433,376713,false,2720,0
e1288ce90d3a72206982332b1de1d19e2b389da9cd51646d4defb87fdde7073d,986320,2020-09-27 03:04:39 UTC,1500024542,1500014542,false,10000,0
d45b29a338d7be1188bdb9c5acaf6324c5ee3c61d37f8d27ba9854db75567862,986319,2020-09-27 03:02:32 UTC,10000,,false,10000,0
5225905621e91fec66f0c219a3a6b8ddf958ba3c9bc878600716c7b98ebba485,986319,2020-09-27 03:02:32 UTC,156172371059,156172063619,false,307440,986307
d1375d03c2f0753f3557eb5ce2dc5cd076a91270d74aad1e72180108afcf54e4,986319,2020-09-27 03:02:32 UTC,402465844,402462881,false,2963,986307
4d3d779729718f91a8000ed66e6a13ac8b21b3f7f988bfdd5082701826e2d28a,986319,2020-09-27 03:02:32 UTC,261775677,261772717,false,2960,0
b054bd7a5c18d987419d085ed4cdd0cb8ccb3aedf54bfc9affcbd9bcf0eceb80,986318,2020-09-27 03:01:03 UTC,194110322,194093729,false,16593,986307
2e9c0f0bb3ce555cc3a2e4d411db8bad09bfdd7147c54b910a0e7106f207959a,986318,2020-09-27 03:01:03 UTC,10000,,false,10000,0
46719364ecf4a131beb00eb7992c105b5b4e8d936f6e803ad24badd50dcc7094,986318,2020-09-27 03:01:03 UTC,2619021,2610481,false,8540,0
f49e1e4dab3832901635a58102fa05f2b85db7300eb053a356c97a48ed5131ee,986318,2020-09-27 03:01:03 UTC,994588908,994576823,false,12085,0
9b08ebaaa0ec52c005482c26774977762e95f5286c45199046a1ed457d84b0cf,986318,2020-09-27 03:01:03 UTC,293320084,293268119,false,51965,986307
f775fead2b0ec0bcdbcd9574ef2e7734719b5590eea5de31279f8447a5dedb87,986318,2020-09-27 03:01:03 UTC,829027727,829003607,false,24120,0
d6b2df7c4e39475f7078b7266237688c9e4c217506711c3f95bf93c721bae6f5,986318,2020-09-27 03:01:03 UTC,2437977414,2437974964,false,2450,0
17dbb458509b533dddbe413b0ddc9c331a234c5071659f095910158ec8952019,986318,2020-09-27 03:01:03 UTC,12123611,12117736,false,5875,986307
a00c17a4c9195f833067c9140fdec1bc6a7a47467bc76971aa4c87d6b940ce0b,986317,2020-09-27 02:58:28 UTC,10000,,false,10000,0
4c0b08c5c66a815b82d370c85d62567fceb27f08b43a8919024b664ebeec1e12,986317,2020-09-27 02:58:28 UTC,4089208504,4089139865,false,68639,0
e89ac835b8447112490dbd7d6a373c0f0f50bc18135b79cdf3facb88919fe53d,986316,2020-09-27 02:56:26 UTC,2674222,2665682,false,8540,0
17b4e01ba24ecba02f5d4a03037165288c2d355dddf0a764fbed907a391b46a4,986315,2020-09-27 02:55:54 UTC,10008575,9996490,false,12085,0
7e1a11ec59eeb4c085eb3d20781773898f41734f40c2aab026bda3717476fe8d,986315,2020-09-27 02:55:54 UTC,211874,201874,false,10000,0
b46dd1462ccafb5363d1e46ba5a504fed4204960e63bb11909c713ffeb6276db,986315,2020-09-27 02:55:54 UTC,100000448,99998528,false,1920,0
01951f17778e371b85af6a892a0f270ec4c125284a986d4cb1bd42142b138839,986315,2020-09-27 02:55:54 UTC,47505282744,47505280652,false,2092,986304
47c90e283a129420d9daac9cf438a3076626de523ca247a2e873200d1d66a35c,986315,2020-09-27 02:55:54 UTC,56439227,56436267,false,2960,0
8945e70030c41bf50fa52ad44b34be2eb5294020ed3819586612586096bc435d,986315,2020-09-27 02:55:54 UTC,9880528,9878598,false,1930,0
9133fe3853d5cf46d269f2fcd6e36547780d0501d7afb6af4bfca739cd31cd75,986315,2020-09-27 02:55:54 UTC,112442134,112438778,false,3356,986304
559a37ae0731a7a730ca1b56d01bdf2136bd5d2a93e96bd73fd3fa15d9e3daa4,986315,2020-09-27 02:55:54 UTC,10000,,false,10000,0
290a0e7e88735aa87efc632912f50f1ffc20a146f8814fce669454d7a9a2427a,986315,2020-09-27 02:55:54 UTC,10000,,false,10000,0
dbed7d2229ab87181d107acb85d5f9dcc062044ea435a2f0012da8410d702bc1,986314,2020-09-27 02:52:14 UTC,10000,,false,10000,0
a42c0884c6bd7e4edb62a69892d940720bc6da250490de64401d6cf37287f508,986314,2020-09-27 02:52:14 UTC,2733815,2725275,false,8540,0
1eb219e7bbbcb737e1a2af48b10ddf0fb872c6c79d1e8d7da1c144a3f79b6bfe,986314,2020-09-27 02:52:14 UTC,294705645,294654260,false,51385,986302
a5b209cce4ec81ab7f4f7148b60c131871c45fd9f1247ebaa00deedefc1dd463,986314,2020-09-27 02:52:14 UTC,10000,,false,10000,0
56772ce58fc97872a78c08aed4ff0784a0f354055a1a0ac7bada284275c25685,986314,2020-09-27 02:52:14 UTC,471969051,471951735,false,17316,0
11244320369ac8de3a27173f43614e7c17b4542d4c6399348d4fc6b1d4c23a85,986313,2020-09-27 02:51:17 UTC,14697145,14690015,false,7130,986302
a83fa2b6011819f0446fbe4350e6ba291b8121de2d8ecbaa56b5d3b08d23ca1a,986313,2020-09-27 02:51:17 UTC,2966738139,2966512902,false,225237,0
aa10622019b255d5ea50740f422d846185e1f7f8f65396e10970e63e74b02a5c,986313,2020-09-27 02:51:17 UTC,194448820,194433662,false,15158,986302
b16b61444ac4ed58bf8597145adb653d03e8d1e4378632d8477a2996fd61fa0a,986313,2020-09-27 02:51:17 UTC,1017806,1013203,false,4603,986302
d2f9ec824d414d1a1df9868a40d6ccfd33dfd4f9bbbbcbb4c5fc627ec1afa57d,986313,2020-09-27 02:51:17 UTC,2697515,2695423,false,2092,986302
ed7b6d86f382bbfe6f1cdf48dda2d9b9f5169d7f98e1fe05bd45044e6b8ce36c,986313,2020-09-27 02:51:17 UTC,262198386,262193895,false,4491,0
5979587e637a64cd78d4c39df02255fc3032550c85b1aad39106b1278fe256b8,986313,2020-09-27 02:51:17 UTC,107681621,107677881,false,3740,0
623481b53f263ca9209773fd66d3d05795595306bc798a6f665d3a3b0313efe5,986311,2020-09-27 02:47:50 UTC,516311143,516242823,false,68320,0
e5ff0cd89a55e0443ec79f45e3052c155f9c8dbe1a768f56dfe1f00621dd7b50,986311,2020-09-27 02:47:50 UTC,10000,,false,10000,0
9ba13d4ffc302e9a0d71ec746718629abd606b7f5d0bea813ffc649668f5ea73,986311,2020-09-27 02:47:50 UTC,18564811703,18564801703,false,10000,0
a563d991cb688f61477fc2fc9f549633debfd6a674fd7323cc1dcf26cb668a54,986310,2020-09-27 02:46:22 UTC,10000,,false,10000,0
4adb404a3c0245277923561a45f3eeb272e6ccfaf239a1c1b2c61f2aeb531e8a,986310,2020-09-27 02:46:22 UTC,10000,,false,10000,0
0e38a5c866ca3b243bafe1b1d364d1fa928fea8b5886c81deb19358e4ecd62c4,986309,2020-09-27 02:44:50 UTC,19538587754,19538577754,false,10000,0
3626b7a0cd54bb851d36838686298211db2a375e059e7a4d1bf9b0f65331c1c0,986309,2020-09-27 02:44:50 UTC,130090926690,130090924340,false,2350,0
a36e7bc5f05312df797695390beb1a0df75bce746a19e11625c8dc60efe0c32a,986307,2020-09-27 02:43:36 UTC,9494345,9491058,false,3287,0
ca493f1e419706827ed2cdb92116284637315e1bf0d2781c2bfcc154c5dd2581,986307,2020-09-27 02:43:36 UTC,2762781,2754241,false,8540,0
422a460c188b21e1533ba774dfa9781365c25e0d7c561d79005944bb1ad92552,986306,2020-09-27 02:43:04 UTC,554298399,554290416,false,7983,0
63a642b28d4848b3f48eb90e2279ac68aa77005fb412291e3d2130097bcd9768,986306,2020-09-27 02:43:04 UTC,10000,,false,10000,0
fc3a8bcbd02991cfb494d4b80c674076c757bf05ffba1b53b4f7637de8d6b8d2,986305,2020-09-27 02:42:10 UTC,100000,96352,false,3648,0
00fed8afaa42f0714c0263bac81c37015ca82fe9d78da242561bd489b233b67e,986303,2020-09-27 02:41:23 UTC,16872187,16837327,false,34860,986292
3d178677984430b07557c2264983122e42ef08fec2695729a69d0b16527cbdad,986303,2020-09-27 02:41:23 UTC,8992139211,8992132183,false,7028,986291
59bcfdba0f72b9486783d20029f7f7f118ed7924f46f8be7bb8e30f8f49a77b7,986303,2020-09-27 02:41:23 UTC,295658686,295616550,false,42136,986292
92931ad9f2dfdd8e18e9f8fdc1b20d2252dbb2a550873cebc0b402f762cac94f,986303,2020-09-27 02:41:23 UTC,47632520932,47632518840,false,2092,986292
342c7e3629cc2665150b0d76e6f3578208cd3597cad1994c0762c3eadf06d0c9,986303,2020-09-27 02:41:23 UTC,195050255,195031339,false,18916,986198
6aa3aedd1cdb101507d0a242594cb9d3867362240d14074b42e2b810b79a8b39,986303,2020-09-27 02:41:23 UTC,27169728,27167636,false,2092,986291
e2e4f05f155092c1b976be15b74ba2709115e83342edf3cc3741bcd57e16f138,986303,2020-09-27 02:41:23 UTC,10000,,false,10000,0
f1634c00b6d63c20b63ed44e5f9bab0b904d646c39d0c13b71b2782fa90de6d6,986303,2020-09-27 02:41:23 UTC,56727289,56723716,false,3573,0
dd425253d89569f7513faf2079f03f49510b9cb558942d429550cf8c6b6f0ca1,986302,2020-09-27 02:39:54 UTC,9034804170,9034802087,false,2083,986290
61c49137009837fee0e79a236ce44bb8442d9173b72aa60f0b0ffa40adc4eeea,986302,2020-09-27 02:39:54 UTC,9093756157,9093754065,false,2092,986290
d35779758c46a5a6533bea9d04488236a3f2a55ec87cd43d7fde7d15bc14877e,986302,2020-09-27 02:39:54 UTC,123734006,123234006,false,500000,0
598222b407351439cb6aa9fae80fdd407d14cc7b129af548ff159aa7d15a6b12,986302,2020-09-27 02:39:54 UTC,31013821,31011729,false,2092,986290
bae3a8354427d368755365d7077fbff7cdae29050caf788eb7daf365ed60ca2f,986302,2020-09-27 02:39:54 UTC,9031018229,9031016146,false,2083,986290
46bf77ff9c5af01d86531fede2726e2465a931e5c7db90fa6454369ed5f09220,986302,2020-09-27 02:39:54 UTC,57887520574,57887518491,false,2083,986290
38bbf2a0775bf350511d8234f6368336f8c0dbf9b7725f2f0fce7956d1122e06,986302,2020-09-27 02:39:54 UTC,61379548,61377456,false,2092,986290
92760817b540afc02cae316beeabbf161ec5707df0dcd594f1815216f2e5f6f6,986302,2020-09-27 02:39:54 UTC,57679257,57677165,false,2092,986290
f53492a2fe3dec20eb8adbfe33365546e3afb6a2c43cb8a7899325197358eb02,986302,2020-09-27 02:39:54 UTC,65212706,65210614,false,2092,986290
c54591de541e82a36cdd1273ee09a0cd5fa4ebf8563849431e61cbe056e2c4ce,986302,2020-09-27 02:39:54 UTC,53798864,53796772,false,2092,986290
9f492141c050ada3b378b2f810ae5cbb9f997c64090795cd0146c73b03ad6198,986302,2020-09-27 02:39:54 UTC,34874326,34872234,false,2092,986290
c547440a31ac04758a47830d279afbe02e0f63c2e2a9d88efd21500e8dd9934d,986301,2020-09-27 02:39:27 UTC,297153226,297151143,false,2083,986289
7033165d5313302d923a3b843997c0bb650d24b1366716db9a9fb645954138ea,986301,2020-09-27 02:39:27 UTC,271706463,271704380,false,2083,986289
55c61885a52047181ed46905dca9c61b490c960ad1943b99a462c5027a8738f5,986301,2020-09-27 02:39:27 UTC,441043457,441041365,false,2092,986289
30bb75b88183342bd048675b5289dbf6f567416f39746e42abf880577a7bad49,986301,2020-09-27 02:39:27 UTC,251649785,251647693,false,2092,986289
7c1204f28f312828af70e7d0ce5e10e32089cff85837f66fe710b72725088568,986301,2020-09-27 02:39:27 UTC,275467231,275465139,false,2092,986240
92c818c4f4160949f76b5de80c9f6f4490bafd653eaf465a20276cd3459a6f5c,986301,2020-09-27 02:39:27 UTC,437192697,437188282,false,4415,986289
e7b9376d50bae5efbd0c0401dd535e5b3f4ee24e6611fcec6c1c8ec35d3b4dc3,986301,2020-09-27 02:39:27 UTC,448712540,448710448,false,2092,986230
2106aae6a55a4fe1d7e4df6959b675f6c6e1afbdb1d20ca46408f7e80d890593,986301,2020-09-27 02:39:27 UTC,10000,,false,10000,0
ccf3706c580ef89a703778784ee821e835f79cff8d0be899316d544cd6070ec5,986301,2020-09-27 02:39:27 UTC,279302920,279300828,false,2092,986289
4cd4d5c61c76badc988022c440d7b04d722351aaaf9e4058416419eceb417d15,986301,2020-09-27 02:39:27 UTC,444825875,444823792,false,2083,986289
03a9e579ef4e47a45fa3f534b7b5ee602bfe7001ff1224271c5e576c894b5974,986300,2020-09-27 02:39:05 UTC,9097599795,9097597703,false,2092,986288
323cfd5d4b5184806fa018d79841703100387973a4d4d68c3fda353b91f3c28e,986300,2020-09-27 02:39:05 UTC,57984272979,57984268855,false,4124,986288
aa26d8d56b65a3eb4f0eb559a0dbb045b83cb84f19a261b8a924cbefbd0b46be,986300,2020-09-27 02:39:05 UTC,488851729,488849646,false,2083,986288
6301f8ea8fdddaed626b7758deee4d630c1b98965484882f3e3686e0c1023fbb,986300,2020-09-27 02:39:05 UTC,530936384,530934292,false,2092,986288
69c8aebb6ed2067e345665e8b7581a497b8e6bd0bd457fac92c0d38b0a0d9967,986300,2020-09-27 02:39:05 UTC,9038624968,9038622876,false,2092,986288
085005b780e2bf16011075de9f2547fa6677a6edba06b3b2454b51b5a0adedfa,986300,2020-09-27 02:39:05 UTC,120694,120694,false,0,0
1cac08057a0b94b5971be03acd9b7172218fe75c47ad12fc0bcda865e1c12ac9,986299,2020-09-27 02:38:55 UTC,571655003,571652911,false,2092,986216
4d69b10fc229d88aae0c3550cfc57190c2d76466cafbb88523b1d85e49a802e8,986299,2020-09-27 02:38:55 UTC,845802923,845800831,false,2092,986287
2f55df88d3b4b7416bdbfaf1514bc96be7b4248c8e08cccf74536e9efe43a55e,986299,2020-09-27 02:38:55 UTC,623732788,623730696,false,2092,986287
b87aaf7c26c7915b4a5b92e56861bb24a1d2417bcdbdd907f5bb2c7889aa375b,986299,2020-09-27 02:38:55 UTC,50469023024,50469020932,false,2092,986263
4bd0e969c38029f3d097c28b9df310d3a16a4b81672f1cd8fef76102cb25883d,986299,2020-09-27 02:38:55 UTC,575395795,575393712,false,2083,986287
8de662eff446a7b61a8bff7bda58941729ec5f1b3228babb9537901646497e68,986299,2020-09-27 02:38:55 UTC,928710755,928708663,false,2092,986287
df433073462c47d7c8cce5f6ebfe581af9d51e80e344f888e8767f8b907a8ac0,986299,2020-09-27 02:38:55 UTC,818710347,818708255,false,2092,986287
a26b7001a493c6b12181f48e4a51eec048c32bc849e11db722bca86c9083f57c,986299,2020-09-27 02:38:55 UTC,604476526,604474434,false,2092,986287
710bbbd86a7b9c28d3b868ea0bd118d632087a40008516ac6d483cfd6927632c,986299,2020-09-27 02:38:55 UTC,811148101,811146018,false,2083,986287
e34d963b32b8f237c76fde468ab2b978ff79b458cc3444dfab13ae0c0577794a,986299,2020-09-27 02:38:55 UTC,838076013,838073921,false,2092,986287
dc25f324af84b6d358141da7b597a4c3c9991d786d5ce5213ad986c64852ba84,986299,2020-09-27 02:38:55 UTC,841994971,841992879,false,2092,986287
b29d3385b087f4fa6f611fc280a9ebf8cb5993134506d418639e3223f3539171,986299,2020-09-27 02:38:55 UTC,936486614,936484522,false,2092,986287
eadc4c5d845520e12028f72da144681a4043eb27bdbbfcf4a8390e9d4d46ddcb,986299,2020-09-27 02:38:55 UTC,932673098,932671006,false,2092,986287
eef00a5bf8d3f8ea9239f9b10e10ef107ffdafb6c3a5afc93bbdb125089c6146,986299,2020-09-27 02:38:55 UTC,955009056,955006964,false,2092,986287
1b291b056f0b51cdae708c80673941fc5bee08cc403abcac11a498ee42b83c26,986299,2020-09-27 02:38:55 UTC,887293679,887291587,false,2092,986287
ba1ec3fbefe51358ea4ab6389356e76a1716688343016acc6dc136f006cb0256,986299,2020-09-27 02:38:55 UTC,534752625,534750533,false,2092,986287
43c165904d7bace4589d03d4ea6d418dcb335cfd0f9e9008bccba25fac7219d4,986299,2020-09-27 02:38:55 UTC,891197287,891195204,false,2083,986287
b2274db3d3056390565edb2a18600c40bcb3cbb50881cc4a6d790e3cf0b2a925,986299,2020-09-27 02:38:55 UTC,596966444,596963490,false,2954,986287
645f0a51cb37a76b0ecd306a2a1d75d5d6182e5bf4dc5fbdcf8a2576412f505b,986299,2020-09-27 02:38:55 UTC,814874070,814871978,false,2092,986287
9578545155ffad89651b52db3016dc1ee3719af28c8b815f7f1d21e68dec8c59,986299,2020-09-27 02:38:55 UTC,579060566,579058483,false,2083,986287
ca46db37eaf73db2c6facc097634e96440c7390048498c8b44e1bc6d8c31ef87,986299,2020-09-27 02:38:55 UTC,600770722,600768630,false,2092,986287
fa4eb34b3e860730e86b8025294b9a65842c8decde9a2311e6d77703d04acaf4,986299,2020-09-27 02:38:55 UTC,849610835,849608743,false,2092,986287
57d597ada4229c6e3b56ba4f692ac6b3a52756652b00cd48171cf92947332f04,986298,2020-09-27 02:37:56 UTC,27890,21890,false,6000,0
9eafba677f4c2ece07b81001a6dadbc57262574f73447fc8063040692a5bb825,986298,2020-09-27 02:37:56 UTC,9042419452,9042417369,false,2083,986286
2f576131b2fa9b74ef44593a4db21dd96b5e672207f47304c12687f21f489d35,986298,2020-09-27 02:37:56 UTC,1015352275,1015350183,false,2092,986286
56fcff924da2059a659fdd597f1ae2ae41516116a3917e677da4d33e20094d1d,986298,2020-09-27 02:37:56 UTC,1031476911,1031474819,false,2092,986286
c80b9fcba76d54cdd16613c5ccb614cd3cdbaa0427a313a51469ebdfeb1b1207,986298,2020-09-27 02:37:56 UTC,990182101,990180009,false,2092,986286
6bdf5c3d8a2bafd00b3f455670c54b65f2b31b491dcab76b0f6e6ad8a81d4635,986298,2020-09-27 02:37:56 UTC,966415511,966413419,false,2092,986246
4a2866b36a882c225e73d99f02c021e64ad42ce96d4581c1e97be48e3d5aa985,986298,2020-09-27 02:37:56 UTC,994081569,994079477,false,2092,986286
980b6699e72307c385a24d75fde310592db88d6f1531979347d2f441adac42ab,986298,2020-09-27 02:37:56 UTC,10000,,false,10000,0
9260d95552cc5bd3530664e483af3447a88aa4a775831416a1bb837cc3b0212b,986298,2020-09-27 02:37:56 UTC,1051859236,1051857144,false,2092,986286
4a520f475ea241d0728b7d51958e2e0920a81c90e7ed578d4c6b5b1f098098d2,986298,2020-09-27 02:37:56 UTC,962634826,962632734,false,2092,986286
9abbab91f1d864a0bb58ea75a4ccc5d909479a22b2249d796ba79445dc36dbd4,986298,2020-09-27 02:37:56 UTC,982417718,982415635,false,2083,986286
d2d42917149f6c0e6679503f2dd1ff86ff51c1c8fbb847b4cec9cdeac25395fe,986298,2020-09-27 02:37:56 UTC,57988037991,57988035899,false,2092,986286
1aece1f40705a0ad067a3b9c76afe50862e914b26cd8bb0675447cf6df9584ab,986298,2020-09-27 02:37:56 UTC,958795252,958793160,false,2092,986286
a148838ab93e05ee8a1c9b2ca24875a38553ba9196376345dae04f9f8a28ad78,986298,2020-09-27 02:37:56 UTC,1048090846,1048088754,false,2092,986286
29e45bb9d137f2be7d8e340c0810de0b325144d753145745253f3834d62009df,986298,2020-09-27 02:37:56 UTC,1089625782,1089623690,false,2092,986286
dd23d32db47abaf03e7ea5d8114cfcb762d843c61cf69f481f0ad3bf6a3a44cd,986298,2020-09-27 02:37:56 UTC,986359316,986357224,false,2092,986286
21f83fe74293574133c5cab2402d24878402a4c50716f5f666bebd8001211658,986298,2020-09-27 02:37:56 UTC,9116013250,9116011167,false,2083,986286
f4e67e204ef849e02670bd0bb6a0812e4e5a7fba7911dafa02f92e5959b79c40,986298,2020-09-27 02:37:56 UTC,997873121,997871038,false,2083,986286
5e145eed9abc87a72567bd16eb2f791d67b26808bf50f0fd9c1e2d7fa30c38ae,986298,2020-09-27 02:37:56 UTC,19538597754,19538587754,false,10000,0
2d4556b611667ece3713f1d019f3040782ec5be60fcbdc054c41d18841f6137c,986298,2020-09-27 02:37:56 UTC,2794299,2785759,false,8540,0
829613a7be84f3c3ef5ab15f000ae18c7e8557e9168a2e1c55de21c514ee37dd,986297,2020-09-27 02:37:37 UTC,1131731059,1131728976,false,2083,986285
7d4b037f59341de989df23e0e8ee1f80a9374ed0378bb454d4d074363243d45c,986297,2020-09-27 02:37:37 UTC,1135530463,1135528371,false,2092,986285
c5c3c80c39a3411c9c06b29a88987cc529a08e6206a4488d1943771c15d5b95d,986297,2020-09-27 02:37:37 UTC,1093406206,1093404114,false,2092,986285
209187c0e15af8c68a06ffa77481b3a192810e00c3d22304cbf38b320774637a,986296,2020-09-27 02:37:09 UTC,4403633673,4403631581,false,2092,986285
26b10e7b7ce3cde1a633af6aac62a3502b845ab48988cb716f96690e3ab1e022,986296,2020-09-27 02:37:09 UTC,4435181011,4435178919,false,2092,986247
993a5acb982a9c19ebd14b1f94955043e9d3c724c42d8b0678f111abef6697a5,986296,2020-09-27 02:37:09 UTC,4320552202,4320550110,false,2092,986285
f744831a447324a9fbd9ed4fb83dbe1e25149ec8ae1b1b84d05a6faf33d93143,986296,2020-09-27 02:37:09 UTC,9062510006,9062507923,false,2083,986285
c5a6a372b0d4358cd3d335bd7af2002a54c661f9b9837b8e95e2ce0724b7e732,986296,2020-09-27 02:37:09 UTC,1230454656,1230452573,false,2083,986247
6d99d3dc3ed152468412fd92a7414ec7f79b76b6726df750eefdd4cae2e16204,986296,2020-09-27 02:37:09 UTC,4399793792,4399791700,false,2092,986285
2cb426a141e530257a9f5d628680faaf2c4349ab34fa7e6101ee181fb6f7fceb,986296,2020-09-27 02:37:09 UTC,1139339780,1139337697,false,2083,986285
5a33a906d20f289647c6b17903af2a05ac9342f43fbfa2d2ae4adc8f62407e19,986296,2020-09-27 02:37:09 UTC,4305298511,4305296419,false,2092,986285
e06e6e949f1dd74bb1c3314c1b2fa399eb80f883ad9bc0026cb86a501b402fb9,986296,2020-09-27 02:37:09 UTC,4286330885,4286328793,false,2092,986285
068ecbc65508f50ce8b0b20e53b8e6c97e6ea088cb48b4d0c27491e2ee784b1a,986296,2020-09-27 02:37:09 UTC,132009259162,132009256812,false,2350,0
13c1e80132780b598ac21373c9ec77f8917f60e24634b053aa8440678dc9fc85,986296,2020-09-27 02:37:09 UTC,57991891857,57991889765,false,2092,986285
fb76ea12f928804c3a3cc56540489235f820989d3ee9e58e989cc2dbc1894041,986296,2020-09-27 02:37:09 UTC,4691392625,4691390533,false,2092,986284
aebfb2349cb0b0b03a163a858b4e0eb5805114f302c879f37eb5c4c0b42b49d3,986296,2020-09-27 02:37:09 UTC,499990000,499980000,false,10000,0
220bd05ab9f7aa190930df0f39ebfb19607f75084345d0390e6169fdb80e4ad8,986296,2020-09-27 02:37:09 UTC,4411189455,4411187372,false,2083,986285
c0c7f97c139334e5e5cca099bf217570e146d9d26f4ab543df105b915773635c,986296,2020-09-27 02:37:09 UTC,4316740294,4316738202,false,2092,986285
8daa811824770bcae0b4cdd05764dbeb99c75afd09c21b21cbb3422f9b9b9848,986296,2020-09-27 02:37:09 UTC,1276817331,1276815239,false,2092,986264
d1dd852007239d8241632d3422c4e5b54646adadd1d650f400946dc4d98d8c57,986296,2020-09-27 02:37:09 UTC,4290180917,4290178825,false,2092,986285
d886ba45078a5cb2e819e91c57ac6fdd7a762a900aa72c0c71d9846c1102fda2,986296,2020-09-27 02:37:09 UTC,1207029805,1207027713,false,2092,986285
a47e8acce63590771299f4161b45974e08f306cb3987bf5fb92b6073c112ed0e,986296,2020-09-27 02:37:09 UTC,1184496551,1184494459,false,2092,986285
36e65b137729226ed765dfdf27df067351252e4513e8be2d1b98606b47118118,986296,2020-09-27 02:37:09 UTC,4301502330,4301500247,false,2083,986285
aa0c0975612b211d1c94c8a17103bfceaba8fc1e9e405c997ee4bff344bb95cd,986296,2020-09-27 02:37:09 UTC,4356200141,4356198049,false,2092,986285
da20acebf60108f4e2027751e79c15b8ea9344655fe8f9c653afdd0b46a5e0bb,986296,2020-09-27 02:37:09 UTC,4282551726,4282549643,false,2083,986285
6bce171b7b536286614fe9ca26b97f7327bcdd74b926104b71f244811da0f8a9,986296,2020-09-27 02:37:09 UTC,4476517295,4476515203,false,2092,986285
8116daa356466550b07fd476c1dead78cd67e4b2e319cb0b705f27000d679d81,986296,2020-09-27 02:37:09 UTC,4360038302,4360036219,false,2083,986285
0ef930431204e7d7a1c82b1b4bc75a2853f531d77f6e95647c3b0527b28f0ede,986296,2020-09-27 02:37:09 UTC,4407417798,4407415706,false,2092,986249
ab9a46638c581d4d81ddef921bb38b318c2d6dc29344c0ef8edef2aee2a00ba7,986296,2020-09-27 02:37:09 UTC,4363760994,4363758902,false,2092,986285
af93bbc13d122044a68f365c04ab20cc881ff272f02a77519cfeaf68f3637ce8,986296,2020-09-27 02:37:09 UTC,500033359,500023359,false,10000,0
1799e219428b4e86fa335edbbd93e27023d8aa56c131cd6cb2a3797e3e4901db,986296,2020-09-27 02:37:09 UTC,1273128985,1273126893,false,2092,986285
1a13f147134ce000b67cdc463472f6abb83df216d364bba8c11cd310ccf652cf,986296,2020-09-27 02:37:09 UTC,4198287432,4198285349,false,2083,986285
360cf02bb2d686cc19b928499ee7d2fec5d175c7100737365ce2ba26e0a69758,986296,2020-09-27 02:37:09 UTC,1226565842,1226563759,false,2083,986285
09721b3d05d640c8ce823cd25a0e4be9e3288d558663cfb8d28fb2d31e7f1c14,986296,2020-09-27 02:37:09 UTC,1234312682,1234310590,false,2092,986285
12e005684eedbb278934ce72eb0ea0f560b010c84753c57f5c4ebc8deb69238d,986296,2020-09-27 02:37:09 UTC,4202064468,4202062376,false,2092,986285
520fe0be237a07b4e5c3b0bc9c89347b0b56f015e5368fc4880cd21278c13624,986296,2020-09-27 02:37:09 UTC,4090000355,4089969620,false,30735,986285
4934512362fd7db77c21ae58bb3162617c08b4c0e3e84dcc55eecb711b77a043,986296,2020-09-27 02:37:09 UTC,4293929039,4293926956,false,2083,986276
17a4b52431e15dec7bf6f655fef36c4bc04678f13d3d2078fa16ac107f7a183e,986296,2020-09-27 02:37:09 UTC,4297756051,4297753959,false,2092,986285
dacc299043242c8db002e4b9788cc5047726b720a6e18cdaa0fc63df17e1d85c,986296,2020-09-27 02:37:09 UTC,138014172,137999791,false,14381,986285
21aa4f330348080b7b4b99ce1ba7e757a6ac3f3c02a95fcd2107a92819bfa727,986296,2020-09-27 02:37:09 UTC,4683754882,4683752790,false,2092,986285
e429db76f388ee1012b33a41d2c52a4263dbe403bc03560516d8efcfb28c2a82,986296,2020-09-27 02:37:09 UTC,4309071145,4309069062,false,2083,986285
20bb62939fc7173a58cf4a2a98475241df0a417de0ca3e1961ee94008d565a47,986296,2020-09-27 02:37:09 UTC,4472701158,4472699066,false,2092,986285
e6a53c120a22d68d022a4f4b0fd5ddb64558e554121583d76500469fec2535d5,986296,2020-09-27 02:37:09 UTC,4414831262,4414829170,false,2092,986285
c3abd928a44933cbb643f5ea3a231108aa4cc835b83cd29a43d52b2845b7611a,986296,2020-09-27 02:37:09 UTC,1176823281,1176821198,false,2083,986285
e199cd89761e337bcf5d4f9fa843a3761de030f015c578182c7bf3ee1c0a59cd,986296,2020-09-27 02:37:09 UTC,1203072137,1203070045,false,2092,986233
e292e809e9a4835db48045d8de9e36896bb9f0fdbb5c47ac2fd0f8bfe54e5732,986296,2020-09-27 02:37:09 UTC,4712924246,4712922163,false,2083,986284
9ab78bb7028b84566173d2c631bfa81ee95972601d01d6e0319a8d543b1abdf2,986296,2020-09-27 02:37:09 UTC,4127650024,4127647932,false,2092,986285
915967c1534b58fad6c0903d6c8200351c3b1a0c51a821d137ca01738290c3fb,986296,2020-09-27 02:37:09 UTC,4716749778,4716747695,false,2083,986284
2f51cb574f42e341a6297e6691c9830807ffc391e2221ea41b51e36ecb444f53,986296,2020-09-27 02:37:09 UTC,4205852222,4205850130,false,2092,986285
477e81f46e423bac7f42d9701977d8bc431ce3e79564f0596b76e90bc446ea0c,986296,2020-09-27 02:37:09 UTC,1180622181,1180620089,false,2092,986285
61343dd0f73cde45fe94cc422746f8420f1f1cc9c927d994daf67a1a658d5462,986296,2020-09-27 02:37:09 UTC,4495294099,4495292007,false,2092,986285
b4c2e9ae312ce60172b270aea2317a5d5ba42ab247d6eb84d85f21a157430ff0,986296,2020-09-27 02:37:09 UTC,4312833108,4312831016,false,2092,986189
672ff351733705d4d2cabc239da201f9af977250366a26982811b61b9064432b,986296,2020-09-27 02:37:09 UTC,4720577511,4720575419,false,2092,986284
0307ab275b7bb18c77b4ce265348cdd2e24d90222aec25e21671a9c19022cf78,986296,2020-09-27 02:37:09 UTC,499990000,499980000,false,10000,0
38db581e411124ee7a35f9265ce4e933a549b82fa4bd4114de34bb84e59fb8a4,986296,2020-09-27 02:37:09 UTC,4244667062,4244664970,false,2092,986285
f39838d2e94a8712a8c90ab0a051298bc0eb6a4783eded0d21b741466124839e,986296,2020-09-27 02:37:09 UTC,4687499902,4687497810,false,2092,986284
dc92788c4df0d15419b087a856d4cdf8b9f201be5d615dee83a9412910d44657,986296,2020-09-27 02:37:09 UTC,42536,39136,false,3400,0
aa1fa6d3cbd5f9c7d0e5c7bbfbe2e64ae526eacad38a7afacca3090a4a801b69,986296,2020-09-27 02:37:09 UTC,4164214965,4164212882,false,2083,986285
3b6e63a90406b88df5c3eeff06dfc330719fe296d37e83be575d3c88301d6686,986296,2020-09-27 02:37:09 UTC,9119861507,9119859415,false,2092,986285
3383920d8c10e631b45f00ad8cf253876983bbba0fb015fd10a76a4bc4eb4521,986296,2020-09-27 02:37:09 UTC,4695152354,4695150271,false,2083,986284
3b1da7751c5560bf806adb3b9c54bbd241732d36cf6ed1af3645b291df4a3a8d,986295,2020-09-27 02:34:56 UTC,5017884247,5017882164,false,2083,986284
052295a20aaf7ea5a433323a153d97403af0c6a0180c547ca82be8acdc44ae72,986295,2020-09-27 02:34:56 UTC,5397579503,5397577411,false,2092,986284
582c55a56a9d7f192d5c39afc29e7af902fefbcb6331e9e37d1d8f8c8442d9af,986295,2020-09-27 02:34:56 UTC,5006418085,5006415993,false,2092,986284
2d0b22429590752fe1c0df0e31801036ad4fde7f8bdb438366d79a13a6a4cef3,986295,2020-09-27 02:34:56 UTC,5488300862,5488298770,false,2092,986283
3b0873e7b7ab8155764941ff4884d9e8d931e17de9bc4048255539ef5ed842ed,986295,2020-09-27 02:34:56 UTC,262401139,262397872,false,3267,0
c704f51f8ce347b713f7050af831743d9c4f983757206a435e7394fd1514e5b3,986295,2020-09-27 02:34:56 UTC,4945098638,4945096546,false,2092,986284
0803232a66aad737983218d8b9098a1ba6b75bf3ac2d653329ae30f4f67c7a6b,986295,2020-09-27 02:34:56 UTC,5361163592,5361160919,false,2673,986284
5923ec582acfe7cfbfd3d8c46b4abd599b5c6894b15965e924fb152fda8477f8,986295,2020-09-27 02:34:56 UTC,4937520782,4937518699,false,2083,986219
028fb603e079fd52dbf8fe4c47d28a4ae54c2a08c9586970778b36241a9dbaf3,986295,2020-09-27 02:34:56 UTC,4838791301,4838789209,false,2092,986284
63fa439518e16689cda5243793dd17f324d3c70b4acdd705795de43ae7e70692,986295,2020-09-27 02:34:56 UTC,5588278695,5588276603,false,2092,986283
ab8ae1d8e76603323e9096d4644ffaedc8d9fb60283ff87f550930ccabaeae75,986295,2020-09-27 02:34:56 UTC,4842577322,4842575230,false,2092,986284
73b38a9506c0d31c815ccf933dd9604f02a49e97efcdb5c2b82c1440606e9dce,986295,2020-09-27 02:34:56 UTC,4865022395,4865020303,false,2092,986284
99fc8332febfae147c0b69e3243c6780248f67693eb39a5d9c9d09610999df02,986295,2020-09-27 02:34:56 UTC,5496031633,5496029541,false,2092,986283
ea88344c211c060983490b6ae4ec88c22582e5ee3373d2951570751bd7ee4f84,986295,2020-09-27 02:34:56 UTC,10000,,false,10000,0
d12123d318b8cf81defe6f9297f798eece56956b0b1c6548f22b208cec27ac5f,986295,2020-09-27 02:34:56 UTC,5499837324,5499835232,false,2092,986283
b6ad9c6ce1dbb74243e363a7d008da633764e1c82b7a3d13f92ed43f434cff71,986295,2020-09-27 02:34:56 UTC,59149661964,59149637292,false,24672,986193
ba767b04d6e7c51db8c6dc261c2ee017d3cdc7da96956dd66c91b7d67ba82ecd,986295,2020-09-27 02:34:56 UTC,5465620234,5465618142,false,2092,986283
e6340bd3b668f2fac9966c5adf3a332f1f6fdf7fd1746088ff6427ba94d9e6d3,986295,2020-09-27 02:34:56 UTC,5438889789,5438887697,false,2092,986284
05dfc457af78d0abdb5c787ccec946a3cee2239eabeeebef9c380ef3f6373727,986295,2020-09-27 02:34:56 UTC,5511198991,5511196899,false,2092,986283
ed88f93b7177ffcdac818aba5b25a8796a338e132db46577637491cd77d42e58,986295,2020-09-27 02:34:56 UTC,5507342417,5507340325,false,2092,986283
f3dbd560c07702b92322b0f9d614c8ef130f49886a1552a65a9192fc215efb8c,986295,2020-09-27 02:34:56 UTC,5037019610,5037017518,false,2092,986284
65ad986fcdc1046bf86d4219a00d00fa1e7517134bf66f14fb4d5060343ba51e,986295,2020-09-27 02:34:56 UTC,4872641082,4872638999,false,2083,986283
37d3f74dd47f8a963008ed13a2b703c21445a98a60a38cbb8b8bdd249273cf7e,986295,2020-09-27 02:34:56 UTC,4876407669,4876405577,false,2092,986284
41a5bb85f9e0e0b164a28d1486b76623c4666913ac1844302be7f00af161f467,986295,2020-09-27 02:34:56 UTC,4960208141,4960206049,false,2092,986284
92a9f0501a545b6c48c0a6ace46310d10a378f65f8271e065ff6525b22408a43,986295,2020-09-27 02:34:56 UTC,4834994072,4834990528,false,3544,986284
1557bd178aa69718c3fb3ca0d6685550ab6bde0fe288fd99d2c63f74cae0c847,986295,2020-09-27 02:34:56 UTC,5677214820,5677211866,false,2954,986249
cd12fd49983f65cfe58dd7b2598123f8e892db464c4084dc1a89348e16234d8e,986295,2020-09-27 02:34:56 UTC,5492247592,5492245500,false,2092,986283
24bf13ab9444f18779774984a8060852ad76df54ed3fbb51a964fc7533f3112c,986295,2020-09-27 02:34:56 UTC,5059799869,5059797777,false,2092,986284
57fcaebec26b0fca1a2c8797c984e3126a59f176738772a65cc5ac42d6d2b922,986295,2020-09-27 02:34:56 UTC,4956372613,4956370521,false,2092,986284
f17bd76c5932f06c94de2428e0fe5777150556e3a3a0beafb0e02559baf91eb4,986295,2020-09-27 02:34:56 UTC,5100923653,5100921561,false,2092,986284
062cd35ea0caecf0e8f92b062603e9281666fab46020f53c6eb4d30aafdb251c,986295,2020-09-27 02:34:56 UTC,5550389431,5550387339,false,2092,986283
acd06c3e66fe081adfcbe796ac8d0936b147360351a569f23cec85a46beec3e0,986295,2020-09-27 02:34:56 UTC,5484484622,5484482530,false,2092,986283
2ca4318b28571de45758a8ecdcdf6d2260c9bc30d2633228f6110349b9340a3b,986295,2020-09-27 02:34:56 UTC,9081996159,9081994076,false,2083,986284
33c218de9c1add6485abfd876f17749ebb7a0cc6ddb9cd40286691fe4b5d3695,986295,2020-09-27 02:34:56 UTC,5454178623,5454176531,false,2092,986284
e9b7ef7cfa1f705871bc4338b82601687175f9f3b62e2ce6f5ddcd428040a28e,986295,2020-09-27 02:34:56 UTC,5116542189,5116540106,false,2083,986233
05830cdccdff4cfdc318402ad7e7dff2cf3189072d01c30f8f35e6e6cf491519,986295,2020-09-27 02:34:56 UTC,5450335847,5450333755,false,2092,986196
783b7b87c4488d2c527aaea2c7fbaad58f1c3a27e32209518b236c10bf931b49,986295,2020-09-27 02:34:56 UTC,5659030527,5659027863,false,2664,986283
ad863925de52e5c5a4d3e07d83f764a6a627162c3f11174c2d192307baaa68c3,986295,2020-09-27 02:34:56 UTC,5301610132,5301608040,false,2092,986284
153d9c3adf47800595bfafb95d64e370b19fb1b39620356db2314f8e20b3ae43,986295,2020-09-27 02:34:56 UTC,5435122434,5435120342,false,2092,986284
7a854b67ebaf66626b52e4dfb2cdbafaa421b246cc182f0482801bc9982ce0fd,986295,2020-09-27 02:34:56 UTC,4868780736,4868778653,false,2083,986284
637a155a574f867db1873a82d9d609c3953fa5492454e0601686e9f59b2277f0,986295,2020-09-27 02:34:56 UTC,5063574721,5063572629,false,2092,986284
5aa15f591806f0127293217359d5a2817eeebb2605b8812aff20af651d6aea82,986295,2020-09-27 02:34:56 UTC,4948809383,4948807300,false,2083,986284
27e4c001540c3accf725d6d08ca7b8245a6d23dad2bad240be71dc46381fdf06,986295,2020-09-27 02:34:56 UTC,5002626250,5002624158,false,2092,986284
f6d6f5d19e5ce896e2bcd286b883030cb7c17d478c5966c80d0c002467fde748,986295,2020-09-27 02:34:56 UTC,5014111040,5014108948,false,2092,986284
d3e1c7d027d4d47cc16990a7e6788b5019448b6d4f39ccd79eee53a771fe1104,986295,2020-09-27 02:34:56 UTC,4880214888,4880212796,false,2092,986238
c5e7dea98ca93380f47e393a8a62ce69510511f7664feec4a78c9cf3719b831d,986295,2020-09-27 02:34:56 UTC,10000,,false,10000,0
32fcb125679f352fc8814246f14077d003c70d2950d6d861772bb0b0a534eae8,986295,2020-09-27 02:34:56 UTC,4900382789,4900380697,false,2092,986284
a47b5791110e7454c43d84b6f6e96afe2e0b7fbca48f989384c39386cca8bbfb,986295,2020-09-27 02:34:56 UTC,4846415391,4846413308,false,2083,986284
4eb991f3c248386603d8da51f2f1fa7d40a2c7370c1dc60b9db0a197b7995615,986295,2020-09-27 02:34:56 UTC,5461899509,5461897417,false,2092,986284
e732dd59479db414b2b668c56e870a547e6050b90a0f6fe3d4847b1c76696099,986295,2020-09-27 02:34:56 UTC,5458050335,5458048243,false,2092,986284
ecbe12522f88bd65d46b7699e4c5d42c10de14f8f01783644cd867714850bfa6,986295,2020-09-27 02:34:56 UTC,5442683844,5442681752,false,2092,986284
0a34f0a306abf49e84c8b93f53248620f88e53e23fd6275579f06d011df56765,986295,2020-09-27 02:34:56 UTC,4963965021,4963962929,false,2092,986284
a629c7bacd63737a9d8949b36ba50d3f2ba017ba7dcd9d2fab1d12c0013c1ddd,986295,2020-09-27 02:34:56 UTC,5040694845,5040692762,false,2083,986284
97c17715ae001568c2cf5e56703e19b9b059f34aaaa62320a6c98195f04231fb,986295,2020-09-27 02:34:56 UTC,5446434815,5446432732,false,2083,986284
18ef6aa527bfdf657279ea7b2c3de37e34d616b83b2e28b8dc519680511c8d1b,986295,2020-09-27 02:34:56 UTC,500000000,499990000,false,10000,0
89e3657c59e6b5c990cbfbe6694d971c195d20ac8587c05e6c54da2a5e710160,986295,2020-09-27 02:34:56 UTC,5010310728,5010308636,false,2092,986284
f0c10f5a54303e84d1f96c445cda85b6707b29414f08606781d71bbace942e78,986295,2020-09-27 02:34:56 UTC,9164378976,9164376884,false,2092,986263
d63aacf979f8f2e3298360aa6db100d6e75323a8f47d11d165d00ab47740373c,986295,2020-09-27 02:34:56 UTC,4952630421,4952628329,false,2092,986284
01d5fd4f22d30296758cbf233eaa7e2fd3865ad4c888b84a9d1c664eb5f247f0,986295,2020-09-27 02:34:56 UTC,5305544522,5305542430,false,2092,986284
539cf5be0360db96e03cbfca207cf550a51e1c34776d1f3fca59458f1715dae6,986295,2020-09-27 02:34:56 UTC,5503586570,5503584487,false,2083,986283
55a9712af00a8dea1fb88d2908c960345471d1cb9e5201b2bebef7f708e25685,986295,2020-09-27 02:34:56 UTC,2824234040,2824222040,false,12000,0
5bf8a2c62015d8cc705e2c10fe7b85f1995bfd2a4a0012f06b80098fe9fad6a5,986295,2020-09-27 02:34:56 UTC,4941305137,4941303054,false,2083,986284
7e01871e618cbfd73a146354c51a608af1c7f9393444fb6e9693ff72be3d571e,986295,2020-09-27 02:34:56 UTC,20000000000,19999905480,false,94520,0
ab61fdbdc2f50b9e6ea2c49cd41e90ea9f0a10410ee5aeffa4dd32634acb6237,986294,2020-09-27 02:32:13 UTC,5823223598,5823221506,false,2092,986283
927fc8df1caefbfcc0e617b2f5aa3c476341476f5b0baaefabc927fb69124755,986294,2020-09-27 02:32:13 UTC,5826960146,5826958054,false,2092,986283
4b1318a0569bbd6a400f78ebc0cf81fa03ba1dd5ace2d34baea81fa4c79231ed,986294,2020-09-27 02:32:13 UTC,9184032433,9184030341,false,2092,986283
9c01752d211051f68cee1d53d225bd01c09ad44edec1f65c3c353d98bf568e0d,986294,2020-09-27 02:32:13 UTC,5714438690,5714436598,false,2092,986283
4118bda762727983bee82636ce09abf791784d2d4e6d9dda3e7df7339cbfb895,986294,2020-09-27 02:32:13 UTC,6536945047,6536942955,false,2092,986283
743ea2133a2a943e4a0dd58e4cbc5b6104efd0e2e8b545b18f85ed70abe5392f,986294,2020-09-27 02:32:13 UTC,6662382680,6662380597,false,2083,986283
0d01a403853b38af5d384e4ce226bcd55e0d14caeb79d792f63559d6c7e8c89d,986294,2020-09-27 02:32:13 UTC,59153553243,59153551151,false,2092,986200
04e766dca2531e1b3304c5aeed6f685d35c5fd9b1dfabf3cec37fdbf30981fbd,986294,2020-09-27 02:32:13 UTC,1931887558,1931885108,false,2450,0
c9e9b387cce081e4f5c8d3c57b3cc2c82a692d6ddb6833963280269ed4ed6c3a,986294,2020-09-27 02:32:13 UTC,6721795127,6721793044,false,2083,986283
5635273acc8525397176d86c92d0378fd020dfebb8f366cd9c52c83eba0c0bde,986294,2020-09-27 02:32:13 UTC,5906778331,5906776248,false,2083,986283
46f6ad030fc8a13c4f0c56a6371c51375bd9629812b957013385a282ebd5105f,986294,2020-09-27 02:32:13 UTC,6574981238,6574979146,false,2092,986283
c164dd66ce1e15dc50567856fd34da667dbab66131b401a4d08b8dcbc0af896f,986294,2020-09-27 02:32:13 UTC,5868010970,5868008878,false,2092,986283
17a90476218f6d0c58994884ae96d2d3c9e9a45cdf6e2b4c9c41e3fb2b3850c4,986294,2020-09-27 02:32:13 UTC,6624731877,6624729785,false,2092,986283
51b1dfd9549625458f21f6706f0e2d390dbdcfb9e4d6125f32179276ee5ddd1b,986294,2020-09-27 02:32:13 UTC,5819353836,5819351753,false,2083,986283
13ca6c7011a488af28e79da8effe65264d31515e0d818af61f05378c7c9dcf32,986294,2020-09-27 02:32:13 UTC,5781507891,5781505799,false,2092,986283
5f9291331842dd2765b9269bbf484a27867aad2fb4c80291e2f18d5b486dfbc3,986294,2020-09-27 02:32:13 UTC,5740039136,5740037044,false,2092,986283
fb84ac7ace6914a1b37bf3d30c529ffc0a91004b5a438b5e91278c78d49e50dc,986294,2020-09-27 02:32:13 UTC,5785160620,5785158528,false,2092,986188
7bb9b97015ebef3994d4aa5e7c4105966d464fa02ecc376590a0d6e99e28f730,986294,2020-09-27 02:32:13 UTC,144978977,144910657,false,68320,0
b19c1be563f6d627c50bf1952c586ef4f4b480bdc0a1dcce0dd72912bf517f18,986294,2020-09-27 02:32:13 UTC,6582646787,6582644695,false,2092,986283
54d0d1fc8e45d1c7f404cfab582080143b2abc133631b937ec35227083551d3d,986294,2020-09-27 02:32:13 UTC,500000000,499990000,false,10000,0
a879e660a024452f1329d495f6c66bfcc59568fdbab9c0bff85714b88c2987dd,986294,2020-09-27 02:32:13 UTC,5792852268,5792850176,false,2092,986283
864e0cdf6d5453e949d93ed6c22072c6a5b795beea9aef558268501a0d9cc1c7,986294,2020-09-27 02:32:13 UTC,6681490423,6681488340,false,2083,986283
0a130bca4974b97f09fae832ce693935705cfde345a0455631bbdfb6a8a4873b,986294,2020-09-27 02:32:13 UTC,6685270616,6685268524,false,2092,986283
6d0116361071e93fd5962f0b3784173f58247b75f3c0e608d028d00ff84ee745,986294,2020-09-27 02:32:13 UTC,6101852803,6101850720,false,2083,986283
88a218a92d157778580f0701c3b4de40ec984bca668152db9468a3799fb20b1b,986294,2020-09-27 02:32:13 UTC,6602017939,6602015856,false,2083,986283
962d41d3cfeb95f7ac81a7d00c798d48b6a401884d4e07b6ebacb57df282b291,986294,2020-09-27 02:32:13 UTC,5830827284,5830825192,false,2092,986283
1bba7fea307072808d5b3111bce0c058cccc8265d45b4b325f82047097be6fc4,986294,2020-09-27 02:32:13 UTC,5910657331,5910655239,false,2092,986283
bae55744607089ff485b45e38ae8ea827ada7b3ef85bed3bbafadd9d40cfdd8d,986294,2020-09-27 02:32:13 UTC,6673892864,6673890781,false,2083,986244
40fbff6b46f497f09b8a892114e57765dc996a3ed2d32a6accd3f77560f9aad5,986294,2020-09-27 02:32:13 UTC,5722091992,5722089900,false,2092,986283
eba5837441c92751d5e77aebd43fbb2772705afa9be5400a0b4a54848788af2d,986294,2020-09-27 02:32:13 UTC,6533021100,6533019008,false,2092,986283
63fdf4567860547ccb56d9f4d67ec9bf54fc5ce5bf86736c973ec2768c847a2d,986294,2020-09-27 02:32:13 UTC,5796622404,5796620312,false,2092,986283
f78bb6a5b07afd0aa3c8bfdf69dff255a7b8a283658cbbc4343253fa55befa72,986294,2020-09-27 02:32:13 UTC,6617114475,6617112383,false,2092,986283
2ff10a225ef9c4bf35804680115bfdeb249785e1478e2f38d39a146e5d4782a4,986294,2020-09-27 02:32:13 UTC,6666138863,6666136771,false,2092,986283
243a90ba44f1a939642aca921bb1c7d9ff5afe8c26af75872a07cba2e53980d0,986294,2020-09-27 02:32:13 UTC,5718290275,5718288192,false,2083,986213
8c6ed0217fa82600a0b0fdf48460822f7584e909cf8b015f5003d98259110abd,986294,2020-09-27 02:32:13 UTC,6139717702,6139715610,false,2092,986283
9e5b55a2716f5dcfdcd113cf825da2b53a4858548fe44013da08f97b029e9edc,986294,2020-09-27 02:32:13 UTC,6677665994,6677663911,false,2083,986283
8193b3411e2016b8e1f2cf6e8d16ee9c828d34cf99208eafbaa21eeb2fdcecb8,986294,2020-09-27 02:32:13 UTC,6670001107,6669999024,false,2083,986283
c60b01392e1426a781efd269f5a36824a24aaf8e9e5aa7e9dccd9ead7b242f95,986294,2020-09-27 02:32:13 UTC,6729438063,6729435971,false,2092,986283
cc4ed1df63c9d678f741ae95a490c8e7b35398fb2be08687a9ef70374494cec9,986294,2020-09-27 02:32:13 UTC,296596389,296548506,false,47883,986283
78f947499620d85bc79a9cd2be1cb8b398a1bbec6f67892c143456e1a3738fc5,986294,2020-09-27 02:32:13 UTC,195486860,195468235,false,18625,986283
714a9ae1836f4804a2701d969e65aef7087f4d5e014c63e6a20a1b151fc3b232,986294,2020-09-27 02:32:13 UTC,688907380,688888821,false,18559,0
4edc496b1f8655a23d1e5455ec30fc995785707d185214acab18a60ef089e963,986294,2020-09-27 02:32:13 UTC,5800407090,5800404998,false,2092,986283
fce7e40927090e72621301ada3b20d7f1487702d44013668f040d9b6f100e5c3,986294,2020-09-27 02:32:13 UTC,6620912795,6620910703,false,2092,986283
6eb73e27ce58df931319bd1f66cfce949f5b89cd8a1216229b3c70f4d42760db,986294,2020-09-27 02:32:13 UTC,5743795520,5743793437,false,2083,986283
009242c58be3736d60f21e2c752b8c038c00ddcbafa3fdbce36a3bbf695c319d,986294,2020-09-27 02:32:13 UTC,5788961763,5788959671,false,2092,986188
0e9aa7f1aa1ebf1f8ce015eab245f30e953d06d0030619373a701841484d5795,986294,2020-09-27 02:32:13 UTC,6613349930,6613347838,false,2092,986259
8aaaa6adad908dd16377bb6bc246d231c21a7c3e59431c98d63e6304f61c053b,986294,2020-09-27 02:32:13 UTC,6578756903,6578754811,false,2092,986283
1c2edd371d6d196bd5d45505fb7256c76e8ea66a5a4c0e538f720d1519cbfb10,986294,2020-09-27 02:32:13 UTC,10000,,false,10000,0
29baec854ee3cb3404784011737bc77b6cf619a5718c25e4ac3713aa2315c23f,986294,2020-09-27 02:32:13 UTC,6495535053,6495525139,false,9914,986283
8fb6e2e7ddfe89f2e1e1018627f20b738c5f4374fdeb7f996412c2cf27257e6c,986294,2020-09-27 02:32:13 UTC,6725588500,6725586408,false,2092,986283
495af83d6d45362cb88d12fa15b078f34cbb70bca31a3d74fc7b2a16a9ca976f,986294,2020-09-27 02:32:13 UTC,6605827897,6605825805,false,2092,986275
4e97283ba56af1f3e7f35e90c8b8f9b05f6f13f5c82b11ff523676d232de9769,986294,2020-09-27 02:32:13 UTC,6609759581,6609757489,false,2092,986283
f1ca3582b0657bfec027df0f39f5db39c80819d21512daa53bade883df8f9cb0,986294,2020-09-27 02:32:13 UTC,9123250304,9123248212,false,2092,986283
f0344dd36bfeba54fdf3dc6c3d704c244e969b76d9de81990ef7e4e0c6d2428e,986293,2020-09-27 02:28:56 UTC,500005424,499995424,false,10000,0
c8b385f50fd399ea34c8a2f11d56260fe8b2be45f860508b707fc52fd94c9c0c,986293,2020-09-27 02:28:56 UTC,500010000,500000000,false,10000,0
657dd90cf396daec7014c3cd15b2c2d85f427892997b6dd417050409a746179c,986293,2020-09-27 02:28:56 UTC,10000,,false,10000,0
faf77068f47676af49da5ec61af9e1c2bb876d6496fcd3c98c19f260cad6772d,986293,2020-09-27 02:28:56 UTC,59157335854,59157333762,false,2092,986281
ce313e448c51eae8ca13c581b0946b99aa206d2fdd530fbb420a411d0445ac21,986293,2020-09-27 02:28:56 UTC,9162766123,9162764040,false,2083,986261
28b361e2bdb512392571483771d4a08c7bac589b367c7334c5bd3d12a45637c9,986293,2020-09-27 02:28:56 UTC,6733220285,6733218193,false,2092,986280
e424401f1c8a6f5f61bf9493f1ca92cf2551a233adc632c9e3902cb98f3d43f0,986292,2020-09-27 02:28:11 UTC,6802092331,6802090239,false,2092,986280
bf346dfffd508053c431b476e98fded65dbe009f985c8d536149bb49f1734648,986292,2020-09-27 02:28:11 UTC,6756812194,6756810111,false,2083,986280
b18f1c91415e1b2ed4a3d501acce2f25af0189a88452c9557618d3d96732eb46,986292,2020-09-27 02:28:11 UTC,6760592078,6760589986,false,2092,986280
6b19eb95ebea7136a0cb42b3e5f68445f8bd7b189f892da47d1ba4543fbaadd6,986292,2020-09-27 02:28:11 UTC,6737079595,6737077512,false,2083,986280
ca94479d70a25e2702809016324165574ba888005d5f68bf5053891ac5a4fa23,986292,2020-09-27 02:28:11 UTC,6821973390,6821971298,false,2092,986280
9ca3f425549d3890d20f90d39833a148d933f88d2a0d4a889907fe08723215e7,986292,2020-09-27 02:28:11 UTC,6764413621,6764411529,false,2092,986280
911bf54f7c39ab5ffc152e8f407d075e504776bfa8c86cdc3ebb0edb596052b8,986292,2020-09-27 02:28:11 UTC,56897662,56894702,false,2960,0
4255e6c47cf141cd224284b96282b6f87d51deab0449b547cc5aef4246a95271,986291,2020-09-27 02:28:00 UTC,6968775110,6968773018,false,2092,986280
3f26d45f8bee245cf2364c5d1f8f4460c5d74454cb9edd5d386bd327ebcbf1cc,986291,2020-09-27 02:28:00 UTC,6881130171,6881128079,false,2092,986280
ea82b53af9629ffd05522b9e0ed190536705df7c2ae12ed0a596c7c1538617e1,986291,2020-09-27 02:28:00 UTC,6855386502,6855384410,false,2092,986280
b57839b44d0bedeaad1ba36d58732d74bcec5dd2f876a5b1b6dd356986b4f872,986291,2020-09-27 02:28:00 UTC,6851470452,6851468360,false,2092,986280
995e431b1baca4ec804fb7a7ce79acb763772527bf155c78eee3825cd29ab34b,986291,2020-09-27 02:28:00 UTC,6877363543,6877361451,false,2092,986238
da92e7b8c2d49ba1b72cba93ad36dc07e8c906ca7d77a59216425caa65e83961,986291,2020-09-27 02:28:00 UTC,6972554712,6972552620,false,2092,986280
f93b5839730ea2ca66a480a5d184bfc4d69d09e1f3deae2a6f3d4da31ca0c87d,986291,2020-09-27 02:28:00 UTC,9201754999,9201752907,false,2092,986280
bca4798710a03f6584452ec97c6d642fba0092c9ed0cd5272a59c4fc33dac916,986291,2020-09-27 02:28:00 UTC,6847700949,6847698866,false,2083,986280
1a80bfac2bc5de1303493da93b2c39108acf2cfda51a18a3dd0862ddc464becd,986291,2020-09-27 02:28:00 UTC,6898752762,6898750670,false,2092,986280
844dce498f397398d533a364cbfdd1cfa7a83089e98cdff59051fb01284244db,986291,2020-09-27 02:28:00 UTC,6976323205,6976321113,false,2092,986280
0e22a72a454c50fd1e028fc549e5d5a18c2bdcea85a83e342c99a63ce2b1c8f6,986291,2020-09-27 02:28:00 UTC,6980126654,6980124562,false,2092,986280
de5fce4eb0050d93f497be7b0469e820327590bfdd54dc8f770c916ecab79dce,986291,2020-09-27 02:28:00 UTC,7018929901,7018927809,false,2092,986280
3a3ed501d8d03d0edae63c600765e677569b5f73acdeb6c5d2426ce35943f682,986291,2020-09-27 02:28:00 UTC,7022752810,7022750727,false,2083,986280
5d3c700ed2b6d6ef9c7e8dc8cb3039293f30b5c2e9f934b9538fb089f8176efc,986291,2020-09-27 02:28:00 UTC,10097933348,10097816402,false,116946,986280
ab372120d7c1e01707f848febf577203c63d89540762cbe73365be41b1bfe0f4,986291,2020-09-27 02:28:00 UTC,6825753444,6825751352,false,2092,986268
bf6dc7fbc4a8ee62a66b973b8d276ab73f8ee7438a4985becd5a772f6408dc98,986291,2020-09-27 02:28:00 UTC,6926712799,6926710707,false,2092,986280
082d7b08ce10a01bd6d13b730c6030de4ceac5c418b35a37baf0caa6cbb49b15,986291,2020-09-27 02:28:00 UTC,6873502024,6873499932,false,2092,986280
c614aca00a7efe8bc8dda2106be4687897ef67f57a85ae9e1ef6e435da339e93,986291,2020-09-27 02:28:00 UTC,1819769,1817339,false,2430,0
e934cfc9e30e5afe561adf2df5ec727305964af72a4b30fb5d40de925a7769b8,986291,2020-09-27 02:28:00 UTC,6906239584,6906237492,false,2092,986280
6bb82e784aa4f6d43113c900448ae8587030cc34784ee35eae79c020bad899be,986291,2020-09-27 02:28:00 UTC,59194168928,59194166836,false,2092,986280
0c854ec17b364f4b250d813d707d16fa6870ab4f7c79797940c58ac459d3e55a,986291,2020-09-27 02:28:00 UTC,6902504989,6902502897,false,2092,986206
e832ec843cbbd47d350e585f0929c0ca7a3940671b71e38fc7e3dd709eda0d03,986291,2020-09-27 02:28:00 UTC,146020985597,146020839427,false,146170,986280
9a2623b4b932f9c9d5d7c37f2e9fabbea37c5729fe2d39d3d76a07671424a11b,986291,2020-09-27 02:28:00 UTC,6843854735,6843852643,false,2092,986280
3e20f42b64ed09d03fb0bfeace0f467e8bcb766ba274c91ca01a09e234b97d7f,986291,2020-09-27 02:28:00 UTC,6964914811,6964912719,false,2092,986213
1a62d6ee89feb85eb9dc055da6b5a3b5857abf44b9a883777d1d63238c6372c7,986291,2020-09-27 02:28:00 UTC,13630500057,13630496539,false,3518,986280
947db224989bb5443229748063fcaa0747336e64f2c3d631ea33f2a287a850e5,986290,2020-09-27 02:26:25 UTC,107817173508,107817165138,false,8370,0
5d012121056b3403f6f8abde5b7d8b73d3c974e4d08cfbbc1bd2edd169800a3d,986290,2020-09-27 02:26:25 UTC,10000,,false,10000,0
e36fd8a8a976902a737ed6f25ff438904ecd40004df85bece4370278f672542d,986290,2020-09-27 02:26:25 UTC,10000,,false,10000,0
a8434a576bf8e704059ff03ece62e1387cccbb50372794ffbf56ad09052d315b,986290,2020-09-27 02:26:25 UTC,262560159,262557199,false,2960,0
b42ccd545a4e9299c8a145f9b614e6ce3a9e2db2acd3d352f87452bb2b206598,986290,2020-09-27 02:26:25 UTC,37490295,37488212,false,2083,986279
ebcaf9c274c1ac9e7bd42a3e9c2245eef490529b7c2a1c0835545ad47f098ae5,986290,2020-09-27 02:26:25 UTC,13203790,13200000,false,3790,0
b561158e9dfc6d9c98bdee79d6d23b3914e4c260c7a1004ce7872c76f1b6dbd6,986290,2020-09-27 02:26:25 UTC,688851016,688847276,false,3740,0
0e69ad11fdc47e03a0a66e4dfcbc640cd59d6c55321c8137c078356797190b57,986290,2020-09-27 02:26:25 UTC,10000,,false,10000,0
567f33c29726b4209ab9b2f07f59e1f44c086bb9fe6a670273f2cd8e549a345d,986289,2020-09-27 02:20:28 UTC,10000,,false,10000,0
61b228de3ced98379f024585da5ca9d24bdde493c2b1efe0798537d0d49cd68c,986289,2020-09-27 02:20:28 UTC,297447730,297402204,false,45526,986188
ac48f296c876041c4d8e4fbcb70bd124f12f954602061d91c07ef8024ae641b3,986289,2020-09-27 02:20:28 UTC,195859577,195845290,false,14287,986269
59cb4f2d9ae14015b063395e9e903b35c6eacf2164b011b8307014d65ebbe9d2,986289,2020-09-27 02:20:28 UTC,50531917279,50531915187,false,2092,986278
a32c4a04c8952870e36c15775b8dbfac62fdc47ca36ee6f77075bff67b2cddf2,986288,2020-09-27 02:19:27 UTC,6935730,6933347,false,2383,986277
b8be0c251e45ace2159edda13dbe4552a6bacac06fcd9933bfa0480984221a89,986288,2020-09-27 02:19:27 UTC,10000,,false,10000,0
0956b193dcae397e53dc9479e700d375eaaa8ab6ed2bfdf813e54915f27ded63,986287,2020-09-27 02:17:31 UTC,57070325,57067365,false,2960,0
4cc7b388605a608d710bf1936f3e24b1a1f9ae7f7823276b7e3837205c6cb59c,986286,2020-09-27 02:16:58 UTC,10000,,false,10000,0
c23f31c3737d974ab3c1b9a99df6b8eb4f7d53f20f7f1c6e5a092cd456ea6b4c,986285,2020-09-27 02:16:50 UTC,2925306,2916766,false,8540,0
852005d8dad0118502d3775bd0c2a9976615eebe8a6f5acd53a3cefa8f973ebc,986284,2020-09-27 02:16:15 UTC,3225866,3217326,false,8540,0
567a6de0772fcc53403e5320d9df8667c85b7b744a72ff5381d315f1f5032e33,986284,2020-09-27 02:16:15 UTC,10000,,false,10000,0
d91986ec0430a823547d3d7e33188a74f6de63c32079b43c89c7d6c9f352159f,986283,2020-09-27 02:14:09 UTC,100999997,100990000,false,9997,0
391246c9fc6f937b3488874a5b5cde761f260c94f3cf707f5bc820b21cb201a9,986281,2020-09-27 02:13:04 UTC,262731938,262728978,false,2960,0
07b360f1a09264a4ee7a19c9948791fc661df06c584287fd94ab023170e4df67,986280,2020-09-27 02:12:41 UTC,298374637,298331639,false,42998,986269
0826aad2dd8063bff4a92d7c4f263ab92a8ceab6229c041c239bd664313a2ddd,986280,2020-09-27 02:12:41 UTC,10000,,false,10000,0
ca1791aaa9448ad5518c247d1246eacd7b993603bf431444a2076fd84fa90234,986280,2020-09-27 02:12:41 UTC,196338838,196321067,false,17771,986269
c9729d6f3168feeb43d4e4d204eae0c06d30350c6b66f42aeaed2fd3b791592f,986280,2020-09-27 02:12:41 UTC,58017700,58007700,false,10000,0
611028c1a93d26aac886e116d1313c39ea8e57c5b1543cd90387705549fcd73f,986280,2020-09-27 02:12:41 UTC,3003914958,3003913958,false,1000,0
371d2cb1b0701196e7a448192f0b1778af92739c14363456ae84374af3fcf71c,986280,2020-09-27 02:12:41 UTC,1364088220,1364019900,false,68320,0
c26450f66268e2ed7bb0e2e46d1e5a53512f5cba2599535aa09e918017c88b72,986280,2020-09-27 02:12:41 UTC,104402561,104382603,false,19958,0
0b8e47cc42f7188bb895ea1b7b547b6deed4505a2a62f513403343fd92003249,986280,2020-09-27 02:12:41 UTC,4929100,4926650,false,2450,0
3ededaff3edaa9e24a19a35815c89c0ff170a322fab2476dcfc6586a739bceb7,986279,2020-09-27 02:09:34 UTC,57288298,57285031,false,3267,0
d969a3358331c5aeeb3f7cb34e3995d9bffa5ba9516c18638b9a61221514f20f,986279,2020-09-27 02:09:34 UTC,10000,,false,10000,0
0792ba9f8ae6a7663ced2e797ac440bfd42238c16d392b324f5503cd77869fff,986279,2020-09-27 02:09:34 UTC,10000,,false,10000,0
7ff8d5e7361b8273c658072bd06c27a0d055ede4f8080752172f3407ec28842d,986279,2020-09-27 02:09:34 UTC,14667958,14666028,false,1930,0
67121c0f637e81965402a0deb54ba8af72dff71ff9f841cb54de28a39f6db6d4,986279,2020-09-27 02:09:34 UTC,2500391038,2500000000,false,391038,986259
7190c26a814c06f59d0137521146c88f21a3662df166cbbd371d0afa0e791a38,986279,2020-09-27 02:09:34 UTC,1100225718,1100215718,false,10000,0
8ac615c00426e332eb2903bfe2a96cc04224131365124df8caf2a34761ea2c7b,986277,2020-09-27 02:06:28 UTC,262885860,262882900,false,2960,0
6d562a20220ea5a83dfc16f4ce4fe137c5bf396804b373aa85de78af8789c133,986277,2020-09-27 02:06:28 UTC,10000,,false,10000,0
b0222c1d349388c2c5f9e33c3a8b3e29e9b8696f33378cf8fe62be02641f3aae,986277,2020-09-27 02:06:28 UTC,1000095249,1000085249,false,10000,0
ea1773ecce50d6f8ed87c82161a33a5f320336b9f1f5a46b1cbd38e25191cb86,986276,2020-09-27 02:05:37 UTC,1999998544,1999988544,false,10000,0
54594b6fe32b55996fcde2a01df62dbd35afb5844ea0a1959553efe90d0f64cd,986276,2020-09-27 02:05:37 UTC,1000051660,1000041660,false,10000,0
eafcd377a7a7898087cf6c8f59c4ca82dc2774a8d6ecaede4a8bb63d9aa3c5e7,986276,2020-09-27 02:05:37 UTC,10000,,false,10000,0
4ee6b91e79d66cb3670c7b5240b7fe1885a79cd97a870f1e218b8289f7958971,986275,2020-09-27 02:04:37 UTC,140777657175,140777654825,false,2350,0
67bdec5a8e97dd85fdc2b365f1c817cfa9e236e54398a7c618c4806ca16cf434,986275,2020-09-27 02:04:37 UTC,240699052280,240699042280,false,10000,0
983067ff7ef73e146e5ae1d4bc90e910fb60a63e28fd22c399ea0a6b9869c84b,986275,2020-09-27 02:04:37 UTC,286084995,286078295,false,6700,0
d05e5129f69db2bfa2a22f73d4958b51c328ad541e514a48d26a95c6e1b745db,986275,2020-09-27 02:04:37 UTC,681047,671679,false,9368,986263
82f79eb99d562c90ff62f7550b45d9a714bf018253d7a720a412ae1e7f5b4054,986275,2020-09-27 02:04:37 UTC,10000,,false,10000,0
2d62eec697e58488de6d6f5c6af994d2f90b8eda7429faebec89caa4130e3710,986275,2020-09-27 02:04:37 UTC,8023893,8019513,false,4380,0
1ac3ba8c699660e0a066bb258ec606e9789c07fb61ee4f83aedb2a86fe1dfb51,986275,2020-09-27 02:04:37 UTC,71104200,71102108,false,2092,986264
3c8156ece6b765ca7c812974169ed25bf5a976d4e3036b5e16318389730f8f64,986275,2020-09-27 02:04:37 UTC,500029686,500019686,false,10000,0
8c1362ff46db72b92bbb2641a93dbbee392f3a65b1dacac6979793cce5fc3e81,986273,2020-09-27 02:02:10 UTC,57500018,57496751,false,3267,0
b51fecafb8817a4544b3684c63367d906d3d17ae321314373966316d877208e9,986273,2020-09-27 02:02:10 UTC,146519251479,146519241479,false,10000,0
599fb83bb2cc57da24555674b4861ba59aeded6293a1fef0588da8afe4ab6889,986273,2020-09-27 02:02:10 UTC,466406635,466403382,false,3253,986261
afb1fa2a63d426cfc5acabf6a85aaa673194a1e57c4743f83408bd03cebdc9f9,986273,2020-09-27 02:02:10 UTC,10000,,false,10000,0
82f0d769e5520dc685d7bdf8b969b0372f433c8c048e5fa390ae1c83b01a7713,986272,2020-09-27 02:01:12 UTC,282166391,282161171,false,5220,0
086f2eef2373261d2308cecf1ae9a3a8aa65fdcaf3ad7f651caa6b0e91851a29,986272,2020-09-27 02:01:12 UTC,18539924085,18539914085,false,10000,0
9cbfe2fa93fa814414a7c73d2d71bcc9a25d0fc5132b9b76979c31a53836c2b8,986270,2020-09-27 02:00:27 UTC,146519261479,146519251479,false,10000,0
bd5fac40c1b6c4070b5fe765dac05aa99301f89ba071d67b4c77d9e2d386015d,986270,2020-09-27 02:00:27 UTC,196668366,196654088,false,14278,986259
4d4664025cb757fa6d2f096499968c9ee3c024d46f764e29e2ea1b1240d2b1df,986270,2020-09-27 02:00:27 UTC,19607088,19605158,false,1930,0
89646fab2ea14e3f3775c2f538a308e39e7cff58bb092be8c181b9feef1996c3,986270,2020-09-27 02:00:27 UTC,263084357,263081397,false,2960,0
3f7fd89d7b800359f453faacf7307280d1ff063a16c3c19c09719ffe78b8954b,986270,2020-09-27 02:00:27 UTC,299343171,299301966,false,41205,986259
407fe7df0fbcf595159332d1f81078c6ab7bdd010b96b322ab7a8c769581486e,986270,2020-09-27 02:00:27 UTC,695813593,695810348,false,3245,986259
06166120176810535559d93cde70a8cc496ab9ece1d4cf6c1caa43f6507e977b,986269,2020-09-27 01:59:47 UTC,10000,,false,10000,0
5380accaca2117cf4da5ea701e4dd4321c16cc55d8f2e809fc2b3fefa3be4c19,986269,2020-09-27 01:59:47 UTC,2011729353,2011654373,false,74980,0
69167b136582020c140489536b43dc5f1e5aa1aadb69be0e5796e5caed8e508a,986269,2020-09-27 01:59:47 UTC,18552610632,18552600632,false,10000,0
052776a5dd4790ce38701d6d2a42e250a3861a48ee50df054d0d62f1e27e4932,986268,2020-09-27 01:57:39 UTC,800771688,800769768,false,1920,0
211d9606f97199761cd54792f295256cb44b09ccf59e070724011205b1b7b58f,986267,2020-09-27 01:56:53 UTC,52061190,52055970,false,5220,0
9837e7c973a3e1830a4aaa72192089ad15549f6ef888920b15a992e1158362a8,986267,2020-09-27 01:56:53 UTC,10000,,false,10000,0
2bb809a411165dbc256fa5a02d1028da4f8dfc617c3be84ebbb26e81b6b7beaa,986267,2020-09-27 01:56:53 UTC,57684283,57681016,false,3267,0
3005fb1532ec0381cc5e0f98735b25b10ced93a127733d7315370da010f166e6,986265,2020-09-27 01:54:26 UTC,24670918,24668988,false,1930,0
c5b9b76d0bed4df4004b22e0de8a57c44cea54bd5145b13be41b6ecfc55941b9,986265,2020-09-27 01:54:26 UTC,10000,,false,10000,0
1c823fd4ee403220c9743ab3519d40697ab0d431cf7eadc5e0be1af813565783,986264,2020-09-27 01:53:27 UTC,436401755,436333435,false,68320,0
3773162070676d646d382e3ef3cb9a7d274ff2773271ec2379611b7778d2a3b4,986264,2020-09-27 01:53:27 UTC,1202711,1193078,false,9633,986253
e47ee350f33c9b2ed6e5aa9f74dfd4885c18bafbbfb4d18d4795c2f29e295184,986264,2020-09-27 01:53:27 UTC,10000,,false,10000,0
5a47077efba58318cfe83c6032e101c02a7dfbf2277af582602afae156f46a3d,986263,2020-09-27 01:52:03 UTC,300283931,300239199,false,44732,986252
881a156e63e1876b814921a2dad61d821100fd7ee6a34fdf7e5249d01c9ba736,986263,2020-09-27 01:52:03 UTC,197029574,197014126,false,15448,986252
e4260351960d48a06c222cc8439e16b3c071fa4328348fe54d3d39b588aa26bc,986263,2020-09-27 01:52:03 UTC,1201388,1193002,false,8386,986252
f4abcaca7db0b807b8c9f33862a64cfb0e824e7e714957883ce09789af173df8,986263,2020-09-27 01:52:03 UTC,10000,,false,10000,0
33ad79831178e6f95bff454a670886b3ad7e81e8be2445b20ef56e587ac88c11,986263,2020-09-27 01:52:03 UTC,263324767,263321194,false,3573,0
4bab5f2aa932c0f9b5c249619fb9e542269e9aa556ed5d669416882dfc025c33,986263,2020-09-27 01:52:03 UTC,29740148,29738218,false,1930,0
8880f00277ea8f823ae6cb6687d3a3368ba88b1fa689a3367f2911a7fa0f0a1a,986262,2020-09-27 01:48:51 UTC,10000,,false,10000,0
067c1ff605db2b13c0d9ef0c33a86079c29cb16f2018d747da76aa0372c0969e,986259,2020-09-27 01:47:52 UTC,142179,132179,false,10000,0
1b6ec08cee3a3b14eecd08175f85f4c7659890dc1de78fcf5fc57f2e374cc3b7,986259,2020-09-27 01:47:52 UTC,21165468,21159468,false,6000,0
d076a71518257040b1afd7f61f0f756833046e462fcf6c917847cb4a9652a706,986258,2020-09-27 01:46:29 UTC,227360755,227345095,false,15660,0
1b5131f85ea66f3502e9ed28b84ee49454182318f7c24a74514a1727d4e55c48,986257,2020-09-27 01:45:59 UTC,104813207,104811115,false,2092,986245
11bb53209532935762f45c64d10bad7f5de793e21bac299dab299ee15b22f7f1,986257,2020-09-27 01:45:59 UTC,22053,12053,false,10000,0
895ac42711b9d2d514e685282e197f67f60079f03e996ff354fa3f2a6fccb68f,986257,2020-09-27 01:45:59 UTC,7992,5082,false,2910,0
6ca99c8c307f8d87d9aaf578307f479c2ebeafb368f6258ff751cf6585a168a6,986257,2020-09-27 01:45:59 UTC,10000,,false,10000,0
d9d0ca01450cfa52cf55d126507ed823566ec14b13d25eb9d28a064d80f6e97d,986256,2020-09-27 01:45:12 UTC,10000,,false,10000,0
7ccb7060f832631eb1744d8c34691f4f71be015514333983dfbc7422b2832179,986256,2020-09-27 01:45:12 UTC,58151435,58147250,false,4185,0
39f2ece5c44a3eb41d15d634b2bf3b3136c8709b2cf23e94501275d965f7e5f7,986256,2020-09-27 01:45:12 UTC,34471078,34469148,false,1930,0
647b77529b4060ecda9125f92ba70c7cbc2bb21198426913ef70db7dd3f208e5,986255,2020-09-27 01:41:57 UTC,301379402,301335242,false,44160,986243
986803d8cb69d8af23d4ff89c38d31c95640cedc87f09b5c470d81b8de0bda7c,986255,2020-09-27 01:41:57 UTC,197384274,197370585,false,13689,986243
b5a1fd2650e84b250592fea2849b8561606e5486818027039e1b75fd1d86bdb2,986255,2020-09-27 01:41:57 UTC,23944155462,23944125462,false,30000,0
77cf9254087046d563fea25193096601d97745be70c18eeb1521761c547a2e2c,986255,2020-09-27 01:41:57 UTC,874901712,874891712,false,10000,0
a395f861ed61d49d6b3b0ec1157c91e11833db734e4ebf5ad7b1f82fa4722f0a,986255,2020-09-27 01:41:57 UTC,263539774,263536814,false,2960,0
c2d177806330f1ed642b40f00cb09f392895a6d8058064e67d4f4369790f1f1a,986254,2020-09-27 01:40:02 UTC,39402108,39400178,false,1930,0
f6e1e889ab30e309ea2a272e43029ae5aa1f9ba44ca74a8559925b64c3c4b3f0,986254,2020-09-27 01:40:02 UTC,579143814,579099054,false,44760,986252
b926342d54be4ed8e84fc78091f608671309643c576e078c979887453fc0209d,986254,2020-09-27 01:40:02 UTC,250,,false,250,0
5435787d1b51436b8063d46b6e25989e4df08ae8ca04e041c153cccf56b505d9,986254,2020-09-27 01:40:02 UTC,10000,,false,10000,0
ad9bc0a81ff83921d5f1c8c717b12e92614c1395085b8a3301fae6e24a082070,986253,2020-09-27 01:38:31 UTC,788627688,788559368,false,68320,0
505ffe553b49cbf892507f0b60a5db8ad78e6ecb44ee93ef370099a8a4b05624,986253,2020-09-27 01:38:31 UTC,10000,,false,10000,0
1570f71d9c7367e9be6030369c14bb070094d4343e2a75860df78b045e3ed95e,986253,2020-09-27 01:38:31 UTC,2899900000,2899899007,false,993,986242
75353788976c8ec39e22535b664c70233ad1596e4a161c7c97aaeaa90322af49,986253,2020-09-27 01:38:31 UTC,5942474722,5942155959,false,318763,0
825f1e2d709cfca10a171f5f0bf8d27236d43144a689d6664d7f3efe9d6800cd,986253,2020-09-27 01:38:31 UTC,482222678,482207000,false,15678,986162
1202797f20d78b4953adcd088cc1740e1746e97ddc73c840ba48c75fd9efaf7a,986252,2020-09-27 01:36:26 UTC,6110020397,6110004817,false,15580,0
201798b0b58491f05227801fe59ad0021e6515a93ddf731b6a3cbf275cfa0695,986252,2020-09-27 01:36:26 UTC,10000,,false,10000,0
726ea68453c758cb43998471288d74b837fc1fad3de3a358d62329fcd1e44475,986252,2020-09-27 01:36:26 UTC,144077815279,144077812929,false,2350,0
4fc1d50ba14b94041f6fd1d5ccccdaa0da0c39283934969e175209a6efa95e1e,986252,2020-09-27 01:36:26 UTC,2348494,2348494,false,0,0
71fce5addef78620031a1cd8213377bd93a9d29f48050cf9670eae8e1cd0195d,986250,2020-09-27 01:34:22 UTC,156155348,156153256,false,2092,986239
2de681a06b9d578e03c3b97a313f28405d3de1a5b9fcc503d2e12aa9af4272b4,986250,2020-09-27 01:34:22 UTC,50599219371,50599217279,false,2092,986238
07d8d6423246cbbde1621629eadb1b7322bb63b46017ceb819fd88b18b7c7564,986250,2020-09-27 01:34:22 UTC,1998080,1988080,false,10000,0
9468efc5669ecf3e4b85f19aaf66df4476e3fa3a546b3d9c8a70a991bb810785,986250,2020-09-27 01:34:22 UTC,58310579,58307619,false,2960,0
dec4e32572fede4dc87e5513fe7dd5bd121cc4213d26e529c302a3bf1913fd14,986249,2020-09-27 01:33:21 UTC,10000,,false,10000,0
85e43deee8b9ae0da8d3d96298245be2f35276f57d527d5225ff5fe47183fd89,986249,2020-09-27 01:33:21 UTC,100000000,99998080,false,1920,0
0dddc4a608fedd5633d84f76400883c4d5525e43605f57f3b94b51a0d9de953d,986249,2020-09-27 01:33:21 UTC,263740269,263737309,false,2960,0
17c408ca634feb30a23ddaf9cec955b3acbc175569e8d43354dad4c4596a1366,986249,2020-09-27 01:33:21 UTC,152699792602,152699790252,false,2350,0
a132e95029e6d2c8a6b1cf4d5b6dcdac64dd190486af4ffc50c4b5c981fe7b81,986249,2020-09-27 01:33:21 UTC,3376246,3367706,false,8540,0
3eb1303691d61896f9d548da33f9db0c5864d29ea8d899b56b0af22b6fb9e47f,986248,2020-09-27 01:32:03 UTC,3404968,3396428,false,8540,0
b1ea5d8841e3d79d634ced833a0bb9c54a45d3ffb894c3841d456ad841996826,986246,2020-09-27 01:30:56 UTC,2002490,2002490,false,0,0
8edd7a6a4f1d1eff28dae2a3d211fa779c7ad99c86883aad0f829c68e69e543f,986245,2020-09-27 01:30:48 UTC,523055847,523038531,false,17316,0
f06f4e45932278a013c19d75fe2ffa2c61fbae4c5d0e1854699116c23a30bca4,986245,2020-09-27 01:30:48 UTC,1008960,1006510,false,2450,0
c12d5665c3e4d398c55a8b2b96e718805cf865345b430d7dbb1275223d082dbc,986245,2020-09-27 01:30:48 UTC,874911712,874901712,false,10000,0
e923a0ca764e81366703a659bf075d3cc5b6abe930708320f54178b2af893c60,986245,2020-09-27 01:30:48 UTC,197699655,197685983,false,13672,986234
d22191fcf1321db0e5ec22dd8686b6d4d62b9a7ed4a8859f00561dd1a2dad7df,986245,2020-09-27 01:30:48 UTC,58487662,58484702,false,2960,0
66be4adfd12cf2f7c3bfc67a4b89e2cb0652729d7619c8c275b7d12f792ce918,986245,2020-09-27 01:30:48 UTC,10000,,false,10000,0
d5c5ae33858f66fb50bc4f7d2064afe30d2651d6fb8a5a73fa22fa69304be7e9,986245,2020-09-27 01:30:48 UTC,302283778,302238440,false,45338,986234
0d6022c6dd255eb3c25fd7162e5fef1a03c99f73a204953e5e75a495fee4607e,986244,2020-09-27 01:29:16 UTC,141659060,141658960,false,100,986233
1cfd9e52d41b4a5ee126ed0325cac6f19453c3c672568ad9522d8aa78c995ef1,986244,2020-09-27 01:29:16 UTC,18552620632,18552610632,false,10000,0
518d7ba1837ce78e07ccf726416c1c942c193b2a8b29e183ff2218d2750a0a64,986243,2020-09-27 01:28:23 UTC,3484911,3476371,false,8540,0
b73e4e383028fbe642bc71062ae5491be5c59c7f79161ded189acf5cd1c72967,986243,2020-09-27 01:28:23 UTC,10000,,false,10000,0
58b4a16a0c4354bdb1055075c538d116f6a8c6828c7a975298a8455f7e788502,986242,2020-09-27 01:28:13 UTC,55393909,55383909,false,10000,0
b78e9073cd85ca11830e5c0f872db58ac487e7c6d571d73d846194b0f89d510a,986242,2020-09-27 01:28:13 UTC,500015580,500005580,false,10000,0
ad7c23d72d156ce354aa01ff467d3dfc7183e327464de6b779247a973992a367,986242,2020-09-27 01:28:13 UTC,1424783,1391783,false,33000,0
d7c859a3eb8a83c8a476c716f6fc32ad40679713b40c1030f6cee3c2b9a5a494,986242,2020-09-27 01:28:13 UTC,499990000,499980000,false,10000,0
560ac05fa9745aa8c345cb27ec35dddaa68c6359b0c25230b8e188ade4aa7227,986242,2020-09-27 01:28:13 UTC,10000,,false,10000,0
6db99cce6b568c7ed0f991a6ade12928e40dd1f3c640986ac9cda1952c1e732c,986242,2020-09-27 01:28:13 UTC,10000,,false,10000,0
9fc5c6935629f95c936428cbb1bfbb4ed85b8df440d80491df5a049c3c458121,986242,2020-09-27 01:28:13 UTC,18849497089,18849487089,false,10000,0
803c12d016baf32fa9127d28b1c78e8c6bbd8a840b688528cebf9c4500c0e57c,986240,2020-09-27 01:26:16 UTC,10000,,false,10000,0
18b8d134b1f10b00e4fbfa572f12de03177641f3758675abbc22d9321d401741,986240,2020-09-27 01:26:16 UTC,263983230,263980270,false,2960,0
f8dacc1b0ff0af71ab5c8c7b61ae07fe623fc64f94b3241a9a7691fa02e4941b,986238,2020-09-27 01:23:22 UTC,3537788,3529248,false,8540,0
87e8ec2a86c1106e3a8da8237d498ecce8f1038e04c4d0c2b5d528f25ad49d83,986237,2020-09-27 01:22:34 UTC,14908409,14901270,false,7139,986225
796c797631c8f376deef6c65bad1501ee9588c7bb71010c850c893ff9fd3e2b4,986237,2020-09-27 01:22:34 UTC,10000,,false,10000,0
8427259a3bc6714a128027a24d6e1d12a498b5529cb242fe01cf7fe7414d566f,986237,2020-09-27 01:22:34 UTC,18849507089,18849497089,false,10000,0
79f76f29edd9ca38afc82282614bed3209fa3c3f435c0ff101007b7a6eecd861,986237,2020-09-27 01:22:34 UTC,58716433,58713473,false,2960,0
e3c14f3bdf55caffbb704d36adeb36896307bc331bf9eada0035f2b6d8434d8e,986237,2020-09-27 01:22:34 UTC,145010000,145000000,false,10000,0
8654efd78daa56eccc6ed07f917fcd8c45de817a1ccdf91f396e5bc9f52a6118,986237,2020-09-27 01:22:34 UTC,10000,,false,10000,0
6238d9be34fa8a1a8d4bdd271518eb630cea6044c9424a66fe817cffee1cd35f,986236,2020-09-27 01:20:13 UTC,50647630203,50647628111,false,2092,986224
6c8e2289e643f800a12b0455dc66cbefc06c936718ff9803b57d6c5ab6c77830,986236,2020-09-27 01:20:13 UTC,264129567,264126607,false,2960,0
5c46ee5e7c669430257ef61411ddb78acd51e97b3e2231f3c30f40d6c0db1f70,986236,2020-09-27 01:20:13 UTC,1208962,1208962,false,0,0
02f1345146e9396751525afdc3810107d07c51e138091485e2f0705176f3e449,986236,2020-09-27 01:20:13 UTC,198139816,198122361,false,17455,986163
47c8c813cfb859c77d719a6e5758775f2ed6205e00dd53bebef9c27cabfafc72,986236,2020-09-27 01:20:13 UTC,303308823,303260308,false,48515,986145
48c5f1b3dcd7d11074402d868ec6d7e24590da8d300861c28353ae46ebca9d7e,986235,2020-09-27 01:19:19 UTC,499992450,499982450,false,10000,0
b4b1727bbef1631b55538731c855779a78b47192a13bb11d9ef7b659ca7ef54d,986235,2020-09-27 01:19:19 UTC,494431464,494421464,false,10000,0
dd2de5b322352df74c45c8e015ba338d1e193252a217e4750d96fc4cb07cfd74,986234,2020-09-27 01:18:29 UTC,49401012757,49399812757,false,1200000,0
2766b4a20065f1f03fd9c13a55515e6a12646a26815f934fd8381656542af867,986234,2020-09-27 01:18:29 UTC,264317951,264314991,false,2960,0
52949d894bd6af31b023a70edcc62c63ebffab759cd46e5c08999269eb597e2b,986234,2020-09-27 01:18:29 UTC,500010000,500000000,false,10000,0
0e4620eac4148e9f35e4400843643cad79e1015367484c83cbff4d29e158aba1,986234,2020-09-27 01:18:29 UTC,10000,,false,10000,0
d18a75c080f806a5e20d440be8b051f1037c5d7c80f036e969e44ffc1ec4299e,986234,2020-09-27 01:18:29 UTC,8542718,8538508,false,4210,986223
0b3290e961aeccc49502aa9132538c3250f4d029c6dab20e2e7bb0e9f4c333ff,986234,2020-09-27 01:18:29 UTC,10000,,false,10000,0
6a10219258af26a0d83522c2a7282e1bc976a35c336ecd0f6a8c8242c840ff1d,986234,2020-09-27 01:18:29 UTC,10000,,false,10000,0
a4056a66e73cc1236c90c679fd3af85f212f64f538349080ff54631cb3cd9f2d,986234,2020-09-27 01:18:29 UTC,294370075,294301755,false,68320,0
14c190808f6f856d3bac527f9d01974f6769d5e29a0f7ce70458220bcaae9b5e,986234,2020-09-27 01:18:29 UTC,58876583,58873623,false,2960,0
09cd1b237bfa132bf90b002dcb1b810029be06e44f48a3a56aaf00e806ce8988,986234,2020-09-27 01:18:29 UTC,900773948,900771688,false,2260,0
f15d34241bd2ebc86a99019b2e12182d6969680027c4e0b4b1c91d6f821316cc,986234,2020-09-27 01:18:29 UTC,177519702,177517619,false,2083,986223
b7a70220741d5f90ed94796976dc25ca80a66520f64241340903e88a7cb81393,986233,2020-09-27 01:15:12 UTC,161199554234,161197754234,false,1800000,0
e4d98ec6e0e030448269a11b267c3630c3c8fc47e8dc1840c803af0dfe29f16e,986230,2020-09-27 01:14:18 UTC,48409583067,48409570692,false,12375,0
d907c412ca64a0c911b67562a5b459a347e12c05f5a0af81b654485d72c138a0,986230,2020-09-27 01:14:18 UTC,500020000,500010000,false,10000,0
5a75c3e4b36564239717ec95ff0e57d88df56c3fd23c1db01ddffc7f7bd8ba31,986229,2020-09-27 01:13:46 UTC,500000000,499990000,false,10000,0
13953fb8cf64e7ef1165562b623ef4bbabb48bc2f7b188e3c596cf754d4691fc,986229,2020-09-27 01:13:46 UTC,10000,,false,10000,0
f7f0ef6eb79642099704b4d46c9a478d3c9b7b2b02619b9ce2b622581b0058f1,986229,2020-09-27 01:13:46 UTC,874743563,874741113,false,2450,0
38d6b98d9a4d0f3d71703b8b4086156a1605f830bde72b6c35336a2ef5b5799b,986229,2020-09-27 01:13:46 UTC,264465142,264462182,false,2960,0
02f58f5f504c28a456b48e1b3fba1dadf02e049fa488afaf0871d238f4c980eb,986229,2020-09-27 01:13:46 UTC,10009636074,10009631292,false,4782,0
8ab344e49426a9887cf4d71efeda21c1fe2bf5f73364f25792986f1173596bdc,986228,2020-09-27 01:11:36 UTC,198576206,198557316,false,18890,986216
ad73b62ef7900cea17519fa41ef643da9ed7d12b962ffff349ced141fb477475,986228,2020-09-27 01:11:36 UTC,123751391,123709520,false,41871,0
5ca497dcb8c8f0d31935d59456e1b9338e6076df8f51e52ce915a67e82ffff38,986228,2020-09-27 01:11:36 UTC,304302511,304252851,false,49660,986216
7110d58d30a28743caf605faab5c28c70c12d51e72968e2759f3a9a9c2aee559,986227,2020-09-27 01:09:54 UTC,1359063745,1359061653,false,2092,986215
19fb52e2b7267a32c3c9b4e506214f1f5bf1b8cd5f13473de092d8bc03870956,986225,2020-09-27 01:09:17 UTC,10000,,false,10000,0
702a095c673be27261b99d131e9277154b55e0331fc2ab8476564a9c4282f1e8,986225,2020-09-27 01:09:17 UTC,500002450,499992450,false,10000,0
3edc29437e9780f64d38d6da3d73fb04e45436046a7572678b8d50577ad0d53c,986225,2020-09-27 01:09:17 UTC,177574,146054,false,31520,0
b04b6dd1111ac77a061ef9924b6542538d56be38b394fae61c56b4d63e08c334,986225,2020-09-27 01:09:17 UTC,3819146764287,3819146747877,false,16410,0
95fcf609133637b7bc23c9fe519b109d6b74c6ad8acf4d48a22e597f7e14936d,986225,2020-09-27 01:09:17 UTC,10000,,false,10000,0
f4451e0d448c13f085def8d61b8667858bc4fc74a26bdc06dc3f77adde6d590c,986224,2020-09-27 01:06:46 UTC,500012450,500002450,false,10000,0
d20ec04c1c44f052711484d07b4e3f4ca06ffac99278cc37f58a1182f89cfbf8,986224,2020-09-27 01:06:46 UTC,2000008544,1999998544,false,10000,0
0c6d4405e13358f6acedfde05716760d36da9e79fca1c04123ed1e3e1ac4a1c3,986224,2020-09-27 01:06:46 UTC,1500083236,1500073236,false,10000,0
a63690c44c344dd45211748a78d9f1b3d9427e0ca581198ac100cabdefda80e3,986224,2020-09-27 01:06:46 UTC,3000155620,3000145620,false,10000,0
c41c41f794e5e7bf394b177c79c509550f3712ec158dad3fc7352b29d78f565a,986224,2020-09-27 01:06:46 UTC,59193326,59190059,false,3267,0
16f9567aee72722ef849703268ee2da1374580f382f6da4d7e9e13a7b78ccd0c,986224,2020-09-27 01:06:46 UTC,10000,,false,10000,0
97443c7b936babd5adf2abc4c201e10e0024674d0c00bf031b86f82e830cdbbd,986224,2020-09-27 01:06:46 UTC,237962311361,237962301361,false,10000,0
a9084789342328801beb3c026d0fdf66f7ebbe1b94524bd8f5ceb10ec387f48e,986223,2020-09-27 01:04:19 UTC,10000,,false,10000,0
8e4c59600b3888cf9a07c7077fa0a51bb7d0d3b4d6fe236a98ea0eeec66b2e95,986223,2020-09-27 01:04:19 UTC,155114,152664,false,2450,0
913be47a29f18ef686c7ef2c2feb722607cc0ffc7585c90af0234f75d3b6e195,986223,2020-09-27 01:04:19 UTC,182756674266,182755674266,false,1000000,0
a514c828373e5f3787aed5d3fd0a5cf7ec3240a59d0bd1e0af1c7b636cdcaa10,986223,2020-09-27 01:04:19 UTC,500000000,499991456,false,8544,0
b056a02d7aed31a78eeda54fe21e74492aa82f9c094e327507f8f0e657e039e7,986223,2020-09-27 01:04:19 UTC,264633241,264630281,false,2960,0
78d0003861006bf475077febed4ebf633d4392d852be7e7c0865e11645b8b14f,986222,2020-09-27 01:02:33 UTC,59388848,59385581,false,3267,0
fc909c0ff07c7522f07371825881b00b75b4ac4f3119f4c2ce19234e12dcba27,986222,2020-09-27 01:02:33 UTC,771303892,771300348,false,3544,986211
4c0abb35a9687d9b28ffc4f5440d169a531361324563779e1bdd1fd03d9510b1,986222,2020-09-27 01:02:33 UTC,10000,,false,10000,0
98deeecdc3f418d310edd3bd8bef6c46502e0495e0928aa42672ef20dddd17cd,986221,2020-09-27 01:00:59 UTC,55958742295,55958740203,false,2092,986210
4d3a9b9c183c0b40c51b252aae396d8d32f38796927c063aaae7a211a8b63d31,986221,2020-09-27 01:00:59 UTC,14894866723,14894863367,false,3356,986210
85f6e8ee8f9d8af4b44f988d3f8b117bf2b8e6f25e7cb8cf9f00d6ef69e0510c,986221,2020-09-27 01:00:59 UTC,802044904,802042231,false,2673,986210
45be2144377ffcf25aed5b50b1400f01f771dc726476701e6e04850d53c3c114,986221,2020-09-27 01:00:59 UTC,31468000,31465908,false,2092,986210
4a7328740eafef58dd165dbce3f13a1c0c783ecd6702a4cce335239ef06b0c89,986221,2020-09-27 01:00:59 UTC,198912611,198895164,false,17447,986210
0b30bda83ed439065660a8545cb84a53894ecdcd40fc3cff527a299d939a14a0,986221,2020-09-27 01:00:59 UTC,2000000,1998080,false,1920,0
7e085ba4a686ae7a65c7abd420fd5043889c8c78599f8efe9954f00e3f2d6b31,986221,2020-09-27 01:00:59 UTC,11139683,11136327,false,3356,986210
e7e59cf6ca4b93d22af0f06fbbc58c5137f19e8aa8e1d94be9d9e54c7e05cf30,986221,2020-09-27 01:00:59 UTC,305501906,305461504,false,40402,986191
5e6f06910da88889604fcbf257b463deb3da327e8f0882e45dba05871e62729f,986221,2020-09-27 01:00:59 UTC,2994863367,2994861275,false,2092,986210
6df9cbf8ef899d309f73acc14cef7fe6b02639e86e4b3a93d701439f816669a7,986221,2020-09-27 01:00:59 UTC,694861275,694859192,false,2083,986210
fc1a159ec6e0630aa6e8499e4ccfe1d9ff5445e4fc7bf5a6ebcd29b2ee20a032,986221,2020-09-27 01:00:59 UTC,194859192,194857100,false,2092,986210
e50a1ece9a5542d27ae33274b753731dc1586d31e63c7be2d3a027f2a2510848,986220,2020-09-27 00:59:11 UTC,264926926,264923966,false,2960,0
5dd6ff0ba027d7b73bbbf8269798de6e653c483bd169ea6cfd8e057f6ea9bd0e,986220,2020-09-27 00:59:11 UTC,10000,,false,10000,0
eeeb77354013513eab8c906be762ee6cfa30c2f85c756c7271d1d6de3164a7c7,986220,2020-09-27 00:59:11 UTC,100010000,100000000,false,10000,0
7361adb453f35ffdd7dc6066e1cee623c924be8bed54ee3d996568d062df7473,986220,2020-09-27 00:59:11 UTC,18119375654,18119365654,false,10000,0
c96184034d44c68b542a476209e96975e7178af0f6773b4bdeb3c783538d1ba7,986220,2020-09-27 00:59:11 UTC,10000,,false,10000,0
3d2bd29124b38ce713a309787ecfd7535cfc7e55aad8fdb5b412ff872e9d0088,986220,2020-09-27 00:59:11 UTC,10000,,false,10000,0
7ba78712026c6e2314a796806b41c0f24ab8a11d8c513374e35ba3737fe3ad41,986220,2020-09-27 00:59:11 UTC,10000,,false,10000,0
5dccdda93cab1badde5e3b99ff7d521743a874ce409c853d146526065ff5fb3b,986220,2020-09-27 00:59:11 UTC,323296367,323228047,false,68320,0
4be61e20ab7f429a2f02fb85d31362ef83b835db6db0faaead8e77aaa5bac8b9,986220,2020-09-27 00:59:11 UTC,1120786143,1120781143,false,5000,0
1e8433280246a0b7e9a4944fa49af0492e1bfc7d56401eac5bb0d29e88a06db1,986219,2020-09-27 00:55:09 UTC,328461358,328458908,false,2450,0
b1f705629713823faeaedf312d518717f5d86b3fd64d5715bfc033255159d51a,986218,2020-09-27 00:54:40 UTC,59868818,59865551,false,3267,0
7682a15cf2c4209a915f8a09addf2a7bc0b1ae3d37ff093820066b9f6a668439,986218,2020-09-27 00:54:40 UTC,7399997740,7399985853,false,11887,986207
ed4cf23cbee50df933ec884bbc841ae140196eb4ca42347ece66b580a86f4875,986218,2020-09-27 00:54:40 UTC,3691659,3683119,false,8540,0
c84ba4a6c18adb29c38438075415d574c85dc8400ee6b42c356047d3df304c13,986218,2020-09-27 00:54:40 UTC,499995580,499985580,false,10000,0
0111107db42433d08aa6d2f91eead564b79b65d2733a9b7dc3c2c31086da5d91,986218,2020-09-27 00:54:40 UTC,306546595,306504476,false,42119,986207
13d212c248261525236e93b4064fdf0c33417217ebc252744b90d1ff26cb4d6b,986218,2020-09-27 00:54:40 UTC,199389540,199368020,false,21520,986207
ef8497eb15cc6e6d2879092ba47c01a222bd5c51438452b0063e9de95a11ab82,986218,2020-09-27 00:54:40 UTC,2010000,2000000,false,10000,0
a6113c2e0b1d725520455ae852d3cd49e75b6c281926513858be98e8497c6d89,986218,2020-09-27 00:54:40 UTC,3624096,3615556,false,8540,0
b741659deeb7267533f4de05df6767562b5799fdaaf0e67c01210f52bc3c6ffd,986218,2020-09-27 00:54:40 UTC,10000,,false,10000,0
48dc7160592f4de9cc87d5e0930a3034f1bb8a6b9ca7274cc92f182a732f3f6e,986218,2020-09-27 00:54:40 UTC,10000,,false,10000,0
098f867aa31c92b0b21c38ebd7e0f337062d8f9640a00647eb7087434592b0ec,986218,2020-09-27 00:54:40 UTC,10000,,false,10000,0
faf4e8569a2eaac81c9f759158fc3798dbc67afdae63c5c514d12d6e90f7b6b0,986218,2020-09-27 00:54:40 UTC,265198327,265195060,false,3267,0
0c40a9d1dec6d81f65342b67a4ff4a7eb824ceb4cdc7491686d7e8b97fc7b2e3,986217,2020-09-27 00:48:08 UTC,6253838,6251388,false,2450,0
8082ac4cb10b80f94377ca1e8041021913870d846d4a6d4a1408943023dc1bda,986216,2020-09-27 00:47:52 UTC,857981984575,857981982483,false,2092,986204
8eb02abb1df8327ca95dfcd43295c8579d97e0e38a8883e907df58588140e8f5,986215,2020-09-27 00:47:33 UTC,65958244378,65958242295,false,2083,986204
f16f28739b5783df534e4844a864a300fd97ebabecab28264013777913128487,986215,2020-09-27 00:47:33 UTC,48910660,48908740,false,1920,0
d939eff2bc467c30b565cc681a11af60beeb2cf8b37597bc8fdd9b5c7cd08342,986215,2020-09-27 00:47:33 UTC,10002396240,10002387968,false,8272,0
c77e5be0bbb778090bb4d2ea01eef4934b016abedc831feee933e53b74de29b0,986215,2020-09-27 00:47:33 UTC,499990000,499980000,false,10000,0
19081629b89c12de8dcdbe566fb2d06a602466cd1c59ce63e9dbd014c9944c14,986215,2020-09-27 00:47:33 UTC,10000,,false,10000,0
070a983eeba166944f1a36694e14d3cd0a07f37b4c777493fc3ab381f192a031,986215,2020-09-27 00:47:33 UTC,60113802,60110842,false,2960,0
a8050de7cced169702e8720d288a09583d643ac98c37ba1a90382d842edc155e,986215,2020-09-27 00:47:33 UTC,245124571,245114571,false,10000,0
269ead56d4cd24d8eca8bc7f3d7e13a97ebc02d13df68ec409884c611f9ffcc7,986215,2020-09-27 00:47:33 UTC,10000,,false,10000,0
63520299b29b4a4a4b5d688888035bf9cc267e1bf30b7c730d5c0bc66ad792b1,986212,2020-09-27 00:44:03 UTC,275858,265858,false,10000,0
4f5298f620a1130e6e9c8d796a54d394ec4c862a7c49dcefaeffabd2cdcbd3fc,986212,2020-09-27 00:44:03 UTC,307550285,307503529,false,46756,986200
7f729fb42712a713252801463d79a4e6f9e05a1b6e064eb2192d2c8c0157e5d2,986212,2020-09-27 00:44:03 UTC,199894059,199872522,false,21537,986200
6ce6b63a8260993988b82b9b6f1903532821ee8f703cafa34391e74dea755a96,986212,2020-09-27 00:44:03 UTC,154951147650,154951145300,false,2350,0
9e5848f5aff8e0ac759c09efec2d8d9ccc0a3cd8c55debdeef4b1e647835a649,986212,2020-09-27 00:44:03 UTC,67087814461,67087812378,false,2083,986201
a740babb6055c6a560516582e0bc4e486df636f05b8e194de2b4a76de79c6ccf,986212,2020-09-27 00:44:03 UTC,10000,,false,10000,0
c013b41cb148be615d8c5dcd0ee5c397dbb72fb25eb659650d0a46037e911791,986212,2020-09-27 00:44:03 UTC,4108937,4100397,false,8540,0
005f08e2411f7c27b3cd596bcff2a8adc25bad0ba8e35a5d07e658ae2d7db935,986212,2020-09-27 00:44:03 UTC,265354757,265351797,false,2960,0
027bbf39ca8fe17c6cceb6f91ae0f921ec8b1b7bbebdf8106fd4bcd697640012,986212,2020-09-27 00:44:03 UTC,152338395,152270075,false,68320,0
483e96611ce4df0788a5eddafd030aed812a4c5d39fae3db8933c8d9dba5168d,986212,2020-09-27 00:44:03 UTC,10000,,false,10000,0
af2ac733d85cc3ba7ec96b0f25e88d0b7289e0853f589bb6f477e000058ed95c,986211,2020-09-27 00:39:56 UTC,265565871,265562911,false,2960,0
4ad077e3de3db97515f88f4d780da14522b9a97640c3c1192745bfdaecdce945,986211,2020-09-27 00:39:56 UTC,9288971188,9288968738,false,2450,0
01868d27627514d330283e428825def9fdfae9dc26fe0890e5edceb2eabac525,986211,2020-09-27 00:39:56 UTC,207572505,207570422,false,2083,986200
030cfd3e319233e9bcb8751aa471f345e3c0e3593c9153c4db297d65b2ed517b,986211,2020-09-27 00:39:56 UTC,17867983201,17867973201,false,10000,0
c09da048f3fb6babb9b9051e5a2a9d76d59421aa8593eaab40f2735c71282f9a,986211,2020-09-27 00:39:56 UTC,322210522,322194752,false,15770,0
2ea0f76563ca93bd212d9a53a085ca0e1afe0287d71e2b9040b866ab51c64ee3,986211,2020-09-27 00:39:56 UTC,10000,,false,10000,0
579103e3a8fde193dfe179ac5b2d67b9b744e021e3b5bcab98bb0f8c63319e8d,986211,2020-09-27 00:39:56 UTC,5635007,5626467,false,8540,0
3c6a97287a124303b760f591ed64ced1bc6cd58309e2327d8378d76928868659,986211,2020-09-27 00:39:56 UTC,10000,,false,10000,0
9f9d3424b13cc90f91c9fb8d48841542f7801fdc1d5bc2c6259c222e7dfce204,986211,2020-09-27 00:39:56 UTC,1000045580,1000035580,false,10000,0
90395e864c6cd49f5589319198f635c3b966db1bfde583e89649ea45ae9816b3,986211,2020-09-27 00:39:56 UTC,8213778969,8213776519,false,2450,0
7bd14b6c16fcd6d522cc1c2b71dd229e66ad4f2027d0caff753c26c619c4ef42,986211,2020-09-27 00:39:56 UTC,60264360,60261400,false,2960,0
f3c577a8523fccfa543de0fd12bcc119bcd22f8591462328de51502938271fa3,986211,2020-09-27 00:39:56 UTC,500005580,499995580,false,10000,0
dd42257cded0acc35139e4659efb69d27794ffebe5de7dc45fc52fb5a27e676e,986211,2020-09-27 00:39:56 UTC,500000000,499990000,false,10000,0
c937142b136fe94b94c0316dbdd4c5124866b857497415698e17b0749363c9f6,986211,2020-09-27 00:39:56 UTC,3010246,3008154,false,2092,986200
b6975cd6d1eb12deab2ff14b2cde816a4cfe84f3a5bf68347789bd2e6ed7ec2d,986211,2020-09-27 00:39:56 UTC,10000,,false,10000,0
50f889df24fb9809098111d25a06da97d27a18767e8c5eed210d861c42753da0,986210,2020-09-27 00:33:38 UTC,10000,,false,10000,0
036f3b062ca2704e8872c54c6f9c2cbbb11b799ab12ba85c5945d1755e4c7b5b,986209,2020-09-27 00:33:24 UTC,5986258,5977718,false,8540,0
21370ddebe070e62306ca04e4914b5ac3591a220dd7aee1887e0a81ca13dd047,986209,2020-09-27 00:33:24 UTC,500015580,500005580,false,10000,0
e827f777fe102fb557430d275df0abd54c8726a7d540faf57a5081f7eeb986fd,986209,2020-09-27 00:33:24 UTC,364008,265888,false,98120,0
301a12011ee58a1245b93f5ed61d0e6e79be857646a723c24a333329a558f89c,986209,2020-09-27 00:33:24 UTC,10000,,false,10000,0
ae98027b59a3ecd84067915d13a7579588a135afd4e111111abf73f5c256d0f5,986209,2020-09-27 00:33:24 UTC,19164071774,19164061774,false,10000,0
dab508f13cd4ff2a481c620feabd5348e87bdbb3d30efb942d2cf565b1f34866,986209,2020-09-27 00:33:24 UTC,60480387,60477427,false,2960,0
b44fc4fcc289d3e61530b98118a9b828c6507f64d94eb78064100a144f18f7da,986209,2020-09-27 00:33:24 UTC,265898608,265895035,false,3573,0
d4f3e83e33adaa4acd759a2b5e0d00f1c67afdc7fd52401160840d1d20a701cf,986207,2020-09-27 00:30:16 UTC,308448651,308402168,false,46483,986196
ab376f0e02e7d6387072e19bfd5cfe9a8ba5f39afe9937f732012d267747ee76,986207,2020-09-27 00:30:16 UTC,200190285,200176869,false,13416,986196
8ecfa3160b255440dbaacf9c8ec261e1655522dfa31addf312d957d8a7c83762,986206,2020-09-27 00:29:44 UTC,6018409,6009869,false,8540,0
a49957a2c19e0e74f7dc8eb90c568824c95b0aa4a356b82f14df71ffdbf162c5,986205,2020-09-27 00:29:16 UTC,10000,,false,10000,0
3662c759ef8d8e350a564c0798c8c3cfab430cfc9515a2f3c6daff7f87cc299c,986205,2020-09-27 00:29:16 UTC,266095593,266092326,false,3267,0
4d9a67823de65255f35ae17be2011180d57381411a39a3546dc594954fe34643,986202,2020-09-27 00:27:36 UTC,10000,,false,10000,0
6e158d183b179c747658d5cf8476c4543ac0092e7d7eeb76b36886e7026fe92c,986200,2020-09-27 00:27:01 UTC,10000,,false,10000,0
035c78fb1b04f7ee547d8f6e55c3a059498d13c9712c8bd8005ef11a9a7c42e7,986199,2020-09-27 00:26:50 UTC,1018514,1011734,false,6780,0
a6d16a1ec4a85fc5240d35d9a718f11edde9d321500feb6ee2bd7825f5fee5a5,986198,2020-09-27 00:26:22 UTC,1005050,1002600,false,2450,0
4ab5b50edf3acbfcfc7b1813757980996ef0e5ef3cf0686173adaad7350a633e,986198,2020-09-27 00:26:22 UTC,500030713,500020713,false,10000,0
e6c498f4ef02e5e5304685eb76fb3d0582b61e54718378637a2757d6d620c905,986196,2020-09-27 00:24:57 UTC,10801178307,10801107967,false,70340,0
33ec484cd8a86e207707ae67565d59b72931e1be0cd6e1fc44e641d322cee6c8,986196,2020-09-27 00:24:57 UTC,39201047,39164687,false,36360,0
d86f5f147f2039b95659aa7c0baf4f028fc3ae95456cb84b55084e991113d1ce,986196,2020-09-27 00:24:57 UTC,10000,,false,10000,0
12a440133a8ddc4f4da717922cc98685ac62d3948bff4b4b54bbc671daf33a84,986195,2020-09-27 00:24:14 UTC,41980949426,41980929407,false,20019,0
c44c4c3e66cf19a6538bcd73c178d9fd935ae911d6c2fff916bd5e5ece4b21b7,986195,2020-09-27 00:24:14 UTC,145000000,144931680,false,68320,0
c24773b2c4c6e50f2d60452ba32da1e845ff18394aad49cbdf5ed0d437f30a09,986195,2020-09-27 00:24:14 UTC,10000,,false,10000,0
105b47f08d9f6e7a96d743d78d2e0ff64fcf2732ccfbc57a05e74dd1f901863e,986195,2020-09-27 00:24:14 UTC,60636650,60633690,false,2960,0
2b98494268dc8807c00f1c50de0d76de260198a50ec4a7ef51e6db0b93e7268f,986195,2020-09-27 00:24:14 UTC,266243729,266240769,false,2960,0
7fd5e0bae81cea97114fcf5898ddc33f646ae9ce500a5fa4f1196117a04f6e81,986195,2020-09-27 00:24:14 UTC,500040713,500030713,false,10000,0
a7db48e85a0fab9de250b3995227dafdbe932a6b26e6fb561b259ce75ce79dca,986195,2020-09-27 00:24:14 UTC,60830998,60828038,false,2960,0
a32e3d596a253b8ed0b9067d187dfb0747c5895e55fcc426386134bc9bb46e36,986193,2020-09-27 00:20:59 UTC,200565402,200549083,false,16319,986181
32c80281e643e8cb7505d926128ea6932d1fec1dfdb8abf01839f3965e04ec71,986193,2020-09-27 00:20:59 UTC,309551591,309512043,false,39548,986181
7e97665253dcdafc836cb945188b0889ca31902a3ed44a2b801e4c83361eda48,986193,2020-09-27 00:20:59 UTC,72292516553,72292514461,false,2092,986181
520fc0e8192b7fd2297d0664429a4a82697ab2dbef7c6ee4d041ad96f96cad9d,986193,2020-09-27 00:20:59 UTC,6054609,6046069,false,8540,0
93f0888a38e78d3132ec75b41a25a7100812d24a2356be3270ab00c75e8f1461,986192,2020-09-27 00:19:46 UTC,10000,,false,10000,0
fd502c166ac4846637b97d707df2652219001e607bac46795e1c1d671dca0f8a,986191,2020-09-27 00:19:10 UTC,266451879,266448612,false,3267,0
5bb1a9903567623821ae028181acc9728d0ff57ae9960f618135be1bd6cc453a,986191,2020-09-27 00:19:10 UTC,10000,,false,10000,0
5457d4028b0c229b86e3d98456470afc3e061ebdf936b185242c120767a273c0,986191,2020-09-27 00:19:10 UTC,26560592731,26560454311,false,138420,0
5730fd8cfe63e8e7dbf6fb5aca99b2f83c1450a38fedc499814555283ecfaaa9,986189,2020-09-27 00:16:34 UTC,10000,,false,10000,0
59778de99b36c9540cd4d685a98318d8c79bcd21cca91427cab5e40cc27ea3ce,986189,2020-09-27 00:16:34 UTC,452450,434450,false,18000,0
acdff3fa788c66129205b288a21d89cf7ab674d0bacffbb145cb3850b00027b5,986189,2020-09-27 00:16:34 UTC,241178495,241176403,false,2092,986178
e10df93f22acc61b25156caf84231b9aff5d59a988ddf5d99e899af3a12380b4,986189,2020-09-27 00:16:34 UTC,61200124,61196857,false,3267,0
030552e36bf84310a650e0d149868d256dfa0dfd8895fc6f36ee45259a8dafbe,986188,2020-09-27 00:13:14 UTC,10000,,false,10000,0
bbbd7ec5bef0451106985e1845938fc018f1d5d9e65c03a622159ee52d6eaaef,986187,2020-09-27 00:13:02 UTC,10000,,false,10000,0
cbb9d7d48f9a8b93280c2c7c2085c14d87b52324e6761c0fead0a0973bcd6c33,986187,2020-09-27 00:13:02 UTC,22571588,22565710,false,5878,986176
571f7f16dd885608e64adf73a6b9815a19e36d57eb1701af5dde429c5d7e3053,986187,2020-09-27 00:13:02 UTC,2097670,2095220,false,2450,0
c7f599e321eca6af64a088161e7bd18cd645cbba40c3f7f32e8cadccc6971676,986186,2020-09-27 00:10:58 UTC,10000,,false,10000,0
98337592e9a9f080188e9be97f2bd5061d7dc590f23d3859a0accd12514e6d0e,986185,2020-09-27 00:10:37 UTC,100000000,99998854,false,1146,0
ac9427c543f99d85fae945450f84e30d81d790167fbddda65652224fce595e86,986185,2020-09-27 00:10:37 UTC,310654145,310615511,false,38634,986174
a4ca48720fc42b9cd73ea9c70254c15574d31395ea250651013d13928241fa1f,986185,2020-09-27 00:10:37 UTC,266604347,266601387,false,2960,0
45167d8161be8a635e814b2f2df5273a97e5a7d94128b5e0b942b64da3e5319f,986185,2020-09-27 00:10:37 UTC,200923194,200907472,false,15722,986174
86f484a75c74396c3d7e7795e278d9cfb1186a348f8e24f36347382fcc1dbf92,986183,2020-09-27 00:08:55 UTC,10000,,false,10000,0
a35a9cb9442f33824233c99c2be1684c838b2bee2020175a523dad04155700b6,986182,2020-09-27 00:08:03 UTC,7378829851,7378819851,false,10000,0
27b45aaedad055624e5442fbfb96b22a698e52c51848f758fa1a68d001387f8d,986181,2020-09-27 00:07:40 UTC,165085,143653,false,21432,0
fb39d4ae0e3532580706f07a402cef9dc2dee1245240fc4fa983f4924e7d4f6e,986181,2020-09-27 00:07:40 UTC,61363322,61360362,false,2960,0
903e0d90e324fb31a039020d3926f2bbfad8fbb4d8efb2606c21277b3dc1caba,986181,2020-09-27 00:07:40 UTC,10000,,false,10000,0
2563f4b1ce65fb578b27ce4c1fd2c8b0405e54e58c9cf9185b4d4fa39f64daf1,986180,2020-09-27 00:06:39 UTC,500082344,500072344,false,10000,0
81ac517901131c25504c1da9171b06120bf2d602354a9f6c394b8d35e751b726,986180,2020-09-27 00:06:39 UTC,616677317,616672706,false,4611,986169
acf84bec268118b2124b6c4d69640e7cc34388eea3a3d7cdbd1a2f155b878b23,986180,2020-09-27 00:06:39 UTC,1000080660,1000070660,false,10000,0
7b5b392f7956f59962569e47fd1a6be8c3dd12d8f54a26e90a2724ca85e25943,986180,2020-09-27 00:06:39 UTC,176640,131800,false,44840,0
52833a176a32f5387b5409ba970815ce9e007c7aa4b6fce259205899fc899d86,986180,2020-09-27 00:06:39 UTC,1014336321,1014268001,false,68320,0
4c769598823ce6483a3019604b7eb6b7c618411cda9cd38f41ecb7ce1e5efbe4,986180,2020-09-27 00:06:39 UTC,11001099317,11001089317,false,10000,0
79c92abeb1b8e852f0b250a6090bff76e88a7ced3039fc28346c2857e800fe46,986180,2020-09-27 00:06:39 UTC,2500176529,2500166529,false,10000,0
109dd45bfc44612271fc412d03cc2dc1914ccc01aa68a00e7ab0a963eada44f9,986180,2020-09-27 00:06:39 UTC,236572403818,236572393818,false,10000,0
7c5beac358d7d965c140d85cd25132461a78f83888d6eb7b0fb2924af321003a,986180,2020-09-27 00:06:39 UTC,416285258,416275258,false,10000,0
c2ef1fc6a44dabec91d784809e852fc6dd89f5ed111b82c7679475c7cc81a8d3,986180,2020-09-27 00:06:39 UTC,3000165620,3000155620,false,10000,0
d715f775065591167b1939e2629ce7e4ac247bf5ee55291ec8b2371fbb10d96a,986179,2020-09-27 00:04:28 UTC,20056269465,20055997845,false,271620,0
8dc969447c2aa03211d8ff62530350343b06c82920111f6c25218a30155c3244,986179,2020-09-27 00:04:28 UTC,266835602,266832029,false,3573,0
581231121522ddf14710f1454de6b7cac321092cc5e1de2d8984421cbbc4c0c8,986179,2020-09-27 00:04:28 UTC,10000,,false,10000,0
299688b9ab6f845de8c8eb9da314a219681834f48a3f26bb58d6eca5bb68e5a6,986179,2020-09-27 00:04:28 UTC,10000,,false,10000,0
a681dc4ffb3ce7d9ac829711b9c34315351d6d09c408d878b69bbb48bc7ef284,986177,2020-09-27 00:02:48 UTC,274931311,274929219,false,2092,986165
2774d1826ae23c2f2836d48cedc36949f667d329a0c7fec8b2957c89d95e1762,986174,2020-09-27 00:01:32 UTC,150609560,150605453,false,4107,986163
2a97caadbad1d61cd7fdd243fd7d74698f89ccd8d8ee1f15d706f907efec6b03,986174,2020-09-27 00:01:32 UTC,201347131,201334603,false,12528,986163
0711d435429a8047db66670593cc495e1625db7cb666cb12892d0a17ce8f66d2,986174,2020-09-27 00:01:32 UTC,6972746843,6972736843,false,10000,0
2c71fa9d43906b06967282c5520a5ccc1fad4e3952d8d154bf85e792e277bfde,986174,2020-09-27 00:01:32 UTC,5942624838,5942621884,false,2954,986163
daf780cda2f0a9d44e68cc290116bce40cf1f7b0f57b511b7f05c747da8f0730,986174,2020-09-27 00:01:32 UTC,10000,,false,10000,0
ccd6b8906480df4d41fe3b9fad84cf53cc5b77cd70d39f077381333415c5eefc,986174,2020-09-27 00:01:32 UTC,15805567,15800964,false,4603,986163
eb8743733475a2641a88f6aeeba9124942a5bd0d11a16d312c54add0207719cc,986174,2020-09-27 00:01:32 UTC,1018274,1015824,false,2450,0
ec75742055591bf3d549962499448a3f3bf3ca12fdd4ecf12947865eac0149bb,986174,2020-09-27 00:01:32 UTC,18664061061,18664051061,false,10000,0
2c674ddf1f48582cf5ba0d13d07d1fe4a6e4cd8aea5c53a7159795eceb1341f4,986174,2020-09-27 00:01:32 UTC,311897361,311855251,false,42110,986163
6367a03eec699b1ac1e20c7eb353dad1e7a3c8295d8c85ca27f1e251da64054c,986174,2020-09-27 00:01:32 UTC,2726724771,2726722098,false,2673,986163
9d4e332a34d7cf989ff2f21daea2a95a1af0921f6f1915a858dfabef97da85e3,986173,2020-09-26 23:59:29 UTC,61526080,61523120,false,2960,0
ccc50793b182eabad427b8079997bd170033f837b271d0c5b4ed2e8434a95a7e,986173,2020-09-26 23:59:29 UTC,18882515576,18882505576,false,10000,0
2fb83f8927a889cc35644ed247e091910feaaa4b7935b37c5330ab1a1b8c991a,986173,2020-09-26 23:59:29 UTC,19616,9616,false,10000,0
f0bd566c2f2ea5765bc69056c9feb10f66d2983794c24b9aeec55ebc76def2dc,986173,2020-09-26 23:59:29 UTC,796290454790,796290452440,false,2350,0
22bba44cb5464ac5bf4363e36b809566c82ee8f12a4c47f6f81f48e920d01ad7,986173,2020-09-26 23:59:29 UTC,10000,,false,10000,0
bf840efd98940c167f2130f51868961972641da2fa175a4b2bbcb0d31b3829e4,986173,2020-09-26 23:59:29 UTC,267037141,267033874,false,3267,0
1d8fd8e5523b0a2cb957959819a61907d0bf0cb58c32cfb09481f2b782fafbd2,986172,2020-09-26 23:58:06 UTC,61762953,61759686,false,3267,0
c1bd1ef058a54a2d7842983a88c99dc55c9dd6d780abbf42b038f35bee2c76d0,986171,2020-09-26 23:57:59 UTC,6107364,6098822,false,8542,0
c0ea511f779a6e3963da717a0d8a329c3c46b4d5bf987f76ad504fae985c865a,986169,2020-09-26 23:57:04 UTC,10000,,false,10000,0
d007866ad7a837119a17a7f602b675d4516e23860f0ec57968a602477f3aefde,986169,2020-09-26 23:57:04 UTC,33650,23650,false,10000,0
08be28afb74116cdcd6fb5452a191cd9932180e52dbf1b66eb408af114128ae4,986169,2020-09-26 23:57:04 UTC,4829521601,4829511601,false,10000,0
6cfb3f1c62a0087ee669e233699ac8d3aeb25a6a84e89ce480ec610ef971eec7,986169,2020-09-26 23:57:04 UTC,10000,,false,10000,0
07375fa9d076cb91484c8e0bbdbbe75e30a2a7627ee88c2442cbd2e0dfdcf323,986169,2020-09-26 23:57:04 UTC,106807000,106797000,false,10000,0
087cdeaf8f092c28f6a3e09ab26fcd2a622650f75fcec21bc2e52ce752af6401,986169,2020-09-26 23:57:04 UTC,267214949,267211989,false,2960,0
86c2044257a111d9a83c173d9deb702fb8a9bbb372778cec604585dedf296474,986169,2020-09-26 23:57:04 UTC,625579437,625569437,false,10000,0
b3a5607a8972f00ed9fcccf076f1f8901a51060e46575ab6cecb07c80bcd62ef,986169,2020-09-26 23:57:04 UTC,5127487,5116870,false,10617,986079
b9a97976f92bd87e38e808c66f36f40f2fccd58a956fec594b19b4cda1b74c77,986169,2020-09-26 23:57:04 UTC,62107911,62104951,false,2960,0
50507535793073d47f5e320283cd06c176ab6e26ecf98e0690335fc0181edd12,986169,2020-09-26 23:57:04 UTC,6183889,6175347,false,8542,0
318ab69e5e9acc2350cc2bdb17bce951594de5cb90bd844acf888f95fbd824e9,986169,2020-09-26 23:57:04 UTC,267591923,267588044,false,3879,0
7348e0684da537fe6819cac4341e5572227e2bb87d7f804ce73b23a43141ac48,986169,2020-09-26 23:57:04 UTC,18882525576,18882515576,false,10000,0
5a694330f15d5b1e90f5f8bcaa27aea94343addbd8bfabbfd1a45f2f9c0c504b,986169,2020-09-26 23:57:04 UTC,10000,,false,10000,0
ee20505a79fdbe3f86335243ba1bbf4818028949dd6df060edd92af00f0899bb,986169,2020-09-26 23:57:04 UTC,6143102,6134560,false,8542,0
7e2a38126f76f0d36b8b30be70f6675aacfad29f7876bdd9f48eb371d14c56c2,986169,2020-09-26 23:57:04 UTC,61963222,61959955,false,3267,0
0ebd1a002a4a427e35e87a7996652bd9008904ee6398b378e1b46e71c9d65e11,986167,2020-09-26 23:51:04 UTC,4197209,4190509,false,6700,0
b0160c36b25ad6bed3f4e2032f589de1cb08345bf0c89b9b4a0631fabc194e0e,986166,2020-09-26 23:50:45 UTC,312941488,312899650,false,41838,986154
5f6634765000ad804924abf4e07634696c5656655869d2d5b390d26c508f226b,986166,2020-09-26 23:50:45 UTC,201799936,201782451,false,17485,986154
53db990d57c58142d485d080e2a30316fae812654dd3e243ab44f7f0d275c89b,986166,2020-09-26 23:50:45 UTC,62386144,62382265,false,3879,0
8cc59786c2128c7af481e3158a49c3ee2064f216c8e17b91eb3dcb6800689459,986166,2020-09-26 23:50:45 UTC,126974881,126953835,false,21046,0
cb9215494b7b48f169832652433065cbb793920dafb1bebfb9ac556f510ad995,986166,2020-09-26 23:50:45 UTC,19112924062,19112914062,false,10000,0
93a59670d19a0e1b76fd47550e8bc686a9a785e20432929151ba2f574414dfde,986164,2020-09-26 23:49:25 UTC,6283224,6274682,false,8542,0
ba8738b2aa7a387f7a1641dae0532be2bd9a12e6d951de13d0a2245448119a7c,986164,2020-09-26 23:49:25 UTC,54130047,54120395,false,9652,986153
5f69f9ab0d21cddd22c8d0e3cd7df8c69b935e45bb88532b870cef31cbc6916b,986164,2020-09-26 23:49:25 UTC,1057140806,1057072470,false,68336,0
551816acadfad1ea88f411ca4fdf78c3932d9c22944572ca0e29d420aa339dac,986164,2020-09-26 23:49:25 UTC,267788382,267785115,false,3267,0
91a61221cf1feef65229bc8c21297f8fed43c912e01b378212b743ce4f0fe685,986164,2020-09-26 23:49:25 UTC,10000,,false,10000,0
6073136faa61daddc037dba0ae3a7a5bf36ad1f0d45d30a1d8ca20b35c36d821,986164,2020-09-26 23:49:25 UTC,19112934062,19112924062,false,10000,0
9e13061576b5e4614835b231546cc6ae7089b4077733b3c0a16786abfe7d842b,986164,2020-09-26 23:49:25 UTC,9818941705,9818931705,false,10000,0
011df5410b03ae5687532e758c23cc55fa3bcdbb63bc0ba38b1d9bd63b59a2e5,986164,2020-09-26 23:49:25 UTC,10000,,false,10000,0
9d43d4677ba69eb78a6b711a2c07530635e84f1aaa3b5a3301518e9d7a52af30,986164,2020-09-26 23:49:25 UTC,6243885,6235343,false,8542,0
c6316fc03bfa6e7cf46b8c784e41f9e292fb4d3edc7365aacb873d1ca491cbf1,986164,2020-09-26 23:49:25 UTC,68923964294,68923964194,false,100,986153
caa61628b7ce075a7903c1eb53229c0261bac6e828d5d563415e3ab2d327f716,986163,2020-09-26 23:46:55 UTC,6317520,6308978,false,8542,0
236042be8c859fbe9e1d1c86f19f7e07deab40eaf6aa4c65169dfde1acb5098b,986162,2020-09-26 23:46:17 UTC,10000,,false,10000,0
f3aceef97b4d6c74d13642e89bf8917b551cfacea4408ff7d9ff0bd954afa541,986162,2020-09-26 23:46:17 UTC,62667505,62663932,false,3573,0
032c99319cce5f447f9bf3d3a8d545c9f735b890c9dce98de29ba6c5d5f2c6fb,986162,2020-09-26 23:46:17 UTC,55344000,55334000,false,10000,0
f683069cb79f0efcb6a420d08203802a9d42ed5a06314de4799128868ef057eb,986162,2020-09-26 23:46:17 UTC,55416,52966,false,2450,0
461e6b1b23a17fb5f54c773e733dc5b5db680f6d1c54e146befb91c80f678f95,986162,2020-09-26 23:46:17 UTC,19128028786,19128018786,false,10000,0
b552df5db96b8c3455df708930452c7c2ae7de5d746b11d151423a3ec0368837,986162,2020-09-26 23:46:17 UTC,200312500,200310050,false,2450,0
5c640ce5e81b08f172bcfe02ca4a4403527fdf1b748a69626d3058269db934df,986162,2020-09-26 23:46:17 UTC,500029105,500019105,false,10000,0
49547eb1dbb8de7c130a851e9b1dea90b7203380efd019f41e9b4a1405612691,986162,2020-09-26 23:46:17 UTC,268015573,268012306,false,3267,0
19b12e59a962d70a8ee7e962cd8e3f482e48f4d3e5216c0b7ef89373bcafc644,986162,2020-09-26 23:46:17 UTC,10000,,false,10000,0
078acac4eb2c8359781f0f1d0353cd42f4e2b18d35dea0affd2cbaee56f274c9,986160,2020-09-26 23:42:38 UTC,500760000,500750000,false,10000,0
3bfc8ff9bd184471c27509ca435285ac70aee09848e2d3ba9616ba56f2d2663f,986160,2020-09-26 23:42:38 UTC,10000,,false,10000,0
d567901f90deab11da1f686085da2d12f8d211cc32c47c1482a2120c343e5d54,986160,2020-09-26 23:42:38 UTC,268163660,268160700,false,2960,0
4ff49801302e196038057bafa4ff53cc4a5356fd98eb79e66364b8f415e6a055,986160,2020-09-26 23:42:38 UTC,53586000,53584080,false,1920,0
1331a84fa061b89745617cb76cfb42a4ab9277e59c458c833b10bb4e794bc9d7,986160,2020-09-26 23:42:38 UTC,19128038786,19128028786,false,10000,0
b3d32579a641d0e5ff7fa925303316bc364394f59902e8ffb99fd25c4ce42bcd,986160,2020-09-26 23:42:38 UTC,30503061600,30503054820,false,6780,0
037fdc811314eefd97c1343366973d4addce1fbbe880183ac5a8031b78c2d305,986160,2020-09-26 23:42:38 UTC,28579990000,28579980000,false,10000,0
20d198ae066c64c548ba5ea59faa77eed169823ebdccae56e492efe77a4b63ac,986159,2020-09-26 23:40:33 UTC,202081486,202067486,false,14000,986148
3979adf337813fce7bf4b13158082a2d1ac6047977d33b5fba330246f36d97cb,986159,2020-09-26 23:40:33 UTC,499980000,499970000,false,10000,0
d51afce42c1ba220f585fb81d99cef3cfe568eb036347265d0cecd6d6e52c8dd,986159,2020-09-26 23:40:33 UTC,10000,,false,10000,0
51a4c9c1a14c25c9d85c6b593fa712b9786759ebae78fc0b467d182218a51a49,986159,2020-09-26 23:40:33 UTC,28580000000,28579990000,false,10000,0
c1f77bb9dfc7c22922d24fc08f52c17e4b7818456423dba4e93bca9ebd494bcb,986159,2020-09-26 23:40:33 UTC,314045835,314004586,false,41249,986148
37e0cb62d26be76cbbf04f1eb9e006d7864f84b15ab565a06830d753df76020f,986159,2020-09-26 23:40:33 UTC,500039105,500029105,false,10000,0
95107115d2697558912c9d75ecff40bb5a49d54cccd8f6f842c49d8f70e7e10f,986155,2020-09-26 23:38:24 UTC,499990000,499980000,false,10000,0
cb26cf69cf4e41248da7eada17af1fd19b1eb463da8456c26bb08d021f889a22,986155,2020-09-26 23:38:24 UTC,62838670,62835710,false,2960,0
e8fab0a29b8f57a067ad58e3058162cea8dddf83893bbc89dbeec7a355da6b78,986154,2020-09-26 23:37:33 UTC,10000,,false,10000,0
c840b06c115b7ad1d5faa03115513f382bee77ecfa1b1d3d994b70d7d1985712,986153,2020-09-26 23:37:19 UTC,10000,,false,10000,0
25e83dc0aa23f676ab3bf19bb0a5335d841324fa0155ae12eb2ff90ac3992cdc,986152,2020-09-26 23:36:10 UTC,268363356,268360089,false,3267,0
64c1db80891bbc6d0e8ab60dd9f3dfc0ce278b314b26abff3c2064b42cf21447,986152,2020-09-26 23:36:10 UTC,499990000,499980000,false,10000,0
aac29b69fc5fbab1d9de5191da9bda820e013878c4b50c6ea91eb3ce39c931a0,986152,2020-09-26 23:36:10 UTC,500000000,499990000,false,10000,0
4788c40843f70fd3f5609a5a8acb97fc13a0272660a52b3a9680287c45baf1ee,986152,2020-09-26 23:36:10 UTC,7064111,7054111,false,10000,0
99549a4348bd4d4fc896120b03a1d058e66d4a5fe6a1484a1ac18cea5cf5e7fe,986151,2020-09-26 23:34:44 UTC,10000,,false,10000,0
146f8efc46b5caf69c45c7c5a5f1de841ef09852c588713698d6ea4bec20da55,986150,2020-09-26 23:34:14 UTC,500000000,499990000,false,10000,0
a381b2bd786b6858a03557a32bccc77dfa7d8665ab9c4a78fe852073710b3fbb,986150,2020-09-26 23:34:14 UTC,10000,,false,10000,0
c794b8178d68782eb4035faca817ddb4e7fbaed60bebb7954de54bd87c15e11c,986150,2020-09-26 23:34:14 UTC,500000000,499990000,false,10000,0
bd64465b3fb1cf07fce9d715144c38d8026c3e63300e4aa2d38ece6737e3d403,986150,2020-09-26 23:34:14 UTC,499990000,499980000,false,10000,0
10dd79e4e1b9bfa711021739f3269046ca327cd0bf6af68e4394082ab0edc250,986149,2020-09-26 23:32:12 UTC,63042941,63039981,false,2960,0
ab802c17534d6e9842ba84f2b2985b42bf064bf10a91164901bcea5d68b1d6bf,986148,2020-09-26 23:31:23 UTC,872192974,872124638,false,68336,0
48527a3c39ee988f77d9504d0b9b0852e9cb5116cd2c5f1a4a8aea0b2c5e6001,986148,2020-09-26 23:31:23 UTC,8909965588,8909958588,false,7000,0
fb6ed074329e3d3e62fcc75b52e36350352e141af8ed7537e963cf43b21f352f,986148,2020-09-26 23:31:23 UTC,268568319,268565052,false,3267,0
6eb2a7ba56ae4298cf43f6b816b9dfb731a26810b0358e486fd8e580922ebaa3,986148,2020-09-26 23:31:23 UTC,6381478,6372936,false,8542,0
611a4372d9f890bebb5eb7c3a4cdbd7f396c02e8ab0901a78e93d69401d9e1c1,986147,2020-09-26 23:30:51 UTC,6557118,6548576,false,8542,0
c7fb1a3e20f1203047e7b51ac96ac85a98c337584858673ddc9530673a0b0fe0,986147,2020-09-26 23:30:51 UTC,7066031,7064111,false,1920,0
2ab102706603ff5313485248749243a3d56c29fd0d8a25ae54d7e14e7ebdd3d8,986147,2020-09-26 23:30:51 UTC,10000,,false,10000,0
828f67f1b6fb0344ce902950aacd74db0da34dcf3ed75b5ec181d2e2d297dcd9,986147,2020-09-26 23:30:51 UTC,500000000,499990000,false,10000,0
2b636c5d6236f3e18b28536d9fa5c402a42f206d1ba7fc463d80112e5fedece5,986147,2020-09-26 23:30:51 UTC,6448063,6439521,false,8542,0
7e6b43c2f4cb6f5b917451c5394437f57afd6afd3b328081788b2561b31d4762,986146,2020-09-26 23:30:13 UTC,202491212,202474906,false,16306,986135
defeb0cd024e3c3c0aa5feaa694ab5700e6c3a1555067c0c61933c6ee2bf4e08,986146,2020-09-26 23:30:13 UTC,315119515,315073038,false,46477,986135
f1d742fa62e94ecfc8e73287244a693a589ce0155742874bf0a2f7e0f8129cce,986145,2020-09-26 23:29:40 UTC,63289572,63285999,false,3573,0
2670096137c642701b02f0bfe8ca38c7e83d61c5d4f1dd025c4344a3a29c410f,986144,2020-09-26 23:29:05 UTC,99834423,99831973,false,2450,0
d47e0e795afa66c9b4b5e9ecdcd4a01028bd6ab7fc81854010b20bd1428000ab,986144,2020-09-26 23:29:05 UTC,10000,,false,10000,0
22fc9924d6645d1dfe9eeac836d5e568621c052154e6a67bdf3b6375c42b59a5,986144,2020-09-26 23:29:05 UTC,70491254442,70491154442,false,100000,986133
eca35ddf9356d282f65993372bfd6aede6f4dc71582ef2370b7945f9ca7ae8fa,986144,2020-09-26 23:29:05 UTC,17956664020,17956654020,false,10000,0
be143644e02e5835a115b2038a0a01a635575d6d0953eb92ec01231c026fe4ff,986142,2020-09-26 23:26:00 UTC,50000000,49997740,false,2260,0
95516caee15d5b52d1de126778d89a5d8f8cd5e18537e1c980870b1504ebd21c,986141,2020-09-26 23:25:34 UTC,268722715,268719755,false,2960,0
5b93b7593b21b5a82ccefbd31114e4e8e9ead62f2d359bd56186ba0155aa25b3,986141,2020-09-26 23:25:34 UTC,10000,,false,10000,0
14dff263d5a157bba1d725ffb45656461ca7f5a9a0da18b65f156e9fdc08914e,986141,2020-09-26 23:25:34 UTC,19602295312,19602279732,false,15580,0
8023b6cedda16f0dea822a3c2b9fcf9e12b686593cc9a0659cfffa8d8bd9d987,986141,2020-09-26 23:25:34 UTC,3973,2827,false,1146,0
7f5174aee7521c044a07461da6590bdede9c48c82dd41f2f4264238388184712,986140,2020-09-26 23:24:01 UTC,200010000,200000000,false,10000,0
b20950e1683ebea50288e5ff741f864a4d8f60524281e7ce4bf75ce7cf7abf3a,986140,2020-09-26 23:24:01 UTC,5296205933,5296190353,false,15580,0
f3705927d9d4d284e4180d6cea1094303f53090d0de26467cfd9115d12ea4d8d,986140,2020-09-26 23:24:01 UTC,18475451908,18475441908,false,10000,0
5282655e964fe2203bc410cdae3ed4bb2cd14dbc41be263dbd5880a0a7110080,986140,2020-09-26 23:24:01 UTC,11706361820,11706346240,false,15580,0
413ca940b99fad37c43a204fe36dbd1f37e5dcf0c60018cc29440b450590b74d,986139,2020-09-26 23:22:58 UTC,4066692837,4066677257,false,15580,0
f293e11d450fa898b192e40904497494c40cb2e7faa4740156a7cd3f67d6fdc4,986138,2020-09-26 23:22:27 UTC,10000,,false,10000,0
1343c1afe351eef8c57a09384e1a32eb2208572ad46ed8f0d2f5c3ed403e508e,986138,2020-09-26 23:22:27 UTC,16315147483,16315131903,false,15580,0
3453d9d44ef6df588b5c27c51fd900104afdedafd5454a65e40e5fe1a5c06644,986135,2020-09-26 23:21:47 UTC,309747064,309744980,false,2084,986123
3a90cd648663ccbf58be4799fb07c5230ac25df41b79a00ba70c8e6d3f034561,986135,2020-09-26 23:21:47 UTC,57488205988,57488190408,false,15580,0
321769b65fe90d2a0e6926ef7c7ef9bfe3226c8134f7d5e18d0e35b1471c2d06,986135,2020-09-26 23:21:47 UTC,10000,,false,10000,0
c7880780a13d35465f4b99cebad60aedc13ca4cb401db7bdda6a64e58714fa3f,986135,2020-09-26 23:21:47 UTC,63476279,63473012,false,3267,0
5775bd672f99ad9ddbc45d3bc774f772283b724c0fa089e714203451f40e4bed,986135,2020-09-26 23:21:47 UTC,1353709155,1353705761,false,3394,0
d51487838f19da609a79617fe43b0acb2fcf215746fb64408e978639e21f180c,986135,2020-09-26 23:21:47 UTC,124584323,124572238,false,12085,0
4dd5f118b4eade5c34d59840eb4a04adf9ab5093df57cf1245270c9b705b4398,986135,2020-09-26 23:21:47 UTC,202880776,202863291,false,17485,986124
b8a8c7484a33c26ca8cf886cd6a4372fa22b403cd9bdc4dc811a782aff7373bf,986135,2020-09-26 23:21:47 UTC,316205322,316160332,false,44990,986124
a0ad369bedad1a07c9f01079266b2fad04e7e262aea9d01a7578a31c79c6ce0d,986134,2020-09-26 23:18:19 UTC,167966730,167965584,false,1146,0
a958370efefa2074ed6ccb8aa9191b38fe1aad0ba8e74920db7a80e12b44a993,986134,2020-09-26 23:18:19 UTC,18741998854,18741991854,false,7000,0
446a8fac56b7c9c93ad313648838d998b0e85c72f60e98e8d9a2801e63482a07,986134,2020-09-26 23:18:19 UTC,2900596114,2899320211,false,1275903,0
9c59648b6c7ed1342ee3cec7650c97bf95e205bd917667f82454f2a7eec3acae,986134,2020-09-26 23:18:19 UTC,72492018645,72492016553,false,2092,986056
1854caf4c8824f3db30b755946329eff18388969eeb0892c62a0b4cd96cecd18,986134,2020-09-26 23:18:19 UTC,10000,,false,10000,0
275b0163b1fab4816e72b6ce6628d4369790a39cd08d157cc5f224ad6e85d361,986134,2020-09-26 23:18:19 UTC,10000,,false,10000,0
b710bef517b16ac306d45ae56f4619bbfff643299bc82be9b0f6be40c98bfbb0,986134,2020-09-26 23:18:19 UTC,7852885,7844343,false,8542,0
83be9087f840e2c5f8fe53ae32fcdf13808cc78bf14fc9978db070d883fdc538,986134,2020-09-26 23:18:19 UTC,6616024,6607482,false,8542,0
b1c1d348e87b8056388a571e7cd10fc02b97fc854c20506788b399ca78581f4d,986134,2020-09-26 23:18:19 UTC,2720907288,2720905867,false,1421,0
95083e2ffcf4e8984e8f940ba9bf6836aaf551ed0f8d06a64109ea54ddfe8981,986134,2020-09-26 23:18:19 UTC,100000000,99997550,false,2450,0
5e15ca2524550723828683f8949f3733b3df50978000130b4580554732d24eae,986134,2020-09-26 23:18:19 UTC,915109142,915040806,false,68336,0
cf6ec6ab34eb051c247af869c61a7ac8bbf8127630496d7c807948bf6381719f,986134,2020-09-26 23:18:19 UTC,100000000,99997550,false,2450,0
5405cfb7d9be5047cffc1cf2aa0bb4cbdc2d42f5718c4106c047c66ddf0c9d07,986134,2020-09-26 23:18:19 UTC,10000,,false,10000,0
37bca660025701bfd113977eb0e1cdfd91624d149ad454b6909dd70dc622bc76,986134,2020-09-26 23:18:19 UTC,10000,,false,10000,0
9660c6c506720f67c06cc6b3d70880b192b287b4ead0eb679e96b947d54f797b,986133,2020-09-26 23:13:19 UTC,5005887067,5005882306,false,4761,0
e8336739f2604dec974d3dfc2721278ed1ccfe56d5b004a957894e3d73a7de81,986133,2020-09-26 23:13:19 UTC,268994997,268991118,false,3879,0
a76c94c0e6c1ba6e0e7bda7b824556734e486d3d01d30b6d4ac6f66c86a2ad14,986132,2020-09-26 23:11:46 UTC,203377471,203360276,false,17195,986121
7a3cd4344ddddb60d8836983892c0616e21377cdcd1fbcdeabfa784300fdbcd0,986132,2020-09-26 23:11:46 UTC,10000010000,10000000000,false,10000,0
91124d7853c5cc44bc68d0c92c1fe6f5019553f6d3d44f501daffd61d5fbf5e7,986132,2020-09-26 23:11:46 UTC,317418779,317370509,false,48270,986121
8db1f2bd33603e09dadca1c3a6532c935d637ba90855a3e7179c039b6f5466eb,986132,2020-09-26 23:11:46 UTC,63674364,63671097,false,3267,0
355601fbf8cf998104b293427c76a554d051c4fdea7776067e2656b4fe6023e4,986132,2020-09-26 23:11:46 UTC,77492520729,77492518645,false,2084,986121
c8f31ee6bb7f63311129bec0f6fc816bed766908885bf53b4ff222a1d2b5240a,986132,2020-09-26 23:11:46 UTC,162301018,162275932,false,25086,0
018c640b8598a92a8633a5ce6e72a57ffddc0abc33979195833fd95804c6de35,986132,2020-09-26 23:11:46 UTC,10000,,false,10000,0
e896f8074f15eaed66ae7c6590589da65a6eb46c6ff247ea2797a9d78ad3d285,986132,2020-09-26 23:11:46 UTC,10000000000,9999998854,false,1146,0
d718df5cf56b94cc503d98abd8cc18dca75bba31b1d0e58e2a662014ea694d3b,986132,2020-09-26 23:11:46 UTC,10000,,false,10000,0
0a04dbb1eefa7d79d377261b6f3dd3f7c9b3bf6f8496da4d130f890b9e2b4b78,986131,2020-09-26 23:09:12 UTC,10000,,false,10000,0
93ff107f07ffaf57735d5d9c02c344f0d63d3cb5bf8b5f88f16e62b52f332c6f,986130,2020-09-26 23:06:24 UTC,3500285894,3500275894,false,10000,0
db322ffd384fd0d9483684231cd21935f2be00ff70d7ceb8efbd35916baf8229,986130,2020-09-26 23:06:24 UTC,6659341,6650799,false,8542,0
884ce67feeb2dda0efe01cb0eff21f5f37818fd61a16e12cfa1e2f8db568a9ed,986129,2020-09-26 23:04:38 UTC,2500186529,2500176529,false,10000,0
00e2974ea2617af24202c772be75accf12243816586aa3aafb94c256cb54c162,986129,2020-09-26 23:04:38 UTC,2500336990,2500326990,false,10000,0
4a5843545b74cb8c2c5ab408f7331c60f7c9ecd1101166467ffc4358b06207bb,986128,2020-09-26 23:04:30 UTC,10000,,false,10000,0
9f06fdb2fccbb44fd7a20d00e76b23a2f68903f4aa7d8f404ed4d312a6985812,986128,2020-09-26 23:04:30 UTC,318552586,318504674,false,47912,986117
4a1fd74680559fd7e2a6835ff9d3f224e41115c5903c27b1889fad09eaaf0037,986128,2020-09-26 23:04:30 UTC,2758519942,2758517559,false,2383,986117
dd579efe532978e7c6142832d985f63344db5807a604b8d26a7da4ce6192eca4,986128,2020-09-26 23:04:30 UTC,338419783,338417699,false,2084,986117
51c13f7896bc3f878b8254bb7b30660003298485014c93ca0126a28801d14cdc,986128,2020-09-26 23:04:30 UTC,10000,,false,10000,0
1590907336551228997e8f6f16d64a2b9f838abea82cf65c5d2f9b2151ab8bb3,986128,2020-09-26 23:04:30 UTC,234790648071,234790638071,false,10000,0
1c14a85c25aefcbd105e7465f3728aedad8550cc5c5888d3e6afdca6a8b43dc0,986128,2020-09-26 23:04:30 UTC,63839880,63836920,false,2960,0
5fdff05666088c5cb99fd022e0a7a38afd774ea8a5bf4aaea7219b209cdd7917,986128,2020-09-26 23:04:30 UTC,499990000,499980000,false,10000,0
2e5f0e32f2bb91e9fef9f1117f4b4023dca6e6deb663cf592f490afc34ff4f68,986128,2020-09-26 23:04:30 UTC,10000,,false,10000,0
9711fa641edf2b4830774551a245cfe3c9b8d76dc77b7c531cfcb1934b121319,986128,2020-09-26 23:04:30 UTC,10000,,false,10000,0
d3b221f1c87234c0ef82caa27ce85d65889b9fe8b4ef6e406bd1ccd7dfcc3a92,986128,2020-09-26 23:04:30 UTC,269289074,269285807,false,3267,0
13080ac7ba9e266215e420b45e0a7cb344fa62ed182ad530125234b608dbaaed,986128,2020-09-26 23:04:30 UTC,32163843,32160196,false,3647,986117
f4680dd70532f376586397d62491a8dc0526cfb8bb5b0e26822fbeada9100502,986128,2020-09-26 23:04:30 UTC,15013238,15007370,false,5868,986117
c237f08902f9b1d2d062727a5a2171a18cf077d133eac5dc05ce76cb4c26f9a1,986128,2020-09-26 23:04:30 UTC,204904067,204885420,false,18647,986117
95d2faa573523b158165d4d3e88d21cc239d5088ad66abeacff8a56ec0d7cb19,986127,2020-09-26 22:59:12 UTC,500000000,499990000,false,10000,0
e6253f43c056f462e87e3155b9c78e674dfd0ccfcd9978b8e8a986230063837e,986124,2020-09-26 22:57:52 UTC,10000,,false,10000,0
d731128b5321653b8e24c1b0bbba2165d59d3bbd2ae510697af7a0a4e207aa0b,986124,2020-09-26 22:57:52 UTC,10000,,false,10000,0
1c0478d85872d2c5571396ce6c835735889b9236b7090b6460823d80560233fc,986124,2020-09-26 22:57:52 UTC,99230,89230,false,10000,0
d28b511ef13339a19ec9a6841caec97063b845dd9a88cb7f5cce1a23611dd7e1,986124,2020-09-26 22:57:52 UTC,4996632222,4996622222,false,10000,0
70bcfdd661448355c0495aaabe58b63402ac8ad35202aa5f59a4a522ada709af,986124,2020-09-26 22:57:52 UTC,730161310,730092974,false,68336,0
9bb6ffe0f304c003ffdaeecfc4c85fdb7e2821eb673810415a6fb859c74a2325,986123,2020-09-26 22:56:10 UTC,10000,,false,10000,0
e3ff554da94274c3a6010ca0fa6591508b25cf1ab2068bc8238e7313ca0e01e1,986123,2020-09-26 22:56:10 UTC,2000000000,1999999548,false,452,0
bee27a41cd9e15fb54796eb4c8f9bd03185c215ff579ff8f5b00e86c040b2ebb,986123,2020-09-26 22:56:10 UTC,64006705,64003745,false,2960,0
165d484092e05c9d8299d4c8b719904cbc340c0e73b976ceda7568ad75631924,986122,2020-09-26 22:53:27 UTC,2971205,2968755,false,2450,0
9e466f4b71a1c1798aff8c0f2a204088738f50a764eef189bc669a4d6ee87f68,986122,2020-09-26 22:53:27 UTC,17975481908,17975471908,false,10000,0
ffc007b0d05dea8310845b509e87c2416588cf09562b60a7c425104150371d4e,986121,2020-09-26 22:51:51 UTC,10000,,false,10000,0
c41690b4b3715a8123133b9d7cea05197ec198c4e70b9a20babab5ffe9e4df5c,986121,2020-09-26 22:51:51 UTC,319575981,319534681,false,41300,986110
3932982fcdd1a2b12782c09b5de37829b613822fc860b9707abaf8dc36874f81,986121,2020-09-26 22:51:51 UTC,205383589,205367266,false,16323,986110
04ab6b55269dd23cf032dbac2e1e3f90ba2724fb9692a6752d48b0021de1533c,986121,2020-09-26 22:51:51 UTC,10000,,false,10000,0
4d66064645b0e65310c6bb6eb970bc51c7d6d339275d6080987d10cdd54f2ac6,986121,2020-09-26 22:51:51 UTC,269472596,269469636,false,2960,0
4f8bf7ce1fae4718612c7b442e8c7a05659a395086c93e473f54da85ef9f0d51,986121,2020-09-26 22:51:51 UTC,2203938296,2203914958,false,23338,0
c77b26e75b93e196f862bf1cc0d79454b5a5e6ed8fcc4bc3413fe906eb9a7de6,986121,2020-09-26 22:51:51 UTC,18411654402,18411644402,false,10000,0
46c46c902e63e5fa860473ae54b22bc1aaf30eb1d1a11633e4dccee11bf18bdf,986120,2020-09-26 22:48:30 UTC,18411664402,18411654402,false,10000,0
b4556578a6ebb4d965d1fa8a26270493c3e3dc5fdaf51a93263e4842ed7d4d8f,986120,2020-09-26 22:48:30 UTC,10000,,false,10000,0
b008f0e72243f7c9710969e97c0187d2f055ed546a5d84bc90d31f6f2e911ed1,986118,2020-09-26 22:46:30 UTC,1000918843,1000838443,false,80400,986117
56fadf1ff1674690c346edfedfcab6b838b56147e020e67f3b31e10d50267639,986118,2020-09-26 22:46:30 UTC,55515109,55145749,false,369360,986117
35a2c455d9cb75e6fb9646e64f779d0fe6358e3680d358ecfb69823d06e133df,986118,2020-09-26 22:46:30 UTC,50428719,50417820,false,10899,986107
c0f99b72e8f5d5311e563524fc1c2c2f73cb6a4779452b08e4edeb2d873221ae,986118,2020-09-26 22:46:30 UTC,499982093,499972093,false,10000,0
2d2bbc95203dc0c615efc10e62557dd8c75acbabcaf02dd0b8ad844db5e8a9eb,986118,2020-09-26 22:46:30 UTC,100819503,100815763,false,3740,0
62fd0689a86b12547eb707bf09149ac6fc94cf756a135a5a73adede11b1a2e6d,986118,2020-09-26 22:46:30 UTC,10000,,false,10000,0
99d35d7a3ff409d81af5ec6cf9c64a974f8e8efb287c4354f5873e0d1fadab14,986117,2020-09-26 22:43:43 UTC,10000,,false,10000,0
a270212b9aca151ebf80eaacb6713b65a8b471a3d23ef95e623e103d907d02f4,986117,2020-09-26 22:43:43 UTC,10000,,false,10000,0
c9f02de55108b557681b6aebdf2418aea7e1fb99f769a154e89e80a226818453,986116,2020-09-26 22:42:51 UTC,64216655,64213695,false,2960,0
ea80b21655d270e5592f805e50ef56e61cb24eb4f94d91bcf03769a6eb143e81,986114,2020-09-26 22:40:33 UTC,320595544,320551647,false,43897,986103
bf372df4f0dfbd913ed6d18d9be9bd335f986724edb86197010ea7bbb8760c9c,986114,2020-09-26 22:40:33 UTC,205775560,205761569,false,13991,986103
cb22ef4f14ef923e835141e8928f13c6009f602cdaab468a859ea8497c41a38a,986114,2020-09-26 22:40:33 UTC,10000,,false,10000,0
e55179bc4cdbf020987774a1d4f6221923cdaa83f9342a725c8d4b9f99eef303,986114,2020-09-26 22:40:33 UTC,765870736,765802400,false,68336,0
712fa58a597b2d9f277c7a05812148467023432f4c0a6904ad3bbe01b3a39ad5,986114,2020-09-26 22:40:33 UTC,499992093,499982093,false,10000,0
999f376854451efcd3f983d0bc61338a369ec0e220209a98811ceece634c9a95,986112,2020-09-26 22:38:56 UTC,10000,,false,10000,0
606552bb5d1078a2d3110e6407b41e30be849235bcc07da37cf7c55d32e7c47d,986112,2020-09-26 22:38:56 UTC,269741730,269738157,false,3573,0
8089bf30f4ef1ace25b27c460153b334d851f6877834ca2d1863bc3c100378d3,986112,2020-09-26 22:38:56 UTC,1030096,1020096,false,10000,0
898b6d5b829d1b4290a219b31e404ed97770b36782fb695a33dfba13bfa85b41,986111,2020-09-26 22:37:51 UTC,500002093,499992093,false,10000,0
aec7363aee817db642f9b635e1fa3a32abb9c8077ac8fed1d90460e7bf0bfe07,986111,2020-09-26 22:37:51 UTC,500020000,500010000,false,10000,0
63c6f5b8e76b6530c58683e552777a9e0d7650ce8f1ef147a3f7b9e6e87cd286,986110,2020-09-26 22:36:15 UTC,500000000,499990000,false,10000,0
0394b3da357e35139ab48b48f82441b87257d44ab09e2faa24795f33a483cb44,986110,2020-09-26 22:36:15 UTC,6696490,6687948,false,8542,0
30011f39bd31c5a3024391f39310f6b0fef40e95fc1596298225793adec34e69,986110,2020-09-26 22:36:15 UTC,376132174,376130082,false,2092,986099
e7b457bf919c66aa3c882044095885ca3ea9445c31f6f8d11236f9b490d3a2f4,986110,2020-09-26 22:36:15 UTC,10000,,false,10000,0
3336d4f882f82eb38578b42e0aad817a28c63dd902f2aa7fc10550468ceb7b39,986108,2020-09-26 22:34:31 UTC,10000,,false,10000,0
5a09809ea85d4845b424b4a1834f1fd16fd5e4b82d7fcc4455ea27b76479c9d5,986108,2020-09-26 22:34:31 UTC,2118545191,2118535191,false,10000,0
0dd5af49de516bc5d650214b697c4636a50e2d7532dacdfcf94b34ce2c848b62,986108,2020-09-26 22:34:31 UTC,500030000,500020000,false,10000,0
f9f9b08bafebffe50653ad941c0c97431acd55ec4d89a365e9f96a1f1244a45b,986107,2020-09-26 22:32:53 UTC,47040,37040,false,10000,0
e1d7918b1643f0788e114a7da736230eb52102cb52b7f6809f1bd0ff34447dbc,986107,2020-09-26 22:32:53 UTC,6946896218,6946880638,false,15580,0
2f7d8320c77f1925ab11c9442e356fc3dcc8c8e93f8562db17a584cce9fcd33a,986107,2020-09-26 22:32:53 UTC,99997740,99987740,false,10000,0
a0bbfe7b11344249e0fa62917028ae47575b1f86d3418b7b54347b56f76cb68e,986107,2020-09-26 22:32:53 UTC,17632208334,17632198334,false,10000,0
864459617b22f25eb44236d01749a49f8e715790d5a75ae49ccdaee6e59d7931,986106,2020-09-26 22:31:39 UTC,20679334716,20679319136,false,15580,0
8d383ea6ff7ba273255005844f019ecfa123fef94da42df78ec27b6ba79a5780,986105,2020-09-26 22:31:20 UTC,10000,,false,10000,0
d5714312dfcd3b0115a0c6926da3696ad3244ee0c6a48f238da321f695d5924f,986104,2020-09-26 22:30:53 UTC,10000,,false,10000,0
5b19764ac66c509d5abeb4ae45368b54511c30352c81ccaf15eec388f487f6ec,986104,2020-09-26 22:30:53 UTC,98556004,98550448,false,5556,0
86ad5cd736e04dde1ec7b5148dd4c8287e664d1fd8d3028e6c5b0e1d5782d161,986104,2020-09-26 22:30:53 UTC,234499810,234497360,false,2450,0
27628a3d37bf96b90f95de0aab0f3507f04984ccccbc42e658072a91a4a13866,986104,2020-09-26 22:30:53 UTC,321460639,321420487,false,40152,986093
905f43547a70ca2be9d2df8721700967a8d46e68fdfb40c3c2d22882b554b602,986104,2020-09-26 22:30:53 UTC,206170210,206153300,false,16910,986093
350b379a8a1f4d4f25f2d9ea076d5f5300d66ae76bd8c1ed85be4e02a17d57d1,986104,2020-09-26 22:30:53 UTC,77613022822,77613020729,false,2093,986093
2079c924e682bb352d101dfb2cc59537c81e4c4cf1d3505b7187141f024af4a1,986104,2020-09-26 22:30:53 UTC,64547888,64543703,false,4185,0
03a4807acabae5a0e3c7abf6a69ec62569a6951c13d188f6fde4a47a2498e117,986104,2020-09-26 22:30:53 UTC,61676,51676,false,10000,0
39aba36c3644b20bda9326adfe8f6754c4410e62a28ff6e8f5783dd80b0ed249,986104,2020-09-26 22:30:53 UTC,10000,,false,10000,0
0b95d3460c8520c28da1db4a30e4979fafe4e6c73e9e129253b88a8a25f95692,986104,2020-09-26 22:30:53 UTC,25516092,25515640,false,452,0
3280b7ec91f2a5100762fc8c8a0c8eabaf811bd687f49814e378bfeb46392fd2,986104,2020-09-26 22:30:53 UTC,499980000,499970000,false,10000,0
69f17c5c618f8b3ed5cf328b005f28f720272515e1da76778ba4c23cb71d4dfa,986104,2020-09-26 22:30:53 UTC,46131339,46129408,false,1931,0
cbe209acb3b4d5bc14a9ba1799351cf0d6e62d8a9ac528e317dbfa8ff31662ef,986104,2020-09-26 22:30:53 UTC,178934238,178932318,false,1920,0
ceb213e5acd2d2b69dbf40a8cc69741ea2acc839fdf72548fb79cc777ae9abbc,986103,2020-09-26 22:27:21 UTC,178936158,178934238,false,1920,0
d67a19ba0f7094b8a3d71b63a7b27ff5475bd5c6e14375f30b9f977e37f34bb6,986101,2020-09-26 22:25:40 UTC,669415564,669413304,false,2260,0
9636f3b0b9703930bbeb595714a1a662eabce33cedd223eb4898ccab58a229c0,986101,2020-09-26 22:25:40 UTC,10000,,false,10000,0
8c36450e6ba5b82c889b062f865acd45d2160b97977394a0ca29806483598766,986101,2020-09-26 22:25:40 UTC,269896835,269893875,false,2960,0
753458e58e464478c9a826a099d781743f86912033c228a3fb7050f067ae0d0b,986101,2020-09-26 22:25:40 UTC,115813024915,115813022822,false,2093,986024
d372f5063cd4f06582027aa7743a1a310d0254aade5b7dd8029e43a99cb97395,986101,2020-09-26 22:25:40 UTC,10000,,false,10000,0
92ce51e6ab804cf1f37797ea6e1d9d05b16f4655c4d66b58f70ce0eeb7f6136e,986099,2020-09-26 22:22:39 UTC,10000,,false,10000,0
cb47cfe87a71155d7ddf80497543078fe0e271f13c22365d7728fbaa669ea624,986099,2020-09-26 22:22:39 UTC,588129662,588061310,false,68352,0
0955d3e8b57842687e3bf7e5b64a9fd1cd4105436d27088c096b0d89b342f651,986098,2020-09-26 22:21:22 UTC,398800442,398798358,false,2084,986087
f6a6777a52116fd4f0de1b4216fa49eafa1d3de7cbe0adbe112380bc304a7242,986098,2020-09-26 22:21:22 UTC,50892669,50890739,false,1930,0
010b7aa10a907058e01204b854aecff21ae7cd812324860441c93a4b40858b4c,986096,2020-09-26 22:20:15 UTC,206872321,206850483,false,21838,986084
396402c6823b792f735565b9ea145cfc6cf735e71aff3dcb0d8fe11a7f5bc1c0,986096,2020-09-26 22:20:15 UTC,322359326,322314300,false,45026,986084
a0d9a3a1273b7b1eca8499d4b0bbb6a6e7e96fc2cf91611c5d745b1a7fa2e751,986094,2020-09-26 22:19:43 UTC,64881965,64879005,false,2960,0
1e4e329b03a5a8b9f30639fc53f0fedae6f70d30d1059b11843f6ab7d808e59f,986094,2020-09-26 22:19:43 UTC,10000,,false,10000,0
ed3afcb33796b1907ced688d9806e76ad84bf42f600dee463836fc30c452bf52,986094,2020-09-26 22:19:43 UTC,201325715,201321975,false,3740,0
9599e21846a35ebfb075d4ca45d2a6d5ab4439dcf8eea97760b516919b226b36,986094,2020-09-26 22:19:43 UTC,210000000,209990000,false,10000,0
52309ced791496aff38bbd6f974d09ac97ad8759dd7efb8a35f1ab0b0a32ed5a,986094,2020-09-26 22:19:43 UTC,209234094,209232001,false,2093,986083
ee7799029c9456c53598d9ced54f4bb732da678d7e72bd31a7919a83af9daf13,986094,2020-09-26 22:19:43 UTC,10000,,false,10000,0
e13cdf2e432778d3912fa97bbd7566e7190724d4546d81d77d33623fb29f0f21,986094,2020-09-26 22:19:43 UTC,200299000,200297080,false,1920,0
ec2f92facb1fe8f635d2bc9a77f0f69e85180a6b52a3a6c6f9a502612d07a9f2,986093,2020-09-26 22:16:35 UTC,4515578,4513128,false,2450,0
c6ce298d291727f2c754524ca283c73b9574add8a7209d4e1866998db17dd479,986093,2020-09-26 22:16:35 UTC,10000,,false,10000,0
f0c3a1f8d17be0529d467b67a2accf571e2cfb9dda3a1961b9413719382f4d69,986093,2020-09-26 22:16:35 UTC,270053755,270050795,false,2960,0
f5918028e060fa5c85b30939f74742d6d9935a1f6d2eeedff32d1ea29f1aa971,986093,2020-09-26 22:16:35 UTC,6900430,6891886,false,8544,0
9af2118beca9649d9a0c8b3978a825924dbc4dea1c3ce697e33a2c154106ba37,986093,2020-09-26 22:16:35 UTC,499990000,499980000,false,10000,0
47e28487b38fa29709a385bcc7b1d9d0ec9559b023773cb80097eca9b189fd2c,986092,2020-09-26 22:12:56 UTC,7718152,7716068,false,2084,986081
79591d0bc91149629bf4883f843f9983ce2504f0aa5cd63fd860892a732ae6fe,986092,2020-09-26 22:12:56 UTC,10000,,false,10000,0
4e74b31eaa66d551cfd161fb561b3f77133a1632c15212b4c78f054b6b239378,986091,2020-09-26 22:12:23 UTC,500000000,499990000,false,10000,0
f97a011a93c025f0ece648bdb5fe5867b86589bdbbc9ef8e1487b3ce0230e5b4,986091,2020-09-26 22:12:23 UTC,10000,,false,10000,0
3310a6d86f6730eaf29c25c7f6f74b8e25d65f40a58e05277350449dc105f471,986090,2020-09-26 22:11:25 UTC,323578795,323537519,false,41276,986079
369734397a6cb24b774f29a480977e47757ea5546825de0acfb56916ce1c14a0,986090,2020-09-26 22:11:25 UTC,65162400,65158827,false,3573,0
c522edcc773d7c842c90fc1690e8870e829cd3836bef66eb0186c4057acfd6c5,986090,2020-09-26 22:11:25 UTC,207540863,207521631,false,19232,986079
ab59f3c3e8c4e92dde6a0008b60c64db5ef6e98d679edf5a1595bcfcd5286d69,986090,2020-09-26 22:11:25 UTC,346729780,346709978,false,19802,0
a499a74863416073bf21989cb0734fe01e82ac171b9eb48a265962a5aa8595ac,986090,2020-09-26 22:11:25 UTC,15787178,15782556,false,4622,986079
cad4931ee0efd35c4a8b5d18f95b259bf6e55dd0b758511cd80b11c54816ac6a,986090,2020-09-26 22:11:25 UTC,408861760,408858360,false,3400,0
cccd05c921cb1ebaed4f02fa9069d99715ce334ce5fb36e0e42039664d122f79,986090,2020-09-26 22:11:25 UTC,497870600,497860600,false,10000,0
95dac4d8cc9ced72c1c58934a8d159e5f4bb15a6d981f13b60e48918fe4e0e3b,986090,2020-09-26 22:11:25 UTC,10000,,false,10000,0
4182d608dbe31bae8b0680e1ad3dd1160f56e277baf991a279601d4c6ac94235,986090,2020-09-26 22:11:25 UTC,7146294,7137750,false,8544,0
9b51cc381bae8049f5f3a0bf598cc8c0ddf72a64237605e1120d3b7eb9754c0a,986089,2020-09-26 22:08:19 UTC,409236187,409234094,false,2093,986077
a24ca2175d4fb45263f8413f36a2af1207cc5862c66a689c0c677bfaa0e0fca4,986088,2020-09-26 22:07:56 UTC,242683712603,242683702603,false,10000,0
7cd56a2e2b8a94b544ed5127d1b8b980e335c30a8fb5cd3b618067783e65a572,986088,2020-09-26 22:07:56 UTC,10000,,false,10000,0
4c675895bb56dd4995124e6eede6c83b494a59ce751f80c9c87e9f8ed78d963c,986088,2020-09-26 22:07:56 UTC,10000,,false,10000,0
2155b294b05980eb1a4b25c66d36aa14e538d48212b5c7488d36f9471d6eb728,986088,2020-09-26 22:07:56 UTC,10000,,false,10000,0
00adb8f587b0783b63617bda9565c804c468328e1e466c1591b77cbdb8ad13ce,986088,2020-09-26 22:07:56 UTC,86089208,86079208,false,10000,0
fb94de5705fe9c422a0a8df56af37b5ee64b492f87122c40c491993db869acc2,986088,2020-09-26 22:07:56 UTC,10000,,false,10000,0
3e31995ee5187a7a6ef77f9fb6e14f3b2ace423f0db8fd89eaaff563b034096b,986088,2020-09-26 22:07:56 UTC,2500346990,2500336990,false,10000,0
26fce38d1a63fb18e1dd8e36e65362ac7563c4f01ab2dee7db302cf152ed91b9,986088,2020-09-26 22:07:56 UTC,620803695,620735343,false,68352,0
bedf0143ab92d73740fdbb0596c3ff43df0b8dd1fc2c8ee458b9c9b1336e95a4,986088,2020-09-26 22:07:56 UTC,1500202351,1500192351,false,10000,0
6e28f43e7a80aee1e31cf60ac2288e29d4172c335e815b5480eee94210fa8aae,986088,2020-09-26 22:07:56 UTC,3500049997,3500039997,false,10000,0
3a74fd5174182100be7411093e2a6f2d7a4a29e441cac1f5cadcefc31fbc1f1d,986088,2020-09-26 22:07:56 UTC,270249476,270246516,false,2960,0
60d44139a151c7546144dce33654b7a634c5f458fabcac3e2257be250d6a2257,986088,2020-09-26 22:07:56 UTC,148302261,148292261,false,10000,0
3efd53214513687c8c001ddc45b071899eeffc811db26e3b3bf44d24e23c78ff,986087,2020-09-26 22:03:38 UTC,17551958689,17551948689,false,10000,0
d2b65586aba5e6f02a1fc8eec009b8456f95e766f3611b4eca6be618f866e960,986084,2020-09-26 22:02:39 UTC,7362919,7354375,false,8544,0
77bdaeaaad0a457c6fd14194c5e8232965ed7f3a1d983bfdce57d823e5c7e5e9,986081,2020-09-26 22:02:08 UTC,100826203,100819503,false,6700,0
9681b3e5b70603fced11533453a5ef7c5952af661b1c659b8a2f62225ee3bb71,986080,2020-09-26 22:01:41 UTC,208068240,208049623,false,18617,986069
7ded3733edfe76327d1ff8e56e9b6c3ea068c2d0d0436ea3a09dea19d0434c55,986080,2020-09-26 22:01:41 UTC,7391545,7383001,false,8544,0
deee744f6ccc29c93ea478e5d911fcd520b581d50ba27553ad4f5132113ccc4a,986080,2020-09-26 22:01:41 UTC,324707342,324664110,false,43232,986048
bf08dbd05773fdf7e50312ad9204356b9990427c73849d6ff1b93304f8bb05c0,986080,2020-09-26 22:01:41 UTC,20555010,20551661,false,3349,986067
ec385374ee04b94003a390d223ce57a8f9e4b2d975fc32168339f1523018f6f8,986080,2020-09-26 22:01:41 UTC,8038544,8030000,false,8544,0
c7d7a5945d7fcb6b46266a256b421496b1616e5cd50f90df5618a805e9f268ba,986080,2020-09-26 22:01:41 UTC,50000000,49990000,false,10000,0
23a2a75df4e0b354931929ea250f5b082e9a6ee4412c0d42f4a25ccbe9ff1cdf,986080,2020-09-26 22:01:41 UTC,10000,,false,10000,0
ab9ef1fed662d770ee459408bc0cd82544dbe6e2e4f3c305e6b636517599bc67,986080,2020-09-26 22:01:41 UTC,10110925,10108832,false,2093,986067
03926a80b2bd8b723391603b42705b3bac9e89b5554324f05f098c87e6db2442,986080,2020-09-26 22:01:41 UTC,20860,19810,false,1050,0
18b51b6b578b3ab69167575681bb1b380218d09693423886ce77f0adf0a15587,986080,2020-09-26 22:01:41 UTC,19001292272,19001282272,false,10000,0
399240fdadd8097d09726b08a1979cef6b9868b54e51b6e0bf8d1e2e75f1838a,986080,2020-09-26 22:01:41 UTC,2937317557,2937314593,false,2964,986069
593f4fe34bcb68bb4fe265968a74aedcbea4aee16fcd73ede0a7d86d24fbfa4b,986080,2020-09-26 22:01:41 UTC,65422261,65418994,false,3267,0
95a58741545f8efd2a3cf2c1c6ff3fdd47c41ea7b08438e5bf532ed5e56c930c,986080,2020-09-26 22:01:41 UTC,7647600,7639056,false,8544,0
25a9ad5245c9432899233e06026bc1733436b612ce87c35046efea9545f57f20,986080,2020-09-26 22:01:41 UTC,6000364726,6000361762,false,2964,986069
96a2c297acc9cebfba7af71908ec9ccd7962dcfd29072b86f377629e27d785b7,986080,2020-09-26 22:01:41 UTC,428689300,428687216,false,2084,986069
05c63f59b6771091d7517917268675fc7e7fb29ede636ad59285a874493eb801,986079,2020-09-26 21:59:29 UTC,7191333,7184182,false,7151,986032
a6bd914ec502e946382a81c1b2f9c278cddd8b8b07fd86afbcb1a912339f4d50,986079,2020-09-26 21:59:29 UTC,31183832,31179219,false,4613,986067
b10182bac0182bae6a2c06cdc50d8b1fa36c06a2265a49ea4a5fa383e1359719,986079,2020-09-26 21:59:29 UTC,18307655,18304306,false,3349,986067
8b6abc7224d9b7659bcb7c8e9fd21a47c01e0419b9691b72f21211ca54f87603,986079,2020-09-26 21:59:29 UTC,22670676,22666054,false,4622,986067
360fe3a4cf3bf731d4f1735ff3b030192a0925ee8ee30293dc5903a6190801d1,986079,2020-09-26 21:59:29 UTC,17713935,17710586,false,3349,986067
cad3033eac99e1897790be9afad6c0d20bd50f6288b9582ec40329ec2ca4421e,986079,2020-09-26 21:59:29 UTC,10292897,10290804,false,2093,986021
1541fb9de05e0c790ebf16b339ab58d4f7f55369004d87aca441ac842e4cf27a,986078,2020-09-26 21:59:21 UTC,10000,,false,10000,0
366630c4b5563f6bf0b22d14436855865e1da2353b02e173d73359e0d2078de0,986078,2020-09-26 21:59:21 UTC,47500,45050,false,2450,0
c3b618f707e832569ad3eda2d92429f2fdcbddbf6d8840c36a9327704bc4bbdb,986077,2020-09-26 21:58:48 UTC,19001302272,19001292272,false,10000,0
64705ed0b1139eeb9545b18d74ba69f20838c94bee4f7b1d3d3e7f2239492011,986077,2020-09-26 21:58:48 UTC,10000,,false,10000,0
3aa99de2f7dec284e3229fd9fe93bb0a33331b56ae4c5896ee2fed8602c9983c,986074,2020-09-26 21:56:04 UTC,999968543,999958543,false,10000,0
e1c9f3c45fcd2fd51cfb61f30cea4cc1c4a2ec0ad4ee8852fc939cda7174bb7a,986073,2020-09-26 21:55:23 UTC,99159666,99157406,false,2260,0
77d3abd1559cf50770692734ea50888a221d0304b3470357d96393e242c44563,986073,2020-09-26 21:55:23 UTC,1065787861800,1065787854390,false,7410,0
35c7581919c16f8ee98b643b1282ca3de8d841a225953bee027aa8f4569b52bd,986073,2020-09-26 21:55:23 UTC,499998543,499988543,false,10000,0
93fe0d44409697f1d084dc018a374a1443e1b2d27cfa8ad048eb7ec28dfafd73,986073,2020-09-26 21:55:23 UTC,74240015,74230015,false,10000,0
787fd3c634656c6af01f9547bc886070807e61ab8811aa5b12d45d0b285e49c0,986073,2020-09-26 21:55:23 UTC,10427600354,10427590354,false,10000,0
638444ecf11b65033f9bf6d47e765dd0637bef1be308bb1e0901042e504816f3,986073,2020-09-26 21:55:23 UTC,10000,,false,10000,0
787b46c3cd3e0e5a215ace2354eb26c08313f26dfae8af17e1e17ad5f4f3d53c,986071,2020-09-26 21:54:13 UTC,8290035,8281491,false,8544,0
dd372ef7c952c41ddedc01e95e5bec4198a4f090a25609264db88ba377290c2f,986071,2020-09-26 21:54:13 UTC,270456879,270453612,false,3267,0
0974435d72ecb9893ff3bab4c6999478ee4dc43688ab33a2292c6e3fe9d2c511,986071,2020-09-26 21:54:13 UTC,10000,,false,10000,0
bfb859bd841b1d772139bccb45be7eaee66d5dd5592c37dc4183d943c099e8ab,986071,2020-09-26 21:54:13 UTC,629134580,629131223,false,3357,986059
b0c6c75d4efbd6a4726351092cce60854db019ec28dbf1b5bc9f9512a5ed00fe,986070,2020-09-26 21:52:56 UTC,500008543,499998543,false,10000,0
e061cef522cfc8dcd46e0a2584632ade9a55a772124e81026c9e6b8505ce3181,986068,2020-09-26 21:52:01 UTC,65604110,65601150,false,2960,0
aac0aa7455f4d2033989f4af74cf56bad54fffc8ff17193b9524444171072f32,986068,2020-09-26 21:52:01 UTC,124513026999,124513024915,false,2084,986057
fc85b14ff89111e29bf4ed56df44b30470aa6b8150193cd136faebc153601feb,986068,2020-09-26 21:52:01 UTC,270633598,270630638,false,2960,0
a36a51eac93afcc38faef7de0f9d1b2406892960939119b6c1eb055d848ae97a,986067,2020-09-26 21:50:49 UTC,325716868,325676430,false,40438,986056
84ebcf79737bcad743a307d7407f9b89d861e544f9842b3305fb893aa2df433f,986067,2020-09-26 21:50:49 UTC,10000,,false,10000,0
fde15bb0bb7b8f81a579fb8c3d2acde7c9ae9924849047b6fc3d27d83dc11ade,986067,2020-09-26 21:50:49 UTC,446098014,446029662,false,68352,0
149298ae43b318bb990b09f36629bfe7ae367bd93eed62d34962f28068663615,986067,2020-09-26 21:50:49 UTC,4263580000,4263570000,false,10000,0
0d1b1fcdce872e31bbfe1f4d83a35b42104914a9a2ba99f275028b80733099be,986067,2020-09-26 21:50:49 UTC,4263570000,4263567464,false,2536,0
eb15013bd2050d320d5192426ae60a35b273770453a230f345cb9530937433c9,986067,2020-09-26 21:50:49 UTC,10427601500,10427600354,false,1146,0
e9efe6ad1252a1282e6df57faa6d6fad20acad5d6d1cd1c7867df79725286b78,986067,2020-09-26 21:50:49 UTC,208778455,208756899,false,21556,986056
81bf8fe5b771cadc0336ca0da5a507a2af6a8f1cbd660a9c907a1c43d2637025,986067,2020-09-26 21:50:49 UTC,10000,,false,10000,0
ee4cdd2c1fe3ce8effea48f4da81fc6199168823bbf5cdd38d82fbd84e1aab72,986067,2020-09-26 21:50:49 UTC,134940630592,134940628499,false,2093,986056
021a662d8cb140959a658b30bbb8affc63ddcb185d6161e66b543155839c25fc,986067,2020-09-26 21:50:49 UTC,99997550,99995120,false,2430,0
78771b8d903f8ded784337f284b3d225a060335522d3703469f59c3b54687da6,986067,2020-09-26 21:50:49 UTC,10000,,false,10000,0
de4150e5053a208145762b7c382d4c8d11dfbb728ee0135362e8634409655049,986066,2020-09-26 21:45:32 UTC,10000,,false,10000,0
730f00e1397f64204ff97f85711c18e30d3ed64564d6f2fb59174fd70949987e,986065,2020-09-26 21:45:08 UTC,270836175,270832908,false,3267,0
35e56dc9118b9528939d5b2b2a3dea7c80404e050651ea81ed9f97a467efec5c,986064,2020-09-26 21:44:47 UTC,10000,,false,10000,0
9e45e67836f4f1b26fc0f5146a8f2fab044e08bbce932b71dfc50bb32d6c182f,986064,2020-09-26 21:44:47 UTC,12166553732,12166450732,false,103000,0
d81694e4504a3f84af7dabf597341216f911a90f8494f05cf36f1e14f4ebf377,986064,2020-09-26 21:44:47 UTC,8342750,8334206,false,8544,0
71f1ef947eeb03dc9b68a63ef3434a6481f8c0b8bf6d86e8fc6ff3acb2afb4dc,986062,2020-09-26 21:41:37 UTC,65756687,65753727,false,2960,0
619ad138955cb0c6efccacf0efeccb225306fa08b8c8b4444a75b65342057425,986062,2020-09-26 21:41:37 UTC,10000000000,9999997550,false,2450,0
39637a472a690cba96a6ae906f80bac95869e5bc8a4de4c08061ffbb0967dfd2,986062,2020-09-26 21:41:37 UTC,499990000,499980000,false,10000,0
9c2f00bba6876131c48fddcd3e8e1038bf4723a98d5b32b63e533e3113091927,986062,2020-09-26 21:41:37 UTC,10000,,false,10000,0
8ba5cd5edebd0937bde2b46c2339b587a6344e206d3c62e0bfbbef9547e85b76,986061,2020-09-26 21:40:13 UTC,326837913,326798637,false,39276,986050
f5dd29fa16ce7576f9c2894ee06cea11b9022f675b03e07514c92648f3b207fc,986061,2020-09-26 21:40:13 UTC,553738280,553736187,false,2093,985993
dc204d6c2075d8bf34ed09122c75d3d8e73613a02a5cedbe74f9c49492b16cad,986061,2020-09-26 21:40:13 UTC,500000000,499990000,false,10000,0
3eb051aaa477033ac99886bf9058bb935e67128e920ce52d48a4c9e77040f593,986061,2020-09-26 21:40:13 UTC,10000,,false,10000,0
0f5bab4ed8c4dc33133adf611f7cabe1877540b95dedad85330f939cdc38720f,986061,2020-09-26 21:40:13 UTC,209425439,209404464,false,20975,986050
c4589fe59255aa2a1978f08cd654eb9566deccc1b701f6186b024d6dcb655c50,986058,2020-09-26 21:37:36 UTC,1881994263,1881955158,false,39105,0
b1796ecf99c2a1e0c3c44a90ff19eb5d38ca3dc8bbbb09dedb8581f172c01723,986057,2020-09-26 21:37:13 UTC,10000,,false,10000,0
d19384836f2daf470fb64c727b67eb592c0be0bcb9b084b77638a2e1f16e56a3,986057,2020-09-26 21:37:13 UTC,10000,,false,10000,0
1e4c3b30e13289a304b9f9e4d63556b77a783507699b32bdb0496a6794dd2994,986057,2020-09-26 21:37:13 UTC,4692000000,4691997382,false,2618,0
26d05baa6052bfe6a24b9c0f129d05d1d6c2e207bc192444a3dac4ffd7a8c672,986057,2020-09-26 21:37:13 UTC,100014730,100004110,false,10620,986046
5a97d82f7b850c65285aa751ed498393e8a1fdad128905ed3218b887983a5c77,986057,2020-09-26 21:37:13 UTC,8439807,8431263,false,8544,0
25d4c8209c07ba7d7fb7a2b5daad551bf9cd8d4fd14893345f17ee82df9c0738,986057,2020-09-26 21:37:13 UTC,500000000,499990000,false,10000,0
4feded0b32829b231f86ba2ef9f3eab646d3f12eb96309051372e43250b8b3b9,986057,2020-09-26 21:37:13 UTC,415031483,414986723,false,44760,986056
aa0dee568949a14512aa32f91908b070af3105f4cb58f89812a2898502a908b9,986057,2020-09-26 21:37:13 UTC,10000,,false,10000,0
abdeeb431a7caedbaba52476e50087b6f300bbd38bd417ec797551d3b85f0fb8,986056,2020-09-26 21:32:05 UTC,1877338364,1877336280,false,2084,986044
000209c66282be34d1fea0378be09e2419c2e45411872cca2bf5e8004f81b055,986055,2020-09-26 21:30:59 UTC,271051285,271048018,false,3267,0
f3ded5b197892566e742be1931812b0096a745ac7baf3eceb67c245fe61414cd,986055,2020-09-26 21:30:59 UTC,209913663,209892133,false,21530,986044
a8606303282b35ed01e9e98c3ddce37f819b0ef50202408866b6742f5f5ecef8,986055,2020-09-26 21:30:59 UTC,10000,,false,10000,0
fbf4457640045866021a7b965527d964758c5b2a14eb8b0810b03924578eb88e,986055,2020-09-26 21:30:59 UTC,327899072,327861838,false,37234,986044
f27c060e3f7c1d7338e12e7921c5ed3920fc1d4dfe09faa8ffed13e1d104dd63,986055,2020-09-26 21:30:59 UTC,137743139,137726289,false,16850,0
4f12ea02953c9d7d1335ba30327ae075c5222f1978f7d2f28c20932ce51478e4,986055,2020-09-26 21:30:59 UTC,478772047,478703695,false,68352,0
1eba6517a03a8ed12853a43baa57805869f99ca5ade54f473ac0679170bb0aca,986055,2020-09-26 21:30:59 UTC,4525645295,4525638294,false,7001,0
46fda0f0b681618e2227ffff4fe18f4df9df8d641a70abb06e174033581986e6,986054,2020-09-26 21:28:59 UTC,8886291570,8886284570,false,7000,0
c90371beaba2cdfa6b4d31acddfef12a03d62633f947319a682c4c59a5c4e3ce,986053,2020-09-26 21:28:12 UTC,10000,,false,10000,0
4698d550271ca1cce317e15345ee6b8e810f3dd211e5fa2e521fae74a808800e,986053,2020-09-26 21:28:12 UTC,1009289,1003420,false,5869,986010
5adc71152b02cda2c8cb87be371373874809248306af5824f8f885d55552187f,986053,2020-09-26 21:28:12 UTC,18646268873,18646258873,false,10000,0
87170296c2bdf0e5a89a9073ac4f422c3772729707bf122a75e0d34269f7c0c5,986053,2020-09-26 21:28:12 UTC,8479768,8471224,false,8544,0
87b32340c8157c96fb77905bc0f3d2cb6d1cc098661e2bc2785c7253d1c7dbf0,986053,2020-09-26 21:28:12 UTC,10000,,false,10000,0
2a03f26188773def912433f359becfca99e517c86bff4e24b989aaa77653d6f8,986053,2020-09-26 21:28:12 UTC,6642,1072,false,5570,986006
e8a513ba43be8a54fa1ecfb7973c05258750c9f8b4a7013a23d89b5c8a2be450,986053,2020-09-26 21:28:12 UTC,65963187,65960227,false,2960,0
095b55e65686bd45f77ff6a4a52f28968c3015bfbaeaa8671f348fc6ca9dd606,986053,2020-09-26 21:28:12 UTC,10000,,false,10000,0
3d65d54bad948a79100cfdf49b1cc1490efb5e3ac640fcc977675616f7c4d943,986052,2020-09-26 21:23:57 UTC,26382719,26380626,false,2093,986041
77c744ebc55309e613ac8df2f5130de1ffa959fb99be9afa112fb2db85fd8285,986052,2020-09-26 21:23:57 UTC,7442113,7432113,false,10000,0
c29811708b207d9b5b70934d804fce0674192317380af511faabe47ce9221508,986052,2020-09-26 21:23:57 UTC,10000,,false,10000,0
a6118adce202facd391d331e099aa02c37a9bd313f8f46cd8a79449660d747c8,986052,2020-09-26 21:23:57 UTC,10000,,false,10000,0
d7deb9d0e5110be33b3820f5cb1331060a17d49a88a2f1a395e28209069d9b68,986052,2020-09-26 21:23:57 UTC,8886293862,8886292716,false,1146,0
04776b19bea1a4ccdefa3f40ad90a477914aff658c0c1fe879cbb1616a4e7a80,986052,2020-09-26 21:23:57 UTC,55172836,55170218,false,2618,0
4596b4ffe2eeadfea0f9815be8e09892404721e42d98b5522c95f7c4ed614b16,986052,2020-09-26 21:23:57 UTC,4740942232,4740842232,false,100000,0
3d84e4595c7633f728e5e9b2a7de6ee3e914bcdd1b7b4d7d9cdf2e0dc3657775,986052,2020-09-26 21:23:57 UTC,271271205,271267938,false,3267,0
cfe2712584a0d5fa52d88c8f59397d7504c89f5b5621d9cb280239a8a5bf1eec,986052,2020-09-26 21:23:57 UTC,210580246,210558989,false,21257,986041
57850ca36c320da223a2717744e18e222afe3fff8f86a03d69bdd8cbc98d0004,986052,2020-09-26 21:23:57 UTC,3588491716,3588490570,false,1146,0
3156ab6b9eb6aeff5fa98bdb9d4818c2796a41890b8ae48b24604e679edaf7a9,986052,2020-09-26 21:23:57 UTC,328833756,328797103,false,36653,986041
60d0ef5f33d1f24f0a0220cdb9279fa55f0322e708ef0f4fb089f4b11d41c1e0,986052,2020-09-26 21:23:57 UTC,10000,,false,10000,0
ab9a88db121f295ee88c05b3eececa8314052f00b14f71ed6523a2fd05a08c0f,986052,2020-09-26 21:23:57 UTC,499980000,499970000,false,10000,0
5ea4dc06555e6daee1ea738af1befaba60757031eb28f72f056cec4035b77187,986052,2020-09-26 21:23:57 UTC,10000,,false,10000,0
79a35feb3b324a7725fc57cf3f4e20cfca284c685bc0df4fc189a69fced88fb2,986051,2020-09-26 21:19:50 UTC,2109623913,2109621993,false,1920,0
71c628e1cf7f152a07ec339337439ec4e513881a0fdc56915f5736166f187931,986051,2020-09-26 21:19:50 UTC,8886303862,8886293862,false,10000,0
abd71d317d4f0fd3e8c8d1c5284850a617168bc030fa40d987f6be2030184a91,986051,2020-09-26 21:19:50 UTC,352359636,352344056,false,15580,0
4f25c83e6c2a04fe8616da31a71e333ec3482af09df05fb683f46f3b3e14f832,986049,2020-09-26 21:18:55 UTC,1403444784,1403429204,false,15580,0
eb2027b44e7da92c2052da231457b2794602e8448fa767e49e067b24153d61a9,986049,2020-09-26 21:18:55 UTC,13318,8438,false,4880,0
d6d51abd1b324dd3e6db97845fbd523dde16ac6f8ec171f90a78f1908e325606,986049,2020-09-26 21:18:55 UTC,10000,,false,10000,0
de2c41091a21f37446cc37fc883111bcb8550744ad70575f58a08a24113c136a,986049,2020-09-26 21:18:55 UTC,34648,28648,false,6000,0
5dae8c34f9aad6583806f0cb4335ee3ee1c271af122500f1d7b07ab445a76f3d,986049,2020-09-26 21:18:55 UTC,342444206915,342444197255,false,9660,0
40aee7daafa54303438aed278d27249c0bfc63294bcf55686ccd7d46bf2dc033,986047,2020-09-26 21:15:26 UTC,10000,,false,10000,0
69ed2ad8d86a24bfd0ac4cf5bd482aefe69b32bcae35fe3a95d6e739adcb456c,986047,2020-09-26 21:15:26 UTC,31176276,31131516,false,44760,986045
19532ed526e0bd07be0b0d88633a0c175d5d980838f78d4df34f750a3eec0244,986047,2020-09-26 21:15:26 UTC,2118549371,2118547111,false,2260,0
32bae56fd293893a035a76293af89cf9b63a49e23e50f95f3a055571d5b05c25,986046,2020-09-26 21:15:07 UTC,11293885394,11293869814,false,15580,0
b5b6a75e1240c2ec665a45b239916d02c299ed0a0b19dde0546037daca221f38,986045,2020-09-26 21:14:07 UTC,1252592035,1252576455,false,15580,0
43b3323b2823917497504081cb4bfe679a6e72d2bf417788a5b3cfd629b7e57b,986045,2020-09-26 21:14:07 UTC,484646389,484630809,false,15580,0
78b27fe62de8c8624930e8dc8190db60cc20291c7288a3bf00a25d8951ee6ebd,986045,2020-09-26 21:14:07 UTC,12394940097,12394921435,false,18662,0
ec00d4ce76d2e6ea4b1b6f997cebb4167d9310cf4aa3707e830837246a9e0108,986045,2020-09-26 21:14:07 UTC,10000,,false,10000,0
d6d32cc6eb496de9de5f173e31a30d543914dea1d290600af5cb3b2e39d1c139,986043,2020-09-26 21:13:18 UTC,304066366,303998014,false,68352,0
63ef42397a74400a5339fcfb57e2b25ad980ce95da7333d2562503a9b2f298f6,986043,2020-09-26 21:13:18 UTC,6835174638,6835167637,false,7001,0
1a718aa78fe9df05e3233f832072728365be00f396e6d0023493cc4d1c9cbcfd,986043,2020-09-26 21:13:18 UTC,4429190130,4429183129,false,7001,0
0658f145fcd039ac1163d0e255101f451e58d8d93eea86b7fee2cbe60c041429,986043,2020-09-26 21:13:18 UTC,66170873,66167913,false,2960,0
3870f4cf9974d1e95951dc7a54db9ef1f67fb419522a49b4341663a4c395face,986043,2020-09-26 21:13:18 UTC,2039021313,2039021242,false,71,0
c9805cda18b2ef488b5bb33fc3c5333f496884bcecf091c21a98a39998c0575f,986043,2020-09-26 21:13:18 UTC,34394,24394,false,10000,0
15be3c769851052523682bfdd9ae33f933036a477628d8428c2f7ba23ee17fd9,986043,2020-09-26 21:13:18 UTC,4240470659,4240463658,false,7001,0
d746402e1934cd23a5f05fbcc2b4a9f1e6fda91cb39a1ee0f42b99defad122b6,986042,2020-09-26 21:11:46 UTC,10000,,false,10000,0
f16f3a17b89223aca6aba5b3c309c708b7f8b09b876cf99e7ad8aacf0753b5f4,986042,2020-09-26 21:11:46 UTC,8768672,8760128,false,8544,0
6b78d095a0031d3a176b16f0802e09ebb57837d09119ae1d87ab1a51d4500768,986041,2020-09-26 21:11:17 UTC,211490056,211468227,false,21829,986030
d606adecb3e4c7cfae9017c7c0e3d11fb2a7a0fc23a15130bf02d3b1d929907c,986041,2020-09-26 21:11:17 UTC,7654682,7644812,false,9870,0
3d610ac21d476719ab0e77a3d99a44acb1f11b03a271d79ed4fb375981860ad0,986041,2020-09-26 21:11:17 UTC,330107668,330063453,false,44215,986030
7cd8bf9c1a3e76850dc322f00a54c696728117da0d8b755094ff29751949038a,986041,2020-09-26 21:11:17 UTC,1500025052,1500015052,false,10000,0
b736e87e7b420c6eb8ca465ec85376576cf57909f5bd8631b7abf8e54b4b21bd,986041,2020-09-26 21:11:17 UTC,18416642494,18416632494,false,10000,0
0d5415b6ff76b6efe12bde6910425f9a0be66a0e4624e865c6eceab0e0ea3b8d,986041,2020-09-26 21:11:17 UTC,15144925,15139047,false,5878,986030
8d082b9a638462a684c48cf356eb97375bec8ea546803fed0079ad53d09e9857,986041,2020-09-26 21:11:17 UTC,499990000,499980000,false,10000,0
bf228db76f6c44e5387aabc7997ce17310439ed6c9b4bd399787341e81af5e90,986041,2020-09-26 21:11:17 UTC,10000,,false,10000,0
93adcea7e0ac023670d8e09f35a327bf05cf1c0b7d8096fe899cef81f7f32445,986041,2020-09-26 21:11:17 UTC,100122349,100119899,false,2450,0
a03ba9b88f793dac0b662324dcfe6bcb40e259b92847e53d0bfee708edc6be12,986041,2020-09-26 21:11:17 UTC,26062734833,26062704833,false,30000,0
35e34de0109dc1a6d6083c3a747e412d74d4e54ce68fc1ee093c8960ae8e7139,986041,2020-09-26 21:11:17 UTC,10000,,false,10000,0
f469102b4bc10fa264ebcedbd47b7eaa804d9ded22c80791794a03466981d6df,986040,2020-09-26 21:05:38 UTC,19093881636,19093871636,false,10000,0
a8d0d9894a21e43bf5641b128f4781c2e4672fe796da09c2cb99dbb5016b513e,986040,2020-09-26 21:05:38 UTC,10000,,false,10000,0
3477ef253ca0e27926fde969623c51be1a160e656f04bca0c4c8a4fc09fb1952,986040,2020-09-26 21:05:38 UTC,238385290078,238385280078,false,10000,0
f0246b1a45756e2ff750db1fd6c3f0db8b8f9e67d849dc83c532e0feb3cbd9f9,986040,2020-09-26 21:05:38 UTC,10000,,false,10000,0
eb02caaa96bff3bf8257c1e25ed4ec2bbaf84f9aec011b2d46f1e33d9dc2e2bf,986040,2020-09-26 21:05:38 UTC,10000010000,10000000000,false,10000,0
8a349ae1efdd91069fdd3b4d83eb15af559f0f5837bd9dfcc3b25f1502e9e6cc,986040,2020-09-26 21:05:38 UTC,460497500,460495918,false,1582,0
90ff3e5780bae6364734d130ad1e4d8155dd9ad1ee3406b390a3ea186b544653,986040,2020-09-26 21:05:38 UTC,10000,,false,10000,0
5a04e3bf938664b7a842b89ec52ffe1ed7f8a701e2c802554bfe86e61a14dcd2,986040,2020-09-26 21:05:38 UTC,500000000,499990000,false,10000,0
68e3011d61a1e46e054e39b6362e6387591cf4dc6a2b5ae08c11ba4d1d850560,986040,2020-09-26 21:05:38 UTC,10000,,false,10000,0
ab6059554010d65c4d96a54416f40113f03d5f955db14b286e78c0fa71d01b7f,986040,2020-09-26 21:05:38 UTC,3500059997,3500049997,false,10000,0
e50b2ad4222b129b6da7aa301a7f1d4d922d034cbe60c0c968df588fdccf72cc,986040,2020-09-26 21:05:38 UTC,271431058,271428098,false,2960,0
5941451066d5dd7752b37e94e8c6513d4ff1378520ce773dd0ed995f16291f02,986040,2020-09-26 21:05:38 UTC,5499998854,5499997708,false,1146,0
a929681b9fa202cf1e57b48a967cb5ac39a4074273b59fd6c771981bc52dd655,986040,2020-09-26 21:05:38 UTC,500090215,500087832,false,2383,986029
cc1b95115b1e24f8dd7c1118a01c0b1745cb146154f87d7a6a3f609cdc154cc6,986040,2020-09-26 21:05:38 UTC,5000667197,5000657197,false,10000,0
690b3ed4ae1f2004511f7da16d705aea93f703d32a9b3aebe58d5553e74fc756,986040,2020-09-26 21:05:38 UTC,10000000000,9999998854,false,1146,0
2c6f2b1966d0bf38c349229f2a9a5d8c43076b74173992d769efd0e1421eb36e,986040,2020-09-26 21:05:38 UTC,3399997708,3399996562,false,1146,0
d4b469daaa257d2650a932208e9aca4a06dbe36eeb0e713d3ea4e3fdfe5d55fa,986039,2020-09-26 21:02:21 UTC,1916001448,1915999364,false,2084,986028
6e33c8b9549983535430cf1816bf0335ddc1e91b529f2815a60cfcf0a78a0d77,986039,2020-09-26 21:02:21 UTC,2990010261,2990007306,false,2955,986028
88b2f4b6ce46a6ce55b2944dd786bb9efc7137e75d44a21503119bd87e479cf3,986039,2020-09-26 21:02:21 UTC,19662993000,19662983000,false,10000,0
650591eff0f8b7d02417a282d3acae1267f620a964ef129247e9c197c220c0d8,986039,2020-09-26 21:02:21 UTC,19093891636,19093881636,false,10000,0
edaee6f8b2623e9176c04438f5a56966e81e0d2efd3a04f1b9844dea16e23c62,986039,2020-09-26 21:02:21 UTC,171040987,171039643,false,1344,0
b143a371f9afa1cd90d5af52ef41bf60859e82ceae4d58fe6b48c3965e170e8d,986038,2020-09-26 21:00:24 UTC,270668130,270664585,false,3545,986026
de270e20191dbeb20e7236d423c9b2ca10eb7ca61034c0dd71abc3c16d5470da,986038,2020-09-26 21:00:24 UTC,10000,,false,10000,0
ad0f684cb9238b76eff739f92b6fd47cd2734089b7d7b4548d7fe9b433abf5fd,986038,2020-09-26 21:00:24 UTC,12140,10350,false,1790,0
a1589db287d50552fef7876a641adf166eb2e384e35daef21085a3fe4d458c10,986038,2020-09-26 21:00:24 UTC,212341896,212320932,false,20964,986026
1b67c3852f601c9a90a05bf266a6d5a404111fce6e2e21c6448852494777d2be,986038,2020-09-26 21:00:24 UTC,169000010000,169000000000,false,10000,0
aded3113900d907ca5ce8e00c39909ab288e810be51a2dcab15ca37ed50d2788,986038,2020-09-26 21:00:24 UTC,111552707,111529020,false,23687,0
3d1b29420091cbc5ba2a178d5db7ae95aa5cd1204836a1637884ac8e816a559c,986038,2020-09-26 21:00:24 UTC,331286847,331240613,false,46234,986026
